Datum,IntensivbettenGesamt,IntensivbettenBelegt,IntensivBettenFrei,COVID19FaelleAktuell,COVID19FaelleBeatmet,Quelle
1588248000,1073,620,453,54,40,https://diviexchange.z6.web.core.windows.net/laendertabelle1.svg
1588309200,1073,622,451,54,40,https://diviexchange.z6.web.core.windows.net/laendertabelle1.svg
1588312800,1067,604,463,55,39,https://diviexchange.z6.web.core.windows.net/laendertabelle1.svg
1588316400,1049,607,442,53,35,https://diviexchange.z6.web.core.windows.net/laendertabelle1.svg
1588323600,1049,609,440,53,35,https://diviexchange.z6.web.core.windows.net/laendertabelle1.svg
1588334400,1049,608,441,53,35,https://diviexchange.z6.web.core.windows.net/laendertabelle1.svg
1588395600,1053,609,444,53,35,https://diviexchange.z6.web.core.windows.net/laendertabelle1.svg
1588399200,1052,604,448,54,35,https://diviexchange.z6.web.core.windows.net/laendertabelle1.svg
1588402800,1053,596,457,53,35,https://diviexchange.z6.web.core.windows.net/laendertabelle1.svg
1588406400,1053,601,452,53,35,https://diviexchange.z6.web.core.windows.net/laendertabelle1.svg
1588446000,1046,596,450,53,35,https://diviexchange.z6.web.core.windows.net/laendertabelle1.svg
1588482000,1048,598,450,52,35,https://diviexchange.z6.web.core.windows.net/laendertabelle1.svg
1588485600,1048,588,460,49,34,https://diviexchange.z6.web.core.windows.net/laendertabelle1.svg
1588489200,1049,581,468,51,34,https://diviexchange.z6.web.core.windows.net/laendertabelle1.svg
1588492800,1049,579,470,51,34,https://diviexchange.z6.web.core.windows.net/laendertabelle1.svg
1588532400,1040,575,465,51,34,https://diviexchange.z6.web.core.windows.net/laendertabelle1.svg
1588564800,1038,573,465,51,34,https://diviexchange.z6.web.core.windows.net/laendertabelle1.svg
1588568400,1037,585,452,51,34,https://diviexchange.z6.web.core.windows.net/laendertabelle1.svg
1588572000,1044,580,464,48,31,https://diviexchange.z6.web.core.windows.net/laendertabelle1.svg
1588575600,1057,575,482,47,32,https://diviexchange.z6.web.core.windows.net/laendertabelle1.svg
1588618800,1057,575,482,48,33,https://diviexchange.z6.web.core.windows.net/laendertabelle1.svg
1588654800,1066,574,492,49,33,https://diviexchange.z6.web.core.windows.net/laendertabelle1.svg
1588658400,1066,589,477,49,31,https://diviexchange.z6.web.core.windows.net/laendertabelle1.svg
1588662000,1068,597,471,49,31,https://diviexchange.z6.web.core.windows.net/laendertabelle1.svg
1588665600,1068,596,472,49,31,https://diviexchange.z6.web.core.windows.net/laendertabelle1.svg
1588669200,1074,601,473,49,31,https://diviexchange.z6.web.core.windows.net/laendertabelle1.svg
1588741200,1074,603,471,48,32,https://diviexchange.z6.web.core.windows.net/laendertabelle1.svg
1588744800,1066,615,451,47,32,https://diviexchange.z6.web.core.windows.net/laendertabelle1.svg
1588748400,1053,620,433,43,31,https://diviexchange.z6.web.core.windows.net/laendertabelle1.svg
1588752000,1053,622,431,43,31,https://diviexchange.z6.web.core.windows.net/laendertabelle1.svg
1588827600,1056,621,435,42,30,https://diviexchange.z6.web.core.windows.net/laendertabelle1.svg
1588831200,1057,606,451,42,30,https://diviexchange.z6.web.core.windows.net/laendertabelle1.svg
1588834800,1057,614,443,42,31,https://diviexchange.z6.web.core.windows.net/laendertabelle1.svg
1588842000,1057,615,442,42,31,https://diviexchange.z6.web.core.windows.net/laendertabelle1.svg
1588885200,1051,610,441,42,31,https://diviexchange.z6.web.core.windows.net/laendertabelle1.svg
1588914000,1051,613,438,41,31,https://diviexchange.z6.web.core.windows.net/laendertabelle1.svg
1588917600,1052,625,427,42,32,https://diviexchange.z6.web.core.windows.net/laendertabelle1.svg
1588921200,1052,626,426,41,28,https://diviexchange.z6.web.core.windows.net/laendertabelle1.svg
1588924800,1052,624,428,41,28,https://diviexchange.z6.web.core.windows.net/laendertabelle1.svg
1588946400,1052,627,425,40,28,https://diviexchange.z6.web.core.windows.net/laendertabelle1.svg
1589000400,1052,619,433,39,27,https://diviexchange.z6.web.core.windows.net/laendertabelle1.svg
1589004000,1052,616,436,40,27,https://diviexchange.z6.web.core.windows.net/laendertabelle1.svg
1589007600,1036,616,420,39,26,https://diviexchange.z6.web.core.windows.net/laendertabelle1.svg
1589011200,1036,615,421,39,26,https://diviexchange.z6.web.core.windows.net/laendertabelle1.svg
1589014800,1036,617,419,40,26,https://diviexchange.z6.web.core.windows.net/laendertabelle1.svg
1589090400,1034,609,425,41,27,https://diviexchange.z6.web.core.windows.net/laendertabelle1.svg
1589094000,1041,596,445,39,26,https://diviexchange.z6.web.core.windows.net/laendertabelle1.svg
1589097600,1051,606,445,39,26,https://diviexchange.z6.web.core.windows.net/laendertabelle1.svg
1589169600,1051,603,448,39,26,https://diviexchange.z6.web.core.windows.net/laendertabelle1.svg
1589173200,1047,606,441,38,26,https://diviexchange.z6.web.core.windows.net/laendertabelle1.svg
1589176800,1050,616,434,40,25,https://diviexchange.z6.web.core.windows.net/laendertabelle1.svg
1589180400,1045,608,437,40,24,https://diviexchange.z6.web.core.windows.net/laendertabelle1.svg
1589205600,1045,604,441,40,24,https://diviexchange.z6.web.core.windows.net/laendertabelle1.svg
1589238000,1045,602,443,40,24,https://diviexchange.z6.web.core.windows.net/laendertabelle1.svg
1589259600,1045,608,437,39,24,https://diviexchange.z6.web.core.windows.net/laendertabelle1.svg
1589263200,1046,610,436,38,24,https://diviexchange.z6.web.core.windows.net/laendertabelle1.svg
1589266800,1049,620,429,39,25,https://diviexchange.z6.web.core.windows.net/laendertabelle1.svg
1589270400,1049,620,429,38,25,https://diviexchange.z6.web.core.windows.net/laendertabelle1.svg
1589295600,1051,622,429,38,24,https://diviexchange.z6.web.core.windows.net/laendertabelle1.svg
1589346000,1047,616,431,37,23,https://diviexchange.z6.web.core.windows.net/laendertabelle1.svg
1589353200,1048,643,405,34,21,https://diviexchange.z6.web.core.windows.net/laendertabelle1.svg
1589432400,1048,640,408,34,21,https://diviexchange.z6.web.core.windows.net/laendertabelle1.svg
1589436000,1052,632,420,33,20,https://diviexchange.z6.web.core.windows.net/laendertabelle1.svg
1589439600,1051,622,429,34,20,https://diviexchange.z6.web.core.windows.net/laendertabelle1.svg
1589461200,1057,627,430,34,20,https://diviexchange.z6.web.core.windows.net/laendertabelle1.svg
1589518800,1057,628,429,35,20,https://diviexchange.z6.web.core.windows.net/laendertabelle1.svg
1589522400,1047,626,421,35,20,https://diviexchange.z6.web.core.windows.net/laendertabelle1.svg
1589526000,1047,629,418,36,20,https://diviexchange.z6.web.core.windows.net/laendertabelle1.svg
1589529600,1047,636,411,35,19,https://diviexchange.z6.web.core.windows.net/laendertabelle1.svg
1589533200,1048,636,412,34,19,https://diviexchange.z6.web.core.windows.net/laendertabelle1.svg
1589608800,1017,643,374,35,22,https://diviexchange.z6.web.core.windows.net/laendertabelle1.svg
1589612400,1008,631,377,36,22,https://diviexchange.z6.web.core.windows.net/laendertabelle1.svg
1589623200,1008,633,375,36,23,https://diviexchange.z6.web.core.windows.net/laendertabelle1.svg
1589630400,1008,634,374,36,23,https://diviexchange.z6.web.core.windows.net/laendertabelle1.svg
1589677200,1002,629,373,36,23,https://diviexchange.z6.web.core.windows.net/laendertabelle1.svg
1589691600,1002,630,372,35,22,https://diviexchange.z6.web.core.windows.net/laendertabelle1.svg
1589695200,1002,619,383,35,22,https://diviexchange.z6.web.core.windows.net/laendertabelle1.svg
1589698800,1021,626,395,33,22,https://diviexchange.z6.web.core.windows.net/laendertabelle1.svg
1589702400,1023,622,401,33,22,https://diviexchange.z6.web.core.windows.net/laendertabelle1.svg
1589706000,1023,619,404,33,22,https://diviexchange.z6.web.core.windows.net/laendertabelle1.svg
1589731200,1023,621,402,33,22,https://diviexchange.z6.web.core.windows.net/laendertabelle1.svg
1589738400,965,570,395,33,22,https://diviexchange.z6.web.core.windows.net/laendertabelle1.svg
1589774400,965,572,393,33,22,https://diviexchange.z6.web.core.windows.net/laendertabelle1.svg
1589778000,965,570,395,33,21,https://diviexchange.z6.web.core.windows.net/laendertabelle1.svg
1589781600,1017,617,400,35,21,https://diviexchange.z6.web.core.windows.net/laendertabelle1.svg
1589785200,1016,612,404,33,20,https://diviexchange.z6.web.core.windows.net/laendertabelle1.svg
1589788800,1016,613,403,34,20,https://diviexchange.z6.web.core.windows.net/laendertabelle1.svg
1589792400,1022,617,405,34,20,https://diviexchange.z6.web.core.windows.net/laendertabelle1.svg
1589860800,1022,615,407,34,20,https://diviexchange.z6.web.core.windows.net/laendertabelle1.svg
1589864400,1016,618,398,34,19,https://diviexchange.z6.web.core.windows.net/laendertabelle1.svg
1589868000,1016,621,395,32,16,https://diviexchange.z6.web.core.windows.net/laendertabelle1.svg
1589871600,1015,624,391,35,16,https://diviexchange.z6.web.core.windows.net/laendertabelle1.svg
1589875200,1015,629,386,35,16,https://diviexchange.z6.web.core.windows.net/laendertabelle1.svg
1589882400,1015,630,385,35,16,https://diviexchange.z6.web.core.windows.net/laendertabelle1.svg
1589950800,1017,624,393,35,16,https://diviexchange.z6.web.core.windows.net/laendertabelle1.svg
1589954400,1024,619,405,33,14,https://diviexchange.z6.web.core.windows.net/laendertabelle1.svg
1589958000,1025,614,411,34,15,https://diviexchange.z6.web.core.windows.net/laendertabelle1.svg
1589968800,1018,613,405,34,15,https://diviexchange.z6.web.core.windows.net/laendertabelle1.svg
1590008400,1012,609,403,34,15,https://diviexchange.z6.web.core.windows.net/laendertabelle1.svg
1590033600,1012,614,398,34,15,https://diviexchange.z6.web.core.windows.net/laendertabelle1.svg
1590037200,1010,614,396,34,15,https://diviexchange.z6.web.core.windows.net/laendertabelle1.svg
1590044400,1002,603,399,33,13,https://diviexchange.z6.web.core.windows.net/laendertabelle1.svg
1590084000,1002,602,400,33,13,https://diviexchange.z6.web.core.windows.net/laendertabelle1.svg
1590123600,1004,597,407,32,13,https://diviexchange.z6.web.core.windows.net/laendertabelle1.svg
1590127200,1007,584,423,33,13,https://diviexchange.z6.web.core.windows.net/laendertabelle1.svg
1590130800,1017,581,436,33,13,https://diviexchange.z6.web.core.windows.net/laendertabelle1.svg
1590134400,1017,583,434,33,13,https://diviexchange.z6.web.core.windows.net/laendertabelle1.svg
1590206400,1017,582,435,33,13,https://diviexchange.z6.web.core.windows.net/laendertabelle1.svg
1590210000,1015,571,444,34,13,https://diviexchange.z6.web.core.windows.net/laendertabelle1.svg
1590213600,1017,579,438,33,13,https://diviexchange.z6.web.core.windows.net/laendertabelle1.svg
1590217200,1018,572,446,31,13,https://diviexchange.z6.web.core.windows.net/laendertabelle1.svg
1590220800,1018,565,453,31,13,https://diviexchange.z6.web.core.windows.net/laendertabelle1.svg
1590296400,1018,559,459,31,13,https://diviexchange.z6.web.core.windows.net/laendertabelle1.svg
1590300000,1018,567,451,30,13,https://diviexchange.z6.web.core.windows.net/laendertabelle1.svg
1590303600,1019,554,465,30,12,https://diviexchange.z6.web.core.windows.net/laendertabelle1.svg
1590310800,1019,552,467,29,12,https://diviexchange.z6.web.core.windows.net/laendertabelle1.svg
1590379200,1025,557,468,29,12,https://diviexchange.z6.web.core.windows.net/laendertabelle1.svg
1590382800,1025,561,464,29,12,https://diviexchange.z6.web.core.windows.net/laendertabelle1.svg
1590386400,1021,555,466,30,13,https://diviexchange.z6.web.core.windows.net/laendertabelle1.svg
1590390000,1022,575,447,29,12,https://diviexchange.z6.web.core.windows.net/laendertabelle1.svg
1590393600,1022,578,444,29,12,https://diviexchange.z6.web.core.windows.net/laendertabelle1.svg
1590469200,1022,601,421,27,11,https://diviexchange.z6.web.core.windows.net/laendertabelle1.svg
1590472800,1021,606,415,27,11,https://diviexchange.z6.web.core.windows.net/laendertabelle1.svg
1590476400,1021,605,416,25,12,https://diviexchange.z6.web.core.windows.net/laendertabelle1.svg
1590534000,1020,605,415,25,12,https://diviexchange.z6.web.core.windows.net/laendertabelle1.svg
1590552000,1014,603,411,25,12,https://diviexchange.z6.web.core.windows.net/laendertabelle1.svg
1590555600,1013,596,417,25,12,https://diviexchange.z6.web.core.windows.net/laendertabelle1.svg
1590559200,1015,597,418,23,11,https://diviexchange.z6.web.core.windows.net/laendertabelle1.svg
1590562800,1013,599,414,22,11,https://diviexchange.z6.web.core.windows.net/laendertabelle1.svg
1590642000,1013,592,421,22,11,https://diviexchange.z6.web.core.windows.net/laendertabelle1.svg
1590645600,1027,605,422,21,10,https://diviexchange.z6.web.core.windows.net/laendertabelle1.svg
1590649200,1027,606,421,20,9,https://diviexchange.z6.web.core.windows.net/laendertabelle1.svg
1590660000,1027,610,417,20,9,https://diviexchange.z6.web.core.windows.net/laendertabelle1.svg
1590667200,1027,609,418,20,9,https://diviexchange.z6.web.core.windows.net/laendertabelle1.svg
1590728400,1015,598,417,20,9,https://diviexchange.z6.web.core.windows.net/laendertabelle1.svg
1590732000,1006,599,407,21,9,https://diviexchange.z6.web.core.windows.net/laendertabelle1.svg
1590735600,1002,604,398,20,6,https://diviexchange.z6.web.core.windows.net/laendertabelle1.svg
1590750000,1002,603,399,20,6,https://diviexchange.z6.web.core.windows.net/laendertabelle1.svg
1590818400,1002,608,394,20,6,https://diviexchange.z6.web.core.windows.net/laendertabelle1.svg
1590822000,999,598,401,17,6,https://diviexchange.z6.web.core.windows.net/laendertabelle1.svg
1590825600,999,596,403,17,6,https://diviexchange.z6.web.core.windows.net/laendertabelle1.svg
1590836400,999,597,402,17,6,https://diviexchange.z6.web.core.windows.net/laendertabelle1.svg
1590847200,1003,597,406,17,6,https://diviexchange.z6.web.core.windows.net/laendertabelle1.svg
1590850800,1003,593,410,17,6,https://diviexchange.z6.web.core.windows.net/laendertabelle1.svg
1590883200,1003,592,411,17,6,https://diviexchange.z6.web.core.windows.net/laendertabelle1.svg
1590901200,1003,586,417,17,6,https://diviexchange.z6.web.core.windows.net/laendertabelle1.svg
1590904800,1006,594,412,19,6,https://diviexchange.z6.web.core.windows.net/laendertabelle1.svg
1590908400,1005,587,418,20,7,https://diviexchange.z6.web.core.windows.net/laendertabelle1.svg
1590912000,1005,585,420,20,7,https://diviexchange.z6.web.core.windows.net/laendertabelle1.svg
1590922800,1005,588,417,20,7,https://diviexchange.z6.web.core.windows.net/laendertabelle1.svg
1590944400,1004,587,417,20,7,https://diviexchange.z6.web.core.windows.net/laendertabelle1.svg
1590948000,987,582,405,18,5,https://diviexchange.z6.web.core.windows.net/laendertabelle1.svg
1590962400,987,583,404,18,5,https://diviexchange.z6.web.core.windows.net/laendertabelle1.svg
1590984000,987,584,403,18,5,https://diviexchange.z6.web.core.windows.net/laendertabelle1.svg
1590987600,987,587,400,18,4,https://diviexchange.z6.web.core.windows.net/laendertabelle1.svg
1590991200,986,574,412,18,4,https://diviexchange.z6.web.core.windows.net/laendertabelle1.svg
1590994800,995,564,431,18,4,https://diviexchange.z6.web.core.windows.net/laendertabelle1.svg
1591002000,994,566,428,18,4,https://diviexchange.z6.web.core.windows.net/laendertabelle1.svg
1591005600,994,565,429,18,4,https://diviexchange.z6.web.core.windows.net/laendertabelle1.svg
1591020000,1011,572,439,20,6,https://diviexchange.z6.web.core.windows.net/laendertabelle1.svg
1591074000,1010,577,433,19,6,https://diviexchange.z6.web.core.windows.net/laendertabelle1.svg
1591077600,1010,564,446,19,6,https://diviexchange.z6.web.core.windows.net/laendertabelle1.svg
1591081200,1006,560,446,19,6,https://diviexchange.z6.web.core.windows.net/laendertabelle1.svg
1591084800,1005,559,446,19,6,https://diviexchange.z6.web.core.windows.net/laendertabelle1.svg
1591160400,1004,589,415,18,5,https://diviexchange.z6.web.core.windows.net/laendertabelle1.svg
1591164000,1004,596,408,19,5,https://diviexchange.z6.web.core.windows.net/laendertabelle1.svg
1591167600,1005,609,396,19,6,https://diviexchange.z6.web.core.windows.net/laendertabelle1.svg
1591178400,1005,609,396,20,6,https://diviexchange.z6.web.core.windows.net/laendertabelle1.svg
1591246800,1008,611,397,16,6,https://diviexchange.z6.web.core.windows.net/laendertabelle1.svg
1591250400,1006,614,392,15,5,https://diviexchange.z6.web.core.windows.net/laendertabelle1.svg
1591254000,1006,622,384,15,6,https://diviexchange.z6.web.core.windows.net/laendertabelle1.svg
1591261200,1004,621,383,15,6,https://diviexchange.z6.web.core.windows.net/laendertabelle1.svg
1591272000,1004,619,385,15,6,https://diviexchange.z6.web.core.windows.net/laendertabelle1.svg
1591333200,1005,622,383,16,6,https://diviexchange.z6.web.core.windows.net/laendertabelle1.svg
1591336800,1005,636,369,16,6,https://diviexchange.z6.web.core.windows.net/laendertabelle1.svg
1591340400,1006,639,367,16,6,https://diviexchange.z6.web.core.windows.net/laendertabelle1.svg
1591344000,1006,638,368,16,6,https://diviexchange.z6.web.core.windows.net/laendertabelle1.svg
1591347600,1006,637,369,15,6,https://diviexchange.z6.web.core.windows.net/laendertabelle1.svg
1591365600,1006,639,367,15,6,https://diviexchange.z6.web.core.windows.net/laendertabelle1.svg
1591416000,1006,638,368,14,6,https://diviexchange.z6.web.core.windows.net/laendertabelle1.svg
1591419600,1006,634,372,14,6,https://diviexchange.z6.web.core.windows.net/laendertabelle1.svg
1591423200,1002,622,380,14,6,https://diviexchange.z6.web.core.windows.net/laendertabelle1.svg
1591426800,1005,624,381,15,6,https://diviexchange.z6.web.core.windows.net/laendertabelle1.svg
1591430400,1005,625,380,15,6,https://diviexchange.z6.web.core.windows.net/laendertabelle1.svg
1591488000,1005,623,382,15,6,https://diviexchange.z6.web.core.windows.net/laendertabelle1.svg
1591506000,1005,619,386,15,6,https://diviexchange.z6.web.core.windows.net/laendertabelle1.svg
1591509600,1007,596,411,14,6,https://diviexchange.z6.web.core.windows.net/laendertabelle1.svg
1591513200,1005,598,407,14,6,https://diviexchange.z6.web.core.windows.net/laendertabelle1.svg
1591516800,1005,596,409,14,6,https://diviexchange.z6.web.core.windows.net/laendertabelle1.svg
1591520400,1005,590,415,13,6,https://diviexchange.z6.web.core.windows.net/laendertabelle1.svg
1591592400,1005,568,437,11,6,https://diviexchange.z6.web.core.windows.net/laendertabelle1.svg
1591596000,1014,568,446,11,6,https://diviexchange.z6.web.core.windows.net/laendertabelle1.svg
1591599600,1014,558,456,11,6,https://diviexchange.z6.web.core.windows.net/laendertabelle1.svg
1591603200,1014,561,453,11,6,https://diviexchange.z6.web.core.windows.net/laendertabelle1.svg
1591678800,1015,583,432,13,6,https://diviexchange.z6.web.core.windows.net/laendertabelle1.svg
1591682400,1013,596,417,13,6,https://diviexchange.z6.web.core.windows.net/laendertabelle1.svg
1591686000,1007,622,385,14,7,https://diviexchange.z6.web.core.windows.net/laendertabelle1.svg
1591696800,1007,622,385,13,6,https://diviexchange.z6.web.core.windows.net/laendertabelle1.svg
1591722000,1007,621,386,13,6,https://diviexchange.z6.web.core.windows.net/laendertabelle1.svg
1591765200,1005,630,375,12,5,https://diviexchange.z6.web.core.windows.net/laendertabelle1.svg
1591768800,1000,633,367,12,5,https://diviexchange.z6.web.core.windows.net/laendertabelle1.svg
1591772400,997,619,378,12,5,https://diviexchange.z6.web.core.windows.net/laendertabelle1.svg
1591959600,994,619,375,13,5,https://diviexchange.z6.web.core.windows.net/laendertabelle1.svg
1592024400,995,620,375,12,5,https://diviexchange.z6.web.core.windows.net/laendertabelle1.svg
1592028000,991,621,370,11,5,https://diviexchange.z6.web.core.windows.net/laendertabelle1.svg
1592031600,994,614,380,12,6,https://diviexchange.z6.web.core.windows.net/laendertabelle1.svg
1592035200,994,621,373,12,6,https://diviexchange.z6.web.core.windows.net/laendertabelle1.svg
1592042400,994,618,376,12,6,https://diviexchange.z6.web.core.windows.net/laendertabelle1.svg
1592049600,994,620,374,12,6,https://diviexchange.z6.web.core.windows.net/laendertabelle1.svg
1592114400,992,598,394,12,6,https://diviexchange.z6.web.core.windows.net/laendertabelle1.svg
1592118000,999,590,409,11,6,https://diviexchange.z6.web.core.windows.net/laendertabelle1.svg
1592121600,999,591,408,11,6,https://diviexchange.z6.web.core.windows.net/laendertabelle1.svg
1592125200,999,594,405,11,6,https://diviexchange.z6.web.core.windows.net/laendertabelle1.svg
1592128800,1000,594,406,10,5,https://diviexchange.z6.web.core.windows.net/laendertabelle1.svg
1592197200,1006,606,400,10,5,https://diviexchange.z6.web.core.windows.net/laendertabelle1.svg
1592200800,1000,595,405,9,4,https://diviexchange.z6.web.core.windows.net/laendertabelle1.svg
1592204400,1002,598,404,9,4,https://diviexchange.z6.web.core.windows.net/laendertabelle1.svg
1592208000,1002,599,403,9,4,https://diviexchange.z6.web.core.windows.net/laendertabelle1.svg
1592211600,1002,597,405,9,3,https://diviexchange.z6.web.core.windows.net/laendertabelle1.svg
1592240400,1002,596,406,9,3,https://diviexchange.z6.web.core.windows.net/laendertabelle1.svg
1592280000,1002,598,404,9,3,https://diviexchange.z6.web.core.windows.net/laendertabelle1.svg
1592283600,998,593,405,7,3,https://diviexchange.z6.web.core.windows.net/laendertabelle1.svg
1592287200,1006,612,394,7,3,https://diviexchange.z6.web.core.windows.net/laendertabelle1.svg
1592290800,1003,619,384,7,3,https://diviexchange.z6.web.core.windows.net/laendertabelle1.svg
1592294400,1003,615,388,6,2,https://diviexchange.z6.web.core.windows.net/laendertabelle1.svg
1592298000,1002,614,388,6,2,https://diviexchange.z6.web.core.windows.net/laendertabelle1.svg
1592366400,1002,617,385,6,2,https://diviexchange.z6.web.core.windows.net/laendertabelle1.svg
1592370000,996,619,377,6,2,https://diviexchange.z6.web.core.windows.net/laendertabelle1.svg
1592373600,992,618,374,5,1,https://diviexchange.z6.web.core.windows.net/laendertabelle1.svg
1592377200,998,631,367,5,1,https://diviexchange.z6.web.core.windows.net/laendertabelle1.svg
1592380800,998,635,363,5,1,https://diviexchange.z6.web.core.windows.net/laendertabelle1.svg
1592384400,998,637,361,5,1,https://diviexchange.z6.web.core.windows.net/laendertabelle1.svg
1592395200,998,638,360,5,1,https://diviexchange.z6.web.core.windows.net/laendertabelle1.svg
1592456400,997,639,358,5,1,https://diviexchange.z6.web.core.windows.net/laendertabelle1.svg
1592460000,998,636,362,5,1,https://diviexchange.z6.web.core.windows.net/laendertabelle1.svg
1592463600,1002,640,362,5,1,https://diviexchange.z6.web.core.windows.net/laendertabelle1.svg
1592467200,1002,641,361,5,1,https://diviexchange.z6.web.core.windows.net/laendertabelle1.svg
1592539200,1002,642,360,5,1,https://diviexchange.z6.web.core.windows.net/laendertabelle1.svg
1592542800,1002,631,371,5,1,https://diviexchange.z6.web.core.windows.net/laendertabelle1.svg
1592546400,999,637,362,5,1,https://diviexchange.z6.web.core.windows.net/laendertabelle1.svg
1592550000,998,632,366,5,1,https://diviexchange.z6.web.core.windows.net/laendertabelle1.svg
1592553600,998,632,366,4,1,https://diviexchange.z6.web.core.windows.net/laendertabelle1.svg
1592557200,997,633,364,4,1,https://diviexchange.z6.web.core.windows.net/laendertabelle1.svg
1592629200,997,616,381,5,1,https://diviexchange.z6.web.core.windows.net/laendertabelle1.svg
1592632800,995,602,393,5,1,https://diviexchange.z6.web.core.windows.net/laendertabelle1.svg
1592636400,996,594,402,5,1,https://diviexchange.z6.web.core.windows.net/laendertabelle1.svg
1592640000,992,589,403,5,1,https://diviexchange.z6.web.core.windows.net/laendertabelle1.svg
1592643600,992,586,406,5,1,https://diviexchange.z6.web.core.windows.net/laendertabelle1.svg
1592672400,992,587,405,5,1,https://diviexchange.z6.web.core.windows.net/laendertabelle1.svg
1592683200,992,585,407,5,1,https://diviexchange.z6.web.core.windows.net/laendertabelle1.svg
1592715600,992,591,401,5,1,https://diviexchange.z6.web.core.windows.net/laendertabelle1.svg
1592719200,998,577,421,4,1,https://diviexchange.z6.web.core.windows.net/laendertabelle1.svg
1592722800,1000,574,426,4,1,https://diviexchange.z6.web.core.windows.net/laendertabelle1.svg
1592726400,999,580,419,4,1,https://diviexchange.z6.web.core.windows.net/laendertabelle1.svg
1592730000,999,575,424,4,1,https://diviexchange.z6.web.core.windows.net/laendertabelle1.svg
1592733600,999,574,425,4,1,https://diviexchange.z6.web.core.windows.net/laendertabelle1.svg
1592740800,1004,574,430,4,1,https://diviexchange.z6.web.core.windows.net/laendertabelle1.svg
1592798400,1004,569,435,4,1,https://diviexchange.z6.web.core.windows.net/laendertabelle1.svg
1592802000,1003,561,442,5,2,https://diviexchange.z6.web.core.windows.net/laendertabelle1.svg
1592805600,999,551,448,5,2,https://diviexchange.z6.web.core.windows.net/laendertabelle1.svg
1592809200,1002,561,441,5,2,https://diviexchange.z6.web.core.windows.net/laendertabelle1.svg
1592834400,997,559,438,5,2,https://diviexchange.z6.web.core.windows.net/laendertabelle1.svg
1592884800,997,564,433,6,2,https://diviexchange.z6.web.core.windows.net/laendertabelle1.svg
1592888400,997,582,415,6,2,https://diviexchange.z6.web.core.windows.net/laendertabelle1.svg
1592892000,993,608,385,6,2,https://diviexchange.z6.web.core.windows.net/laendertabelle1.svg
1592895600,992,610,382,6,2,https://diviexchange.z6.web.core.windows.net/laendertabelle1.svg
1592902800,992,609,383,6,2,https://diviexchange.z6.web.core.windows.net/laendertabelle1.svg
1592906400,996,608,388,6,2,https://diviexchange.z6.web.core.windows.net/laendertabelle1.svg
1592974800,996,605,391,6,2,https://diviexchange.z6.web.core.windows.net/laendertabelle1.svg
1592978400,996,603,393,6,2,https://diviexchange.z6.web.core.windows.net/laendertabelle1.svg
1592982000,996,595,401,5,2,https://diviexchange.z6.web.core.windows.net/laendertabelle1.svg
1592985600,1007,589,418,5,2,https://diviexchange.z6.web.core.windows.net/laendertabelle1.svg
1592989200,1007,588,419,5,2,https://diviexchange.z6.web.core.windows.net/laendertabelle1.svg
1592992800,1007,585,422,5,2,https://diviexchange.z6.web.core.windows.net/laendertabelle1.svg
1593014400,1007,586,421,5,2,https://diviexchange.z6.web.core.windows.net/laendertabelle1.svg
1593061200,1007,594,413,5,2,https://diviexchange.z6.web.core.windows.net/laendertabelle1.svg
1593064800,998,591,407,5,2,https://diviexchange.z6.web.core.windows.net/laendertabelle1.svg
1593068400,1003,612,391,5,2,https://diviexchange.z6.web.core.windows.net/laendertabelle1.svg
1593086400,1010,615,395,5,2,https://diviexchange.z6.web.core.windows.net/laendertabelle1.svg
1593093600,1010,622,388,5,2,https://diviexchange.z6.web.core.windows.net/laendertabelle1.svg
1593144000,1010,623,387,5,2,https://diviexchange.z6.web.core.windows.net/laendertabelle1.svg
1593147600,1013,622,391,5,2,https://diviexchange.z6.web.core.windows.net/laendertabelle1.svg
1593154800,1007,623,384,5,2,https://diviexchange.z6.web.core.windows.net/laendertabelle1.svg
1593158400,1017,633,384,5,2,https://diviexchange.z6.web.core.windows.net/laendertabelle1.svg
1593165600,1019,639,380,5,2,https://diviexchange.z6.web.core.windows.net/laendertabelle1.svg
1593172800,1018,639,379,5,2,https://diviexchange.z6.web.core.windows.net/laendertabelle1.svg
1593176400,1018,638,380,5,2,https://diviexchange.z6.web.core.windows.net/laendertabelle1.svg
1593234000,1018,636,382,5,2,https://diviexchange.z6.web.core.windows.net/laendertabelle1.svg
1593237600,1017,631,386,5,2,https://diviexchange.z6.web.core.windows.net/laendertabelle1.svg
1593241200,1016,621,395,6,3,https://diviexchange.z6.web.core.windows.net/laendertabelle1.svg
1593244800,1004,610,394,6,3,https://diviexchange.z6.web.core.windows.net/laendertabelle1.svg
1593248400,1002,605,397,6,3,https://diviexchange.z6.web.core.windows.net/laendertabelle1.svg
1593252000,1002,604,398,6,3,https://diviexchange.z6.web.core.windows.net/laendertabelle1.svg
1593270000,1003,605,398,6,3,https://diviexchange.z6.web.core.windows.net/laendertabelle1.svg
1593320400,1003,604,399,6,3,https://diviexchange.z6.web.core.windows.net/laendertabelle1.svg
1593324000,1003,602,401,6,3,https://diviexchange.z6.web.core.windows.net/laendertabelle1.svg
1593327600,1011,611,400,6,3,https://diviexchange.z6.web.core.windows.net/laendertabelle1.svg
1593331200,1009,605,404,6,3,https://diviexchange.z6.web.core.windows.net/laendertabelle1.svg
1593338400,1009,593,416,6,3,https://diviexchange.z6.web.core.windows.net/laendertabelle1.svg
1593342000,1009,578,431,5,2,https://diviexchange.z6.web.core.windows.net/laendertabelle1.svg
1593345600,1008,577,431,5,2,https://diviexchange.z6.web.core.windows.net/laendertabelle1.svg
1593378000,1006,575,431,5,2,https://diviexchange.z6.web.core.windows.net/laendertabelle1.svg
1593388800,1000,572,428,5,2,https://diviexchange.z6.web.core.windows.net/laendertabelle1.svg
1593403200,1000,569,431,5,2,https://diviexchange.z6.web.core.windows.net/laendertabelle1.svg
1593406800,1000,561,439,5,2,https://diviexchange.z6.web.core.windows.net/laendertabelle1.svg
1593410400,1002,556,446,5,2,https://diviexchange.z6.web.core.windows.net/laendertabelle1.svg
1593414000,1003,543,460,5,2,https://diviexchange.z6.web.core.windows.net/laendertabelle1.svg
1593417600,1009,550,459,5,2,https://diviexchange.z6.web.core.windows.net/laendertabelle1.svg
1593421200,1009,551,458,5,2,https://diviexchange.z6.web.core.windows.net/laendertabelle1.svg
1593489600,1009,549,460,5,2,https://diviexchange.z6.web.core.windows.net/laendertabelle1.svg
1593493200,1001,569,432,4,1,https://diviexchange.z6.web.core.windows.net/laendertabelle1.svg
1593496800,1006,599,407,4,1,https://diviexchange.z6.web.core.windows.net/laendertabelle1.svg
1593500400,1006,612,394,4,1,https://diviexchange.z6.web.core.windows.net/laendertabelle1.svg
1593504000,1006,616,390,4,1,https://diviexchange.z6.web.core.windows.net/laendertabelle1.svg
1593507600,1006,619,387,4,1,https://diviexchange.z6.web.core.windows.net/laendertabelle1.svg
1593511200,1006,617,389,4,1,https://diviexchange.z6.web.core.windows.net/laendertabelle1.svg
1593579600,1015,616,399,4,1,https://diviexchange.z6.web.core.windows.net/laendertabelle1.svg
1593583200,1017,622,395,4,1,https://diviexchange.z6.web.core.windows.net/laendertabelle1.svg
1593586800,1016,615,401,4,1,https://diviexchange.z6.web.core.windows.net/laendertabelle1.svg
1593590400,1016,617,399,4,1,https://diviexchange.z6.web.core.windows.net/laendertabelle1.svg
1593662400,1016,618,398,4,1,https://diviexchange.z6.web.core.windows.net/laendertabelle1.svg
1593666000,1015,612,403,4,1,https://diviexchange.z6.web.core.windows.net/laendertabelle1.svg
1593669600,1010,620,390,4,1,https://diviexchange.z6.web.core.windows.net/laendertabelle1.svg
1593673200,1010,618,392,4,1,https://diviexchange.z6.web.core.windows.net/laendertabelle1.svg
1593676800,1010,623,387,4,1,https://diviexchange.z6.web.core.windows.net/laendertabelle1.svg
1593680400,1012,630,382,4,1,https://diviexchange.z6.web.core.windows.net/laendertabelle1.svg
1593748800,1011,630,381,3,1,https://diviexchange.z6.web.core.windows.net/laendertabelle1.svg
1593752400,1011,628,383,3,1,https://diviexchange.z6.web.core.windows.net/laendertabelle1.svg
1593756000,1007,620,387,3,1,https://diviexchange.z6.web.core.windows.net/laendertabelle1.svg
1593759600,1001,622,379,3,1,https://diviexchange.z6.web.core.windows.net/laendertabelle1.svg
1593835200,1001,623,378,3,1,https://diviexchange.z6.web.core.windows.net/laendertabelle1.svg
1593838800,1001,620,381,3,1,https://diviexchange.z6.web.core.windows.net/laendertabelle1.svg
1593842400,1001,621,380,3,1,https://diviexchange.z6.web.core.windows.net/laendertabelle1.svg
1593846000,1003,620,383,3,1,https://diviexchange.z6.web.core.windows.net/laendertabelle1.svg
1593849600,1001,630,371,3,1,https://diviexchange.z6.web.core.windows.net/laendertabelle1.svg
1593853200,1001,631,370,3,1,https://diviexchange.z6.web.core.windows.net/laendertabelle1.svg
1593856800,1001,620,381,3,1,https://diviexchange.z6.web.core.windows.net/laendertabelle1.svg
1593903600,1001,615,386,3,1,https://diviexchange.z6.web.core.windows.net/laendertabelle1.svg
1593928800,1002,607,395,3,1,https://diviexchange.z6.web.core.windows.net/laendertabelle1.svg
1593932400,1000,611,389,3,1,https://diviexchange.z6.web.core.windows.net/laendertabelle1.svg
1593936000,1004,588,416,3,1,https://diviexchange.z6.web.core.windows.net/laendertabelle1.svg
1593939600,1004,587,417,3,1,https://diviexchange.z6.web.core.windows.net/laendertabelle1.svg
1593943200,1004,585,419,3,1,https://diviexchange.z6.web.core.windows.net/laendertabelle1.svg
1593972000,1002,584,418,3,1,https://diviexchange.z6.web.core.windows.net/laendertabelle1.svg
1594008000,998,581,417,3,1,https://diviexchange.z6.web.core.windows.net/laendertabelle1.svg
1594011600,996,584,412,3,1,https://diviexchange.z6.web.core.windows.net/laendertabelle1.svg
1594015200,997,584,413,3,1,https://diviexchange.z6.web.core.windows.net/laendertabelle1.svg
1594018800,999,585,414,3,1,https://diviexchange.z6.web.core.windows.net/laendertabelle1.svg
1594022400,1001,589,412,3,1,https://diviexchange.z6.web.core.windows.net/laendertabelle1.svg
1594029600,1001,588,413,3,1,https://diviexchange.z6.web.core.windows.net/laendertabelle1.svg
1594054800,1001,588,413,4,1,https://diviexchange.z6.web.core.windows.net/laendertabelle1.svg
1594072800,1001,591,410,4,1,https://diviexchange.z6.web.core.windows.net/laendertabelle1.svg
1594094400,1005,595,410,4,1,https://diviexchange.z6.web.core.windows.net/laendertabelle1.svg
1594101600,1004,606,398,4,1,https://diviexchange.z6.web.core.windows.net/laendertabelle1.svg
1594105200,1004,607,397,5,1,https://diviexchange.z6.web.core.windows.net/laendertabelle1.svg
1594108800,1004,608,396,5,1,https://diviexchange.z6.web.core.windows.net/laendertabelle1.svg
1594116000,1004,603,401,5,1,https://diviexchange.z6.web.core.windows.net/laendertabelle1.svg
1594180800,1004,606,398,5,1,https://diviexchange.z6.web.core.windows.net/laendertabelle1.svg
1594184400,1004,604,400,5,1,https://diviexchange.z6.web.core.windows.net/laendertabelle1.svg
1594188000,1004,606,398,5,1,https://diviexchange.z6.web.core.windows.net/laendertabelle1.svg
1594191600,1005,611,394,5,1,https://diviexchange.z6.web.core.windows.net/laendertabelle1.svg
1594195200,1005,609,396,5,1,https://diviexchange.z6.web.core.windows.net/laendertabelle1.svg
1594206000,1005,605,400,5,1,https://diviexchange.z6.web.core.windows.net/laendertabelle1.svg
1594270800,1007,612,395,5,1,https://diviexchange.z6.web.core.windows.net/laendertabelle1.svg
1594274400,1007,622,385,5,1,https://diviexchange.z6.web.core.windows.net/laendertabelle1.svg
1594278000,1007,636,371,5,1,https://diviexchange.z6.web.core.windows.net/laendertabelle1.svg
1594281600,1007,638,369,5,1,https://diviexchange.z6.web.core.windows.net/laendertabelle1.svg
1594288800,1008,632,376,5,1,https://diviexchange.z6.web.core.windows.net/laendertabelle1.svg
1594303200,1008,631,377,5,1,https://diviexchange.z6.web.core.windows.net/laendertabelle1.svg
1594317600,992,617,375,5,1,https://diviexchange.z6.web.core.windows.net/laendertabelle1.svg
1594328400,1008,626,382,5,1,https://diviexchange.z6.web.core.windows.net/laendertabelle1.svg
1594339200,1008,628,380,5,1,https://diviexchange.z6.web.core.windows.net/laendertabelle1.svg
1594357200,1005,642,363,5,1,https://diviexchange.z6.web.core.windows.net/laendertabelle1.svg
1594360800,1006,639,367,5,1,https://diviexchange.z6.web.core.windows.net/laendertabelle1.svg
1594368000,1005,632,373,5,1,https://diviexchange.z6.web.core.windows.net/laendertabelle1.svg
1594371600,1004,628,376,5,1,https://diviexchange.z6.web.core.windows.net/laendertabelle1.svg
1594378800,1004,632,372,5,1,https://diviexchange.z6.web.core.windows.net/laendertabelle1.svg
1594440000,1004,629,375,5,1,https://diviexchange.z6.web.core.windows.net/laendertabelle1.svg
1594443600,1004,628,376,5,1,https://diviexchange.z6.web.core.windows.net/laendertabelle1.svg
1594447200,1004,623,381,5,1,https://diviexchange.z6.web.core.windows.net/laendertabelle1.svg
1594450800,1001,609,392,4,1,https://diviexchange.z6.web.core.windows.net/laendertabelle1.svg
1594454400,1001,606,395,4,1,https://diviexchange.z6.web.core.windows.net/laendertabelle1.svg
1594458000,999,606,393,4,1,https://diviexchange.z6.web.core.windows.net/laendertabelle1.svg
1594461600,1000,602,398,4,1,https://diviexchange.z6.web.core.windows.net/laendertabelle1.svg
1594530000,1000,600,400,4,1,https://diviexchange.z6.web.core.windows.net/laendertabelle1.svg
1594533600,991,581,410,4,1,https://diviexchange.z6.web.core.windows.net/laendertabelle1.svg
1594537200,1002,592,410,4,1,https://diviexchange.z6.web.core.windows.net/laendertabelle1.svg
1594540800,1004,596,408,4,1,https://diviexchange.z6.web.core.windows.net/laendertabelle1.svg
1594544400,1005,591,414,4,1,https://diviexchange.z6.web.core.windows.net/laendertabelle1.svg
1594548000,1005,590,415,4,1,https://diviexchange.z6.web.core.windows.net/laendertabelle1.svg
1594594800,997,584,413,4,1,https://diviexchange.z6.web.core.windows.net/laendertabelle1.svg
1594612800,997,583,414,4,1,https://diviexchange.z6.web.core.windows.net/laendertabelle1.svg
1594616400,995,592,403,4,1,https://diviexchange.z6.web.core.windows.net/laendertabelle1.svg
1594620000,1001,592,409,4,1,https://diviexchange.z6.web.core.windows.net/laendertabelle1.svg
1594623600,996,592,404,4,1,https://diviexchange.z6.web.core.windows.net/laendertabelle1.svg
1594674000,984,585,399,4,1,https://diviexchange.z6.web.core.windows.net/laendertabelle1.svg
1594702800,984,598,386,4,1,https://diviexchange.z6.web.core.windows.net/laendertabelle1.svg
1594706400,983,606,377,4,1,https://diviexchange.z6.web.core.windows.net/laendertabelle1.svg
1594710000,984,609,375,4,1,https://diviexchange.z6.web.core.windows.net/laendertabelle1.svg
1594713600,984,608,376,4,1,https://diviexchange.z6.web.core.windows.net/laendertabelle1.svg
1594717200,983,615,368,4,1,https://diviexchange.z6.web.core.windows.net/laendertabelle1.svg
1594720800,983,622,361,4,1,https://diviexchange.z6.web.core.windows.net/laendertabelle1.svg
1594728000,981,623,358,4,1,https://diviexchange.z6.web.core.windows.net/laendertabelle1.svg
1594731600,993,631,362,4,1,https://diviexchange.z6.web.core.windows.net/laendertabelle1.svg
1594749600,987,628,359,4,1,https://diviexchange.z6.web.core.windows.net/laendertabelle1.svg
1594760400,993,634,359,4,1,https://diviexchange.z6.web.core.windows.net/laendertabelle1.svg
1594789200,1000,636,364,4,1,https://diviexchange.z6.web.core.windows.net/laendertabelle1.svg
1594792800,1000,635,365,4,1,https://diviexchange.z6.web.core.windows.net/laendertabelle1.svg
1594796400,1000,639,361,4,1,https://diviexchange.z6.web.core.windows.net/laendertabelle1.svg
1594800000,1000,635,365,4,1,https://diviexchange.z6.web.core.windows.net/laendertabelle1.svg
1594803600,1000,633,367,4,1,https://diviexchange.z6.web.core.windows.net/laendertabelle1.svg
1594807200,1000,637,363,4,1,https://diviexchange.z6.web.core.windows.net/laendertabelle1.svg
1594821600,1000,636,364,4,1,https://diviexchange.z6.web.core.windows.net/laendertabelle1.svg
1594854000,998,633,365,4,1,https://diviexchange.z6.web.core.windows.net/laendertabelle1.svg
1594875600,998,644,354,4,1,https://diviexchange.z6.web.core.windows.net/laendertabelle1.svg
1594879200,999,638,361,4,1,https://diviexchange.z6.web.core.windows.net/laendertabelle1.svg
1594882800,997,645,352,4,1,https://diviexchange.z6.web.core.windows.net/laendertabelle1.svg
1594886400,996,639,357,4,1,https://diviexchange.z6.web.core.windows.net/laendertabelle1.svg
1594893600,996,642,354,4,1,https://diviexchange.z6.web.core.windows.net/laendertabelle1.svg
1594900800,994,640,354,4,1,https://diviexchange.z6.web.core.windows.net/laendertabelle1.svg
1594929600,994,639,355,4,1,https://diviexchange.z6.web.core.windows.net/laendertabelle1.svg
1594940400,994,638,356,4,1,https://diviexchange.z6.web.core.windows.net/laendertabelle1.svg
1594958400,994,640,354,4,1,https://diviexchange.z6.web.core.windows.net/laendertabelle1.svg
1594962000,991,639,352,4,1,https://diviexchange.z6.web.core.windows.net/laendertabelle1.svg
1594965600,995,640,355,4,1,https://diviexchange.z6.web.core.windows.net/laendertabelle1.svg
1594969200,995,642,353,4,1,https://diviexchange.z6.web.core.windows.net/laendertabelle1.svg
1594972800,995,637,358,4,1,https://diviexchange.z6.web.core.windows.net/laendertabelle1.svg
1594976400,995,631,364,4,1,https://diviexchange.z6.web.core.windows.net/laendertabelle1.svg
1595048400,995,629,366,4,1,https://diviexchange.z6.web.core.windows.net/laendertabelle1.svg
1595052000,996,621,375,4,1,https://diviexchange.z6.web.core.windows.net/laendertabelle1.svg
1595055600,994,611,383,4,1,https://diviexchange.z6.web.core.windows.net/laendertabelle1.svg
1595062800,994,605,389,4,1,https://diviexchange.z6.web.core.windows.net/laendertabelle1.svg
1595066400,1005,602,403,4,1,https://diviexchange.z6.web.core.windows.net/laendertabelle1.svg
1595095200,1005,599,406,4,1,https://diviexchange.z6.web.core.windows.net/laendertabelle1.svg
1595134800,1005,597,408,4,1,https://diviexchange.z6.web.core.windows.net/laendertabelle1.svg
1595138400,1005,596,409,4,1,https://diviexchange.z6.web.core.windows.net/laendertabelle1.svg
1595142000,1005,582,423,2,1,https://diviexchange.z6.web.core.windows.net/laendertabelle1.svg
1595145600,1005,583,422,2,1,https://diviexchange.z6.web.core.windows.net/laendertabelle1.svg
1595149200,1005,584,421,2,1,https://diviexchange.z6.web.core.windows.net/laendertabelle1.svg
1595152800,1005,583,422,2,1,https://diviexchange.z6.web.core.windows.net/laendertabelle1.svg
1595156400,1005,589,416,2,1,https://diviexchange.z6.web.core.windows.net/laendertabelle1.svg
1595170800,1005,591,414,2,1,https://diviexchange.z6.web.core.windows.net/laendertabelle1.svg
1595174400,1006,593,413,2,1,https://diviexchange.z6.web.core.windows.net/laendertabelle1.svg
1595221200,993,599,394,2,1,https://diviexchange.z6.web.core.windows.net/laendertabelle1.svg
1595224800,1005,601,404,2,1,https://diviexchange.z6.web.core.windows.net/laendertabelle1.svg
1595228400,1016,607,409,2,1,https://diviexchange.z6.web.core.windows.net/laendertabelle1.svg
1595232000,1016,608,408,2,1,https://diviexchange.z6.web.core.windows.net/laendertabelle1.svg
1595235600,1018,610,408,2,1,https://diviexchange.z6.web.core.windows.net/laendertabelle1.svg
1595239200,1019,615,404,2,1,https://diviexchange.z6.web.core.windows.net/laendertabelle1.svg
1595286000,1013,609,404,2,1,https://diviexchange.z6.web.core.windows.net/laendertabelle1.svg
1595307600,1005,623,382,2,1,https://diviexchange.z6.web.core.windows.net/laendertabelle1.svg
1595311200,1018,628,390,2,1,https://diviexchange.z6.web.core.windows.net/laendertabelle1.svg
1595314800,1051,673,378,2,1,https://diviexchange.z6.web.core.windows.net/laendertabelle1.svg
1595318400,1051,675,376,2,1,https://diviexchange.z6.web.core.windows.net/laendertabelle1.svg
1595322000,1051,672,379,2,1,https://diviexchange.z6.web.core.windows.net/laendertabelle1.svg
1595329200,1048,671,377,2,1,https://diviexchange.z6.web.core.windows.net/laendertabelle1.svg
1595394000,1034,673,361,2,1,https://diviexchange.z6.web.core.windows.net/laendertabelle1.svg
1595397600,1049,672,377,2,1,https://diviexchange.z6.web.core.windows.net/laendertabelle1.svg
1595401200,1050,670,380,2,1,https://diviexchange.z6.web.core.windows.net/laendertabelle1.svg
1595404800,1050,669,381,2,1,https://diviexchange.z6.web.core.windows.net/laendertabelle1.svg
1595408400,1051,668,383,2,1,https://diviexchange.z6.web.core.windows.net/laendertabelle1.svg
1595412000,1051,654,397,2,1,https://diviexchange.z6.web.core.windows.net/laendertabelle1.svg
1595419200,1043,654,389,2,1,https://diviexchange.z6.web.core.windows.net/laendertabelle1.svg
1595422800,1043,656,387,2,1,https://diviexchange.z6.web.core.windows.net/laendertabelle1.svg
1595480400,1053,642,411,2,1,https://diviexchange.z6.web.core.windows.net/laendertabelle1.svg
1595484000,1052,641,411,2,1,https://diviexchange.z6.web.core.windows.net/laendertabelle1.svg
1595487600,1047,635,412,2,1,https://diviexchange.z6.web.core.windows.net/laendertabelle1.svg
1595491200,1046,641,405,2,1,https://diviexchange.z6.web.core.windows.net/laendertabelle1.svg
1595502000,1044,639,405,2,1,https://diviexchange.z6.web.core.windows.net/laendertabelle1.svg
1595512800,1042,639,403,2,1,https://diviexchange.z6.web.core.windows.net/laendertabelle1.svg
1595566800,1042,644,398,2,1,https://diviexchange.z6.web.core.windows.net/laendertabelle1.svg
1595570400,1041,656,385,2,1,https://diviexchange.z6.web.core.windows.net/laendertabelle1.svg
1595574000,1041,659,382,2,1,https://diviexchange.z6.web.core.windows.net/laendertabelle1.svg
1595577600,1043,645,398,2,1,https://diviexchange.z6.web.core.windows.net/laendertabelle1.svg
1595653200,1043,642,401,2,1,https://diviexchange.z6.web.core.windows.net/laendertabelle1.svg
1595656800,1038,637,401,3,1,https://diviexchange.z6.web.core.windows.net/laendertabelle1.svg
1595660400,1037,623,414,3,1,https://diviexchange.z6.web.core.windows.net/laendertabelle1.svg
1595664000,1031,626,405,3,1,https://diviexchange.z6.web.core.windows.net/laendertabelle1.svg
1595667600,1031,632,399,4,1,https://diviexchange.z6.web.core.windows.net/laendertabelle1.svg
1595671200,1043,637,406,4,1,https://diviexchange.z6.web.core.windows.net/laendertabelle1.svg
1595678400,1043,638,405,4,1,https://diviexchange.z6.web.core.windows.net/laendertabelle1.svg
1595736000,1043,640,403,4,1,https://diviexchange.z6.web.core.windows.net/laendertabelle1.svg
1595739600,1043,639,404,5,1,https://diviexchange.z6.web.core.windows.net/laendertabelle1.svg
1595743200,1039,622,417,5,1,https://diviexchange.z6.web.core.windows.net/laendertabelle1.svg
1595746800,1039,621,418,5,1,https://diviexchange.z6.web.core.windows.net/laendertabelle1.svg
1595750400,1039,622,417,5,1,https://diviexchange.z6.web.core.windows.net/laendertabelle1.svg
1595754000,1043,623,420,5,1,https://diviexchange.z6.web.core.windows.net/laendertabelle1.svg
1595768400,1043,607,436,5,1,https://diviexchange.z6.web.core.windows.net/laendertabelle1.svg
1595790000,1043,608,435,5,1,https://diviexchange.z6.web.core.windows.net/laendertabelle1.svg
1595804400,1033,603,430,5,1,https://diviexchange.z6.web.core.windows.net/laendertabelle1.svg
1595826000,1033,601,432,5,1,https://diviexchange.z6.web.core.windows.net/laendertabelle1.svg
1595829600,1035,604,431,5,1,https://diviexchange.z6.web.core.windows.net/laendertabelle1.svg
1595833200,1045,613,432,5,1,https://diviexchange.z6.web.core.windows.net/laendertabelle1.svg
1595836800,1045,603,442,5,1,https://diviexchange.z6.web.core.windows.net/laendertabelle1.svg
1595840400,1045,605,440,5,1,https://diviexchange.z6.web.core.windows.net/laendertabelle1.svg
1595844000,1045,604,441,5,1,https://diviexchange.z6.web.core.windows.net/laendertabelle1.svg
1595912400,1045,613,432,5,1,https://diviexchange.z6.web.core.windows.net/laendertabelle1.svg
1595916000,1044,632,412,4,0,https://diviexchange.z6.web.core.windows.net/laendertabelle1.svg
1595919600,1042,643,399,4,0,https://diviexchange.z6.web.core.windows.net/laendertabelle1.svg
1595923200,1042,654,388,4,0,https://diviexchange.z6.web.core.windows.net/laendertabelle1.svg
1595926800,1049,664,385,4,0,https://diviexchange.z6.web.core.windows.net/laendertabelle1.svg
1595998800,1049,669,380,3,0,https://diviexchange.z6.web.core.windows.net/laendertabelle1.svg
1596002400,1046,673,373,3,0,https://diviexchange.z6.web.core.windows.net/laendertabelle1.svg
1596006000,1046,655,391,3,0,https://diviexchange.z6.web.core.windows.net/laendertabelle1.svg
1596013200,1046,661,385,3,0,https://diviexchange.z6.web.core.windows.net/laendertabelle1.svg
1596016800,1046,665,381,3,0,https://diviexchange.z6.web.core.windows.net/laendertabelle1.svg
1596020400,1046,664,382,3,0,https://diviexchange.z6.web.core.windows.net/laendertabelle1.svg
1596024000,1046,663,383,3,0,https://diviexchange.z6.web.core.windows.net/laendertabelle1.svg
1596085200,1055,671,384,3,0,https://diviexchange.z6.web.core.windows.net/laendertabelle1.svg
1596088800,1054,665,389,3,0,https://diviexchange.z6.web.core.windows.net/laendertabelle1.svg
1596092400,1054,670,384,3,0,https://diviexchange.z6.web.core.windows.net/laendertabelle1.svg
1596096000,1054,663,391,3,0,https://diviexchange.z6.web.core.windows.net/laendertabelle1.svg
1596099600,1054,666,388,3,0,https://diviexchange.z6.web.core.windows.net/laendertabelle1.svg
1596139200,1044,659,385,3,0,https://diviexchange.z6.web.core.windows.net/laendertabelle1.svg
1596171600,1044,649,395,3,0,https://diviexchange.z6.web.core.windows.net/laendertabelle1.svg
1596175200,1063,672,391,3,0,https://diviexchange.z6.web.core.windows.net/laendertabelle1.svg
1596178800,1059,672,387,3,0,https://diviexchange.z6.web.core.windows.net/laendertabelle1.svg
1596182400,1059,670,389,3,0,https://diviexchange.z6.web.core.windows.net/laendertabelle1.svg
1596189600,1059,671,388,3,0,https://diviexchange.z6.web.core.windows.net/laendertabelle1.svg
1596193200,1059,668,391,3,0,https://diviexchange.z6.web.core.windows.net/laendertabelle1.svg
1596200400,1059,666,393,3,0,https://diviexchange.z6.web.core.windows.net/laendertabelle1.svg
1596261600,1059,647,412,3,0,https://diviexchange.z6.web.core.windows.net/laendertabelle1.svg
1596265200,1057,641,416,3,0,https://diviexchange.z6.web.core.windows.net/laendertabelle1.svg
1596268800,1057,645,412,3,0,https://diviexchange.z6.web.core.windows.net/laendertabelle1.svg
1596272400,1057,644,413,3,0,https://diviexchange.z6.web.core.windows.net/laendertabelle1.svg
1596276000,1048,641,407,3,0,https://diviexchange.z6.web.core.windows.net/laendertabelle1.svg
1596279600,1048,640,408,3,0,https://diviexchange.z6.web.core.windows.net/laendertabelle1.svg
1596344400,1048,643,405,3,0,https://diviexchange.z6.web.core.windows.net/laendertabelle1.svg
1596348000,1051,628,423,3,0,https://diviexchange.z6.web.core.windows.net/laendertabelle1.svg
1596351600,1049,619,430,3,0,https://diviexchange.z6.web.core.windows.net/laendertabelle1.svg
1596355200,1049,617,432,3,0,https://diviexchange.z6.web.core.windows.net/laendertabelle1.svg
1596358800,1049,607,442,3,0,https://diviexchange.z6.web.core.windows.net/laendertabelle1.svg
1596362400,1049,610,439,3,0,https://diviexchange.z6.web.core.windows.net/laendertabelle1.svg
1596380400,1049,605,444,2,0,https://diviexchange.z6.web.core.windows.net/laendertabelle1.svg
1596427200,1050,607,443,2,0,https://diviexchange.z6.web.core.windows.net/laendertabelle1.svg
1596430800,1049,610,439,2,0,https://diviexchange.z6.web.core.windows.net/laendertabelle1.svg
1596434400,1047,616,431,2,0,https://diviexchange.z6.web.core.windows.net/laendertabelle1.svg
1596438000,1057,624,433,2,0,https://diviexchange.z6.web.core.windows.net/laendertabelle1.svg
1596441600,1056,627,429,3,0,https://diviexchange.z6.web.core.windows.net/laendertabelle1.svg
1596445200,1056,620,436,4,0,https://diviexchange.z6.web.core.windows.net/laendertabelle1.svg
1596448800,1056,616,440,4,0,https://diviexchange.z6.web.core.windows.net/laendertabelle1.svg
1596466800,1066,618,448,4,0,https://diviexchange.z6.web.core.windows.net/laendertabelle1.svg
1596567600,1015,602,413,3,0,https://diviexchange.z6.web.core.windows.net/laendertabelle1.svg
1596628800,1009,597,412,3,0,https://diviexchange.z6.web.core.windows.net/laendertabelle1.svg
1596664805,933,620,313,6,0,https://www.intensivregister.de/api/public/reporting/laendertabelle
1596682805,933,615,318,6,0,https://www.intensivregister.de/api/public/reporting/laendertabelle
1596686406,933,618,315,6,0,https://www.intensivregister.de/api/public/reporting/laendertabelle
1596690005,933,620,313,6,0,https://www.intensivregister.de/api/public/reporting/laendertabelle
1596693606,932,625,307,6,0,https://www.intensivregister.de/api/public/reporting/laendertabelle
1596697205,932,623,309,6,0,https://www.intensivregister.de/api/public/reporting/laendertabelle
1596700806,919,620,299,6,0,https://www.intensivregister.de/api/public/reporting/laendertabelle
1596769205,919,619,300,6,0,https://www.intensivregister.de/api/public/reporting/laendertabelle
1596772805,919,618,301,6,0,https://www.intensivregister.de/api/public/reporting/laendertabelle
1596776405,917,629,288,5,0,https://www.intensivregister.de/api/public/reporting/laendertabelle
1596780005,917,631,286,5,0,https://www.intensivregister.de/api/public/reporting/laendertabelle
1596783606,917,630,287,5,0,https://www.intensivregister.de/api/public/reporting/laendertabelle
1596787205,917,628,289,5,0,https://www.intensivregister.de/api/public/reporting/laendertabelle
1596834005,917,629,288,5,0,https://www.intensivregister.de/api/public/reporting/laendertabelle
1596855605,917,624,293,5,0,https://www.intensivregister.de/api/public/reporting/laendertabelle
1596859205,917,628,289,5,0,https://www.intensivregister.de/api/public/reporting/laendertabelle
1596862805,917,616,301,4,0,https://www.intensivregister.de/api/public/reporting/laendertabelle
1596866406,916,612,304,5,0,https://www.intensivregister.de/api/public/reporting/laendertabelle
1596888005,916,611,305,5,0,https://www.intensivregister.de/api/public/reporting/laendertabelle
1596906005,906,609,297,5,0,https://www.intensivregister.de/api/public/reporting/laendertabelle
1596945605,906,599,307,5,0,https://www.intensivregister.de/api/public/reporting/laendertabelle
1596949205,906,602,304,3,0,https://www.intensivregister.de/api/public/reporting/laendertabelle
1596952805,906,591,315,3,0,https://www.intensivregister.de/api/public/reporting/laendertabelle
1596956405,906,587,319,3,0,https://www.intensivregister.de/api/public/reporting/laendertabelle
1596960005,904,593,311,3,0,https://www.intensivregister.de/api/public/reporting/laendertabelle
1596970806,901,583,318,3,0,https://www.intensivregister.de/api/public/reporting/laendertabelle
1596985205,835,533,302,3,0,https://www.intensivregister.de/api/public/reporting/laendertabelle
1597024805,901,593,308,3,0,https://www.intensivregister.de/api/public/reporting/laendertabelle
1597028406,901,594,307,3,0,https://www.intensivregister.de/api/public/reporting/laendertabelle
1597032006,901,606,295,3,0,https://www.intensivregister.de/api/public/reporting/laendertabelle
1597035606,920,619,301,3,0,https://www.intensivregister.de/api/public/reporting/laendertabelle
1597039206,920,616,304,3,0,https://www.intensivregister.de/api/public/reporting/laendertabelle
1597042806,922,615,307,3,0,https://www.intensivregister.de/api/public/reporting/laendertabelle
1597114805,922,611,311,3,0,https://www.intensivregister.de/api/public/reporting/laendertabelle
1597118405,912,618,294,3,0,https://www.intensivregister.de/api/public/reporting/laendertabelle
1597122006,912,635,277,3,0,https://www.intensivregister.de/api/public/reporting/laendertabelle
1597125605,912,631,281,3,0,https://www.intensivregister.de/api/public/reporting/laendertabelle
1597132806,912,629,283,3,0,https://www.intensivregister.de/api/public/reporting/laendertabelle
1597140006,912,633,279,3,0,https://www.intensivregister.de/api/public/reporting/laendertabelle
1597143606,912,634,278,3,0,https://www.intensivregister.de/api/public/reporting/laendertabelle
1597201206,912,627,285,3,0,https://www.intensivregister.de/api/public/reporting/laendertabelle
1597204805,917,623,294,3,0,https://www.intensivregister.de/api/public/reporting/laendertabelle
1597208406,917,621,296,4,1,https://www.intensivregister.de/api/public/reporting/laendertabelle
1597212006,917,633,284,3,1,https://www.intensivregister.de/api/public/reporting/laendertabelle
1597215606,917,634,283,3,1,https://www.intensivregister.de/api/public/reporting/laendertabelle
1597219206,917,633,284,3,1,https://www.intensivregister.de/api/public/reporting/laendertabelle
1597287605,917,639,278,3,1,https://www.intensivregister.de/api/public/reporting/laendertabelle
1597291206,914,634,280,3,1,https://www.intensivregister.de/api/public/reporting/laendertabelle
1597294806,915,636,279,3,1,https://www.intensivregister.de/api/public/reporting/laendertabelle
1597298405,915,632,283,3,1,https://www.intensivregister.de/api/public/reporting/laendertabelle
1597302005,915,634,281,3,1,https://www.intensivregister.de/api/public/reporting/laendertabelle
1597305606,915,633,282,3,1,https://www.intensivregister.de/api/public/reporting/laendertabelle
1597374006,905,634,271,3,1,https://www.intensivregister.de/api/public/reporting/laendertabelle
1597377606,906,635,271,3,1,https://www.intensivregister.de/api/public/reporting/laendertabelle
1597381206,899,637,262,3,1,https://www.intensivregister.de/api/public/reporting/laendertabelle
1597384806,899,641,258,3,1,https://www.intensivregister.de/api/public/reporting/laendertabelle
1597464005,866,604,262,3,1,https://www.intensivregister.de/api/public/reporting/laendertabelle
1597467605,866,605,261,3,1,https://www.intensivregister.de/api/public/reporting/laendertabelle
1597471205,864,609,255,3,1,https://www.intensivregister.de/api/public/reporting/laendertabelle
1597482005,864,608,256,3,1,https://www.intensivregister.de/api/public/reporting/laendertabelle
1597550405,864,611,253,3,1,https://www.intensivregister.de/api/public/reporting/laendertabelle
1597554005,862,591,271,3,1,https://www.intensivregister.de/api/public/reporting/laendertabelle
1597557605,862,585,277,3,1,https://www.intensivregister.de/api/public/reporting/laendertabelle
1597561205,862,584,278,3,1,https://www.intensivregister.de/api/public/reporting/laendertabelle
1597582805,862,585,277,3,1,https://www.intensivregister.de/api/public/reporting/laendertabelle
1597586405,862,581,281,3,1,https://www.intensivregister.de/api/public/reporting/laendertabelle
1597593605,812,532,280,3,1,https://www.intensivregister.de/api/public/reporting/laendertabelle
1597604405,804,530,274,3,1,https://www.intensivregister.de/api/public/reporting/laendertabelle
1597633205,791,516,275,3,1,https://www.intensivregister.de/api/public/reporting/laendertabelle
1597636806,841,570,271,3,1,https://www.intensivregister.de/api/public/reporting/laendertabelle
1597640405,843,565,278,3,1,https://www.intensivregister.de/api/public/reporting/laendertabelle
1597644006,850,568,282,3,0,https://www.intensivregister.de/api/public/reporting/laendertabelle
1597647606,850,567,283,3,0,https://www.intensivregister.de/api/public/reporting/laendertabelle
1597654805,850,569,281,3,0,https://www.intensivregister.de/api/public/reporting/laendertabelle
1597665605,858,571,287,3,0,https://www.intensivregister.de/api/public/reporting/laendertabelle
1597719606,860,579,281,3,0,https://www.intensivregister.de/api/public/reporting/laendertabelle
1597723205,860,576,284,3,0,https://www.intensivregister.de/api/public/reporting/laendertabelle
1597726807,875,581,294,3,0,https://www.intensivregister.de/api/public/reporting/laendertabelle
1597730407,875,582,293,3,0,https://www.intensivregister.de/api/public/reporting/laendertabelle
1597734006,875,580,295,3,0,https://www.intensivregister.de/api/public/reporting/laendertabelle
1597806005,875,569,306,3,0,https://www.intensivregister.de/api/public/reporting/laendertabelle
1597809605,875,578,297,3,0,https://www.intensivregister.de/api/public/reporting/laendertabelle
1597813206,875,590,285,3,0,https://www.intensivregister.de/api/public/reporting/laendertabelle
1597816806,875,593,282,3,0,https://www.intensivregister.de/api/public/reporting/laendertabelle
1597820407,875,594,281,3,0,https://www.intensivregister.de/api/public/reporting/laendertabelle
1597824006,876,590,286,3,0,https://www.intensivregister.de/api/public/reporting/laendertabelle
1597870805,854,570,284,3,0,https://www.intensivregister.de/api/public/reporting/laendertabelle
1597892405,854,576,278,3,0,https://www.intensivregister.de/api/public/reporting/laendertabelle
1597896007,854,582,272,3,0,https://www.intensivregister.de/api/public/reporting/laendertabelle
1597899605,884,620,264,3,0,https://www.intensivregister.de/api/public/reporting/laendertabelle
1597903206,884,621,263,3,0,https://www.intensivregister.de/api/public/reporting/laendertabelle
1597906805,906,631,275,3,0,https://www.intensivregister.de/api/public/reporting/laendertabelle
1597914006,906,633,273,3,0,https://www.intensivregister.de/api/public/reporting/laendertabelle
1597957205,898,632,266,3,0,https://www.intensivregister.de/api/public/reporting/laendertabelle
1597978805,898,641,257,3,0,https://www.intensivregister.de/api/public/reporting/laendertabelle
1597982405,898,649,249,3,0,https://www.intensivregister.de/api/public/reporting/laendertabelle
1597986006,898,642,256,4,1,https://www.intensivregister.de/api/public/reporting/laendertabelle
1597989606,898,644,254,4,1,https://www.intensivregister.de/api/public/reporting/laendertabelle
1597996806,906,646,260,4,1,https://www.intensivregister.de/api/public/reporting/laendertabelle
1598068805,906,638,268,3,1,https://www.intensivregister.de/api/public/reporting/laendertabelle
1598072405,906,635,271,3,1,https://www.intensivregister.de/api/public/reporting/laendertabelle
1598076005,906,634,272,3,1,https://www.intensivregister.de/api/public/reporting/laendertabelle
1598079605,906,638,268,3,1,https://www.intensivregister.de/api/public/reporting/laendertabelle
1598094005,906,637,269,3,1,https://www.intensivregister.de/api/public/reporting/laendertabelle
1598097605,906,628,278,3,1,https://www.intensivregister.de/api/public/reporting/laendertabelle
1598101205,906,623,283,3,1,https://www.intensivregister.de/api/public/reporting/laendertabelle
1598151605,906,622,284,3,1,https://www.intensivregister.de/api/public/reporting/laendertabelle
1598155205,906,608,298,3,1,https://www.intensivregister.de/api/public/reporting/laendertabelle
1598158805,904,609,295,3,1,https://www.intensivregister.de/api/public/reporting/laendertabelle
1598162405,903,597,306,3,1,https://www.intensivregister.de/api/public/reporting/laendertabelle
1598166006,903,596,307,3,1,https://www.intensivregister.de/api/public/reporting/laendertabelle
1598169605,903,593,310,3,1,https://www.intensivregister.de/api/public/reporting/laendertabelle
1598238005,903,585,318,3,1,https://www.intensivregister.de/api/public/reporting/laendertabelle
1598241606,905,579,326,3,1,https://www.intensivregister.de/api/public/reporting/laendertabelle
1598245206,902,590,312,3,1,https://www.intensivregister.de/api/public/reporting/laendertabelle
1598248807,902,589,313,3,1,https://www.intensivregister.de/api/public/reporting/laendertabelle
1598259606,902,595,307,3,1,https://www.intensivregister.de/api/public/reporting/laendertabelle
1598310005,902,597,305,3,1,https://www.intensivregister.de/api/public/reporting/laendertabelle
1598324406,902,603,299,3,1,https://www.intensivregister.de/api/public/reporting/laendertabelle
1598328006,902,592,310,1,1,https://www.intensivregister.de/api/public/reporting/laendertabelle
1598331606,908,606,302,1,1,https://www.intensivregister.de/api/public/reporting/laendertabelle
1598335207,910,610,300,1,1,https://www.intensivregister.de/api/public/reporting/laendertabelle
1598338806,910,622,288,1,1,https://www.intensivregister.de/api/public/reporting/laendertabelle
1598349606,910,624,286,1,1,https://www.intensivregister.de/api/public/reporting/laendertabelle
1598396405,910,623,287,1,1,https://www.intensivregister.de/api/public/reporting/laendertabelle
1598410805,910,636,274,1,1,https://www.intensivregister.de/api/public/reporting/laendertabelle
1598414405,912,658,254,2,1,https://www.intensivregister.de/api/public/reporting/laendertabelle
1598418009,912,651,261,2,1,https://www.intensivregister.de/api/public/reporting/laendertabelle
1598421607,912,654,258,2,1,https://www.intensivregister.de/api/public/reporting/laendertabelle
1598425206,912,653,259,2,1,https://www.intensivregister.de/api/public/reporting/laendertabelle
1598475605,904,647,257,2,1,https://www.intensivregister.de/api/public/reporting/laendertabelle
1598497205,902,633,269,3,1,https://www.intensivregister.de/api/public/reporting/laendertabelle
1598500805,902,626,276,2,1,https://www.intensivregister.de/api/public/reporting/laendertabelle
1598511605,910,627,283,3,2,https://www.intensivregister.de/api/public/reporting/laendertabelle
1598515206,910,626,284,3,2,https://www.intensivregister.de/api/public/reporting/laendertabelle
1598522407,910,627,283,3,2,https://www.intensivregister.de/api/public/reporting/laendertabelle
1598583605,910,614,296,3,2,https://www.intensivregister.de/api/public/reporting/laendertabelle
1598587205,910,619,291,3,2,https://www.intensivregister.de/api/public/reporting/laendertabelle
1598590806,910,616,294,3,2,https://www.intensivregister.de/api/public/reporting/laendertabelle
1598594407,910,615,295,3,2,https://www.intensivregister.de/api/public/reporting/laendertabelle
1598598006,910,614,296,3,2,https://www.intensivregister.de/api/public/reporting/laendertabelle
1598605209,910,615,295,3,2,https://www.intensivregister.de/api/public/reporting/laendertabelle
1598670005,910,604,306,4,2,https://www.intensivregister.de/api/public/reporting/laendertabelle
1598673605,910,610,300,4,2,https://www.intensivregister.de/api/public/reporting/laendertabelle
1598677205,908,614,294,4,2,https://www.intensivregister.de/api/public/reporting/laendertabelle
1598680806,909,606,303,4,1,https://www.intensivregister.de/api/public/reporting/laendertabelle
1598698806,909,609,300,4,1,https://www.intensivregister.de/api/public/reporting/laendertabelle
1598702405,909,607,302,4,1,https://www.intensivregister.de/api/public/reporting/laendertabelle
1598716806,909,610,299,4,1,https://www.intensivregister.de/api/public/reporting/laendertabelle
1598745605,909,608,301,4,1,https://www.intensivregister.de/api/public/reporting/laendertabelle
1598756405,909,607,302,4,1,https://www.intensivregister.de/api/public/reporting/laendertabelle
1598760005,909,612,297,4,1,https://www.intensivregister.de/api/public/reporting/laendertabelle
1598763605,909,610,299,4,1,https://www.intensivregister.de/api/public/reporting/laendertabelle
1598767205,907,606,301,4,1,https://www.intensivregister.de/api/public/reporting/laendertabelle
1598770805,907,598,309,4,1,https://www.intensivregister.de/api/public/reporting/laendertabelle
1598774406,907,601,306,4,1,https://www.intensivregister.de/api/public/reporting/laendertabelle
1598821205,907,600,307,4,1,https://www.intensivregister.de/api/public/reporting/laendertabelle
1598842805,907,591,316,4,1,https://www.intensivregister.de/api/public/reporting/laendertabelle
1598846406,907,592,315,4,1,https://www.intensivregister.de/api/public/reporting/laendertabelle
1598850005,907,583,324,4,1,https://www.intensivregister.de/api/public/reporting/laendertabelle
1598853605,909,586,323,4,1,https://www.intensivregister.de/api/public/reporting/laendertabelle
1598857206,909,590,319,4,1,https://www.intensivregister.de/api/public/reporting/laendertabelle
1598878806,909,592,317,4,1,https://www.intensivregister.de/api/public/reporting/laendertabelle
1598925605,909,594,315,4,1,https://www.intensivregister.de/api/public/reporting/laendertabelle
1598929205,909,599,310,3,1,https://www.intensivregister.de/api/public/reporting/laendertabelle
1598932806,906,628,278,3,1,https://www.intensivregister.de/api/public/reporting/laendertabelle
1598936405,906,625,281,3,1,https://www.intensivregister.de/api/public/reporting/laendertabelle
1598940007,906,637,269,3,1,https://www.intensivregister.de/api/public/reporting/laendertabelle
1598943606,906,635,271,3,1,https://www.intensivregister.de/api/public/reporting/laendertabelle
1599012005,906,634,272,3,1,https://www.intensivregister.de/api/public/reporting/laendertabelle
1599015605,906,640,266,3,1,https://www.intensivregister.de/api/public/reporting/laendertabelle
1599019205,911,650,261,3,1,https://www.intensivregister.de/api/public/reporting/laendertabelle
1599022805,911,639,272,3,1,https://www.intensivregister.de/api/public/reporting/laendertabelle
1599030006,911,642,269,3,1,https://www.intensivregister.de/api/public/reporting/laendertabelle
1599102005,911,654,257,3,1,https://www.intensivregister.de/api/public/reporting/laendertabelle
1599105605,909,646,263,3,1,https://www.intensivregister.de/api/public/reporting/laendertabelle
1599109206,911,653,258,3,1,https://www.intensivregister.de/api/public/reporting/laendertabelle
1599116407,911,643,268,3,1,https://www.intensivregister.de/api/public/reporting/laendertabelle
1599166805,911,645,266,3,1,https://www.intensivregister.de/api/public/reporting/laendertabelle
1599188405,911,639,272,3,1,https://www.intensivregister.de/api/public/reporting/laendertabelle
1599192006,911,643,268,3,1,https://www.intensivregister.de/api/public/reporting/laendertabelle
1599195606,911,636,275,3,1,https://www.intensivregister.de/api/public/reporting/laendertabelle
1599199205,911,633,278,3,1,https://www.intensivregister.de/api/public/reporting/laendertabelle
1599202806,909,637,272,3,1,https://www.intensivregister.de/api/public/reporting/laendertabelle
1599206406,909,640,269,3,1,https://www.intensivregister.de/api/public/reporting/laendertabelle
1599249605,901,632,269,3,1,https://www.intensivregister.de/api/public/reporting/laendertabelle
1599274805,901,634,267,3,1,https://www.intensivregister.de/api/public/reporting/laendertabelle
1599278405,901,645,256,3,1,https://www.intensivregister.de/api/public/reporting/laendertabelle
1599282005,901,637,264,3,1,https://www.intensivregister.de/api/public/reporting/laendertabelle
1599285606,901,643,258,3,1,https://www.intensivregister.de/api/public/reporting/laendertabelle
1599289205,901,637,264,3,1,https://www.intensivregister.de/api/public/reporting/laendertabelle
1599292805,901,633,268,3,1,https://www.intensivregister.de/api/public/reporting/laendertabelle
1599310805,901,632,269,3,1,https://www.intensivregister.de/api/public/reporting/laendertabelle
1599361205,901,631,270,3,1,https://www.intensivregister.de/api/public/reporting/laendertabelle
1599364805,901,633,268,3,1,https://www.intensivregister.de/api/public/reporting/laendertabelle
1599368405,901,627,274,3,1,https://www.intensivregister.de/api/public/reporting/laendertabelle
1599372005,901,626,275,3,1,https://www.intensivregister.de/api/public/reporting/laendertabelle
1599375605,901,623,278,3,1,https://www.intensivregister.de/api/public/reporting/laendertabelle
1599379205,901,624,277,3,1,https://www.intensivregister.de/api/public/reporting/laendertabelle
1599382805,909,636,273,3,1,https://www.intensivregister.de/api/public/reporting/laendertabelle
1599386405,909,637,272,3,1,https://www.intensivregister.de/api/public/reporting/laendertabelle
1599415205,897,629,268,3,1,https://www.intensivregister.de/api/public/reporting/laendertabelle
1599418805,909,637,272,3,1,https://www.intensivregister.de/api/public/reporting/laendertabelle
1599447605,909,621,288,3,1,https://www.intensivregister.de/api/public/reporting/laendertabelle
1599451206,909,622,287,3,1,https://www.intensivregister.de/api/public/reporting/laendertabelle
1599454806,909,620,289,3,1,https://www.intensivregister.de/api/public/reporting/laendertabelle
1599458406,909,622,287,3,1,https://www.intensivregister.de/api/public/reporting/laendertabelle
1599462006,910,624,286,3,1,https://www.intensivregister.de/api/public/reporting/laendertabelle
1599505205,888,606,282,3,1,https://www.intensivregister.de/api/public/reporting/laendertabelle
1599534005,888,613,275,4,1,https://www.intensivregister.de/api/public/reporting/laendertabelle
1599537605,888,622,266,4,1,https://www.intensivregister.de/api/public/reporting/laendertabelle
1599541205,890,628,262,4,1,https://www.intensivregister.de/api/public/reporting/laendertabelle
1599544805,917,649,268,4,1,https://www.intensivregister.de/api/public/reporting/laendertabelle
1599552006,917,646,271,4,1,https://www.intensivregister.de/api/public/reporting/laendertabelle
1599620405,917,639,278,3,1,https://www.intensivregister.de/api/public/reporting/laendertabelle
1599624005,917,641,276,3,1,https://www.intensivregister.de/api/public/reporting/laendertabelle
1599627606,917,643,274,3,1,https://www.intensivregister.de/api/public/reporting/laendertabelle
1599631206,917,632,285,3,1,https://www.intensivregister.de/api/public/reporting/laendertabelle
1599634806,917,627,290,3,1,https://www.intensivregister.de/api/public/reporting/laendertabelle
1599642006,917,625,292,3,1,https://www.intensivregister.de/api/public/reporting/laendertabelle
1599706805,917,636,281,3,1,https://www.intensivregister.de/api/public/reporting/laendertabelle
1599710406,917,650,267,3,1,https://www.intensivregister.de/api/public/reporting/laendertabelle
1599714007,917,651,266,3,1,https://www.intensivregister.de/api/public/reporting/laendertabelle
1599717606,917,658,259,3,1,https://www.intensivregister.de/api/public/reporting/laendertabelle
1599721207,917,659,258,3,1,https://www.intensivregister.de/api/public/reporting/laendertabelle
1599793205,917,655,262,3,1,https://www.intensivregister.de/api/public/reporting/laendertabelle
1599796805,917,654,263,2,1,https://www.intensivregister.de/api/public/reporting/laendertabelle
1599800406,915,657,258,2,1,https://www.intensivregister.de/api/public/reporting/laendertabelle
1599804006,915,662,253,2,1,https://www.intensivregister.de/api/public/reporting/laendertabelle
1599807605,915,663,252,2,1,https://www.intensivregister.de/api/public/reporting/laendertabelle
1599879605,915,668,247,2,1,https://www.intensivregister.de/api/public/reporting/laendertabelle
1599883205,915,655,260,2,1,https://www.intensivregister.de/api/public/reporting/laendertabelle
1599886805,915,653,262,2,1,https://www.intensivregister.de/api/public/reporting/laendertabelle
1599890405,915,647,268,2,1,https://www.intensivregister.de/api/public/reporting/laendertabelle
1599894005,915,639,276,3,1,https://www.intensivregister.de/api/public/reporting/laendertabelle
1599969605,915,634,281,3,1,https://www.intensivregister.de/api/public/reporting/laendertabelle
1599973205,915,626,289,3,1,https://www.intensivregister.de/api/public/reporting/laendertabelle
1599980405,915,625,290,3,1,https://www.intensivregister.de/api/public/reporting/laendertabelle
1599984005,915,620,295,3,1,https://www.intensivregister.de/api/public/reporting/laendertabelle
1600052405,911,614,297,3,1,https://www.intensivregister.de/api/public/reporting/laendertabelle
1600056005,913,618,295,3,1,https://www.intensivregister.de/api/public/reporting/laendertabelle
1600059605,911,606,305,5,1,https://www.intensivregister.de/api/public/reporting/laendertabelle
1600074005,921,607,314,5,1,https://www.intensivregister.de/api/public/reporting/laendertabelle
1600084805,921,606,315,5,1,https://www.intensivregister.de/api/public/reporting/laendertabelle
1600138805,921,605,316,4,1,https://www.intensivregister.de/api/public/reporting/laendertabelle
1600142405,921,608,313,4,1,https://www.intensivregister.de/api/public/reporting/laendertabelle
1600146005,921,628,293,4,1,https://www.intensivregister.de/api/public/reporting/laendertabelle
1600149605,921,632,289,4,1,https://www.intensivregister.de/api/public/reporting/laendertabelle
1600153205,920,633,287,4,1,https://www.intensivregister.de/api/public/reporting/laendertabelle
1600221605,920,634,286,4,1,https://www.intensivregister.de/api/public/reporting/laendertabelle
1600225205,920,633,287,4,1,https://www.intensivregister.de/api/public/reporting/laendertabelle
1600228805,920,634,286,4,1,https://www.intensivregister.de/api/public/reporting/laendertabelle
1600232405,920,637,283,4,1,https://www.intensivregister.de/api/public/reporting/laendertabelle
1600236006,920,641,279,4,1,https://www.intensivregister.de/api/public/reporting/laendertabelle
1600246806,920,638,282,4,1,https://www.intensivregister.de/api/public/reporting/laendertabelle
1600311605,920,645,275,4,1,https://www.intensivregister.de/api/public/reporting/laendertabelle
1600315205,920,663,257,4,1,https://www.intensivregister.de/api/public/reporting/laendertabelle
1600318806,920,671,249,4,1,https://www.intensivregister.de/api/public/reporting/laendertabelle
1600322405,920,674,246,3,1,https://www.intensivregister.de/api/public/reporting/laendertabelle
1600326005,920,671,249,3,1,https://www.intensivregister.de/api/public/reporting/laendertabelle
1600329606,920,663,257,3,1,https://www.intensivregister.de/api/public/reporting/laendertabelle
1600336806,920,661,259,3,1,https://www.intensivregister.de/api/public/reporting/laendertabelle
1600351205,920,661,259,4,1,https://www.intensivregister.de/api/public/reporting/laendertabelle
1600398005,920,655,265,4,1,https://www.intensivregister.de/api/public/reporting/laendertabelle
1600401605,920,644,276,5,1,https://www.intensivregister.de/api/public/reporting/laendertabelle
1600405206,920,645,275,5,1,https://www.intensivregister.de/api/public/reporting/laendertabelle
1600408805,920,649,271,5,1,https://www.intensivregister.de/api/public/reporting/laendertabelle
1600477205,920,651,269,5,1,https://www.intensivregister.de/api/public/reporting/laendertabelle
1600488005,920,624,296,4,1,https://www.intensivregister.de/api/public/reporting/laendertabelle
1600491605,920,622,298,2,0,https://www.intensivregister.de/api/public/reporting/laendertabelle
1600495206,920,618,302,2,0,https://www.intensivregister.de/api/public/reporting/laendertabelle
1600509606,916,622,294,2,0,https://www.intensivregister.de/api/public/reporting/laendertabelle
1600567207,916,623,293,2,0,https://www.intensivregister.de/api/public/reporting/laendertabelle
1600574405,916,621,295,2,0,https://www.intensivregister.de/api/public/reporting/laendertabelle
1600578005,916,620,296,2,0,https://www.intensivregister.de/api/public/reporting/laendertabelle
1600581605,916,614,302,2,0,https://www.intensivregister.de/api/public/reporting/laendertabelle
1600588805,917,616,301,2,0,https://www.intensivregister.de/api/public/reporting/laendertabelle
1600635605,916,616,300,2,0,https://www.intensivregister.de/api/public/reporting/laendertabelle
1600660805,916,612,304,2,0,https://www.intensivregister.de/api/public/reporting/laendertabelle
1600664405,917,602,315,3,1,https://www.intensivregister.de/api/public/reporting/laendertabelle
1600668006,917,601,316,3,1,https://www.intensivregister.de/api/public/reporting/laendertabelle
1600671605,917,604,313,3,1,https://www.intensivregister.de/api/public/reporting/laendertabelle
1600743606,917,627,290,2,1,https://www.intensivregister.de/api/public/reporting/laendertabelle
1600747206,917,639,278,2,1,https://www.intensivregister.de/api/public/reporting/laendertabelle
1600750806,917,643,274,4,2,https://www.intensivregister.de/api/public/reporting/laendertabelle
1600754406,917,646,271,4,2,https://www.intensivregister.de/api/public/reporting/laendertabelle
1600758006,916,645,271,4,2,https://www.intensivregister.de/api/public/reporting/laendertabelle
1600826405,916,646,270,4,2,https://www.intensivregister.de/api/public/reporting/laendertabelle
1600830005,916,648,268,4,2,https://www.intensivregister.de/api/public/reporting/laendertabelle
1600833606,916,647,269,5,2,https://www.intensivregister.de/api/public/reporting/laendertabelle
1600837205,916,655,261,5,2,https://www.intensivregister.de/api/public/reporting/laendertabelle
1600840806,916,662,254,5,2,https://www.intensivregister.de/api/public/reporting/laendertabelle
1600844405,916,661,255,5,2,https://www.intensivregister.de/api/public/reporting/laendertabelle
1600848006,916,657,259,5,2,https://www.intensivregister.de/api/public/reporting/laendertabelle
1600916405,916,661,255,5,2,https://www.intensivregister.de/api/public/reporting/laendertabelle
1600920005,916,646,270,5,2,https://www.intensivregister.de/api/public/reporting/laendertabelle
1600923606,916,644,272,5,2,https://www.intensivregister.de/api/public/reporting/laendertabelle
1600927206,916,634,282,5,2,https://www.intensivregister.de/api/public/reporting/laendertabelle
1600930806,916,637,279,5,2,https://www.intensivregister.de/api/public/reporting/laendertabelle
1600941606,916,638,278,5,2,https://www.intensivregister.de/api/public/reporting/laendertabelle
1601002805,916,635,281,4,2,https://www.intensivregister.de/api/public/reporting/laendertabelle
1601006405,916,633,283,4,2,https://www.intensivregister.de/api/public/reporting/laendertabelle
1601010005,916,635,281,4,2,https://www.intensivregister.de/api/public/reporting/laendertabelle
1601013605,916,633,283,4,2,https://www.intensivregister.de/api/public/reporting/laendertabelle
1601017205,916,632,284,4,2,https://www.intensivregister.de/api/public/reporting/laendertabelle
1601020805,916,628,288,4,2,https://www.intensivregister.de/api/public/reporting/laendertabelle
1601089205,916,627,289,4,2,https://www.intensivregister.de/api/public/reporting/laendertabelle
1601092805,917,629,288,4,2,https://www.intensivregister.de/api/public/reporting/laendertabelle
1601096405,917,639,278,4,2,https://www.intensivregister.de/api/public/reporting/laendertabelle
1601100005,917,628,289,5,2,https://www.intensivregister.de/api/public/reporting/laendertabelle
1601103605,917,623,294,5,2,https://www.intensivregister.de/api/public/reporting/laendertabelle
1601110805,917,629,288,5,2,https://www.intensivregister.de/api/public/reporting/laendertabelle
1601114405,917,630,287,5,2,https://www.intensivregister.de/api/public/reporting/laendertabelle
1601175606,917,629,288,5,2,https://www.intensivregister.de/api/public/reporting/laendertabelle
1601179205,914,615,299,5,2,https://www.intensivregister.de/api/public/reporting/laendertabelle
1601182805,914,615,299,7,2,https://www.intensivregister.de/api/public/reporting/laendertabelle
1601186405,917,620,297,7,2,https://www.intensivregister.de/api/public/reporting/laendertabelle
1601190005,915,617,298,9,2,https://www.intensivregister.de/api/public/reporting/laendertabelle
1601197205,915,619,296,9,2,https://www.intensivregister.de/api/public/reporting/laendertabelle
1601262005,915,616,299,9,2,https://www.intensivregister.de/api/public/reporting/laendertabelle
1601265605,915,613,302,9,2,https://www.intensivregister.de/api/public/reporting/laendertabelle
1601269205,915,610,305,9,2,https://www.intensivregister.de/api/public/reporting/laendertabelle
1601272806,915,613,302,9,2,https://www.intensivregister.de/api/public/reporting/laendertabelle
1601276405,917,617,300,10,2,https://www.intensivregister.de/api/public/reporting/laendertabelle
1601290806,917,616,301,10,2,https://www.intensivregister.de/api/public/reporting/laendertabelle
1601294406,917,615,302,10,2,https://www.intensivregister.de/api/public/reporting/laendertabelle
1601348405,921,644,277,9,2,https://www.intensivregister.de/api/public/reporting/laendertabelle
1601352006,921,643,278,8,2,https://www.intensivregister.de/api/public/reporting/laendertabelle
1601355606,923,652,271,7,2,https://www.intensivregister.de/api/public/reporting/laendertabelle
1601359205,923,656,267,7,2,https://www.intensivregister.de/api/public/reporting/laendertabelle
1601362805,923,657,266,7,2,https://www.intensivregister.de/api/public/reporting/laendertabelle
1601434805,923,655,268,6,2,https://www.intensivregister.de/api/public/reporting/laendertabelle
1601438406,923,656,267,6,2,https://www.intensivregister.de/api/public/reporting/laendertabelle
1601442006,927,648,279,6,2,https://www.intensivregister.de/api/public/reporting/laendertabelle
1601449205,927,645,282,6,2,https://www.intensivregister.de/api/public/reporting/laendertabelle
1601456406,927,646,281,6,2,https://www.intensivregister.de/api/public/reporting/laendertabelle
1601517605,927,644,283,6,2,https://www.intensivregister.de/api/public/reporting/laendertabelle
1601521205,927,642,285,7,2,https://www.intensivregister.de/api/public/reporting/laendertabelle
1601524805,927,626,301,7,2,https://www.intensivregister.de/api/public/reporting/laendertabelle
1601528406,927,632,295,7,2,https://www.intensivregister.de/api/public/reporting/laendertabelle
1601532006,927,634,293,7,2,https://www.intensivregister.de/api/public/reporting/laendertabelle
1601607605,927,639,288,7,2,https://www.intensivregister.de/api/public/reporting/laendertabelle
1601611205,927,644,283,7,2,https://www.intensivregister.de/api/public/reporting/laendertabelle
1601614806,927,645,282,8,2,https://www.intensivregister.de/api/public/reporting/laendertabelle
1601618406,927,643,284,8,2,https://www.intensivregister.de/api/public/reporting/laendertabelle
1601622005,927,644,283,8,2,https://www.intensivregister.de/api/public/reporting/laendertabelle
1601632806,927,649,278,8,2,https://www.intensivregister.de/api/public/reporting/laendertabelle
1601640005,927,650,277,8,2,https://www.intensivregister.de/api/public/reporting/laendertabelle
1601690405,927,650,277,7,2,https://www.intensivregister.de/api/public/reporting/laendertabelle
1601694005,927,644,283,7,2,https://www.intensivregister.de/api/public/reporting/laendertabelle
1601697605,927,639,288,7,2,https://www.intensivregister.de/api/public/reporting/laendertabelle
1601701205,927,644,283,7,2,https://www.intensivregister.de/api/public/reporting/laendertabelle
1601708405,927,636,291,7,2,https://www.intensivregister.de/api/public/reporting/laendertabelle
1601712005,917,626,291,8,2,https://www.intensivregister.de/api/public/reporting/laendertabelle
1601780405,917,627,290,8,2,https://www.intensivregister.de/api/public/reporting/laendertabelle
1601784005,917,622,295,8,2,https://www.intensivregister.de/api/public/reporting/laendertabelle
1601787605,915,626,289,8,2,https://www.intensivregister.de/api/public/reporting/laendertabelle
1601791205,915,614,301,8,2,https://www.intensivregister.de/api/public/reporting/laendertabelle
1601794805,915,615,300,8,2,https://www.intensivregister.de/api/public/reporting/laendertabelle
1601798405,915,602,313,8,2,https://www.intensivregister.de/api/public/reporting/laendertabelle
1601805605,915,600,315,8,2,https://www.intensivregister.de/api/public/reporting/laendertabelle
1601866805,915,606,309,8,2,https://www.intensivregister.de/api/public/reporting/laendertabelle
1601870405,915,601,314,8,2,https://www.intensivregister.de/api/public/reporting/laendertabelle
1601874005,928,603,325,8,2,https://www.intensivregister.de/api/public/reporting/laendertabelle
1601877605,922,591,331,8,2,https://www.intensivregister.de/api/public/reporting/laendertabelle
1601884805,922,593,329,8,2,https://www.intensivregister.de/api/public/reporting/laendertabelle
1601953205,922,605,317,9,2,https://www.intensivregister.de/api/public/reporting/laendertabelle
1601956805,917,607,310,9,2,https://www.intensivregister.de/api/public/reporting/laendertabelle
1601960405,917,615,302,9,2,https://www.intensivregister.de/api/public/reporting/laendertabelle
1601964005,917,627,290,9,2,https://www.intensivregister.de/api/public/reporting/laendertabelle
1601967605,917,625,292,9,2,https://www.intensivregister.de/api/public/reporting/laendertabelle
1601978405,917,624,293,9,2,https://www.intensivregister.de/api/public/reporting/laendertabelle
1602018005,917,625,292,9,2,https://www.intensivregister.de/api/public/reporting/laendertabelle
1602039605,917,628,289,9,2,https://www.intensivregister.de/api/public/reporting/laendertabelle
1602043206,912,642,270,10,2,https://www.intensivregister.de/api/public/reporting/laendertabelle
1602046805,912,636,276,10,2,https://www.intensivregister.de/api/public/reporting/laendertabelle
1602050405,912,644,268,10,2,https://www.intensivregister.de/api/public/reporting/laendertabelle
1602126005,912,654,258,9,2,https://www.intensivregister.de/api/public/reporting/laendertabelle
1602129605,912,655,257,9,2,https://www.intensivregister.de/api/public/reporting/laendertabelle
1602136805,912,657,255,10,2,https://www.intensivregister.de/api/public/reporting/laendertabelle
1602140405,912,658,254,10,2,https://www.intensivregister.de/api/public/reporting/laendertabelle
1602212405,912,654,258,8,2,https://www.intensivregister.de/api/public/reporting/laendertabelle
1602216005,912,644,268,8,2,https://www.intensivregister.de/api/public/reporting/laendertabelle
1602219605,912,637,275,8,2,https://www.intensivregister.de/api/public/reporting/laendertabelle
1602226805,912,634,278,8,2,https://www.intensivregister.de/api/public/reporting/laendertabelle
1602302405,912,637,275,9,2,https://www.intensivregister.de/api/public/reporting/laendertabelle
1602306005,914,632,282,9,2,https://www.intensivregister.de/api/public/reporting/laendertabelle
1602309605,912,620,292,9,2,https://www.intensivregister.de/api/public/reporting/laendertabelle
1602313205,912,617,295,9,2,https://www.intensivregister.de/api/public/reporting/laendertabelle
1602316805,912,615,297,9,2,https://www.intensivregister.de/api/public/reporting/laendertabelle
1602363605,912,613,299,9,2,https://www.intensivregister.de/api/public/reporting/laendertabelle
1602385205,912,612,300,9,2,https://www.intensivregister.de/api/public/reporting/laendertabelle
1602388805,912,616,296,9,2,https://www.intensivregister.de/api/public/reporting/laendertabelle
1602392405,912,623,289,9,2,https://www.intensivregister.de/api/public/reporting/laendertabelle
1602396005,912,620,292,9,2,https://www.intensivregister.de/api/public/reporting/laendertabelle
1602399605,912,621,291,10,2,https://www.intensivregister.de/api/public/reporting/laendertabelle
1602403205,912,613,299,10,2,https://www.intensivregister.de/api/public/reporting/laendertabelle
1602406805,912,617,295,11,2,https://www.intensivregister.de/api/public/reporting/laendertabelle
1602457205,912,619,293,11,2,https://www.intensivregister.de/api/public/reporting/laendertabelle
1602471605,912,613,299,11,2,https://www.intensivregister.de/api/public/reporting/laendertabelle
1602475205,912,617,295,11,2,https://www.intensivregister.de/api/public/reporting/laendertabelle
1602478805,912,612,300,10,2,https://www.intensivregister.de/api/public/reporting/laendertabelle
1602482405,903,612,291,10,2,https://www.intensivregister.de/api/public/reporting/laendertabelle
1602486005,903,614,289,10,2,https://www.intensivregister.de/api/public/reporting/laendertabelle
1602489605,903,615,288,10,2,https://www.intensivregister.de/api/public/reporting/laendertabelle
1602493205,903,610,293,10,2,https://www.intensivregister.de/api/public/reporting/laendertabelle
1602558005,903,616,287,10,2,https://www.intensivregister.de/api/public/reporting/laendertabelle
1602561605,903,632,271,10,2,https://www.intensivregister.de/api/public/reporting/laendertabelle
1602565205,903,639,264,10,2,https://www.intensivregister.de/api/public/reporting/laendertabelle
1602572405,908,646,262,9,2,https://www.intensivregister.de/api/public/reporting/laendertabelle
1602583205,908,648,260,9,2,https://www.intensivregister.de/api/public/reporting/laendertabelle
1602640805,908,646,262,9,2,https://www.intensivregister.de/api/public/reporting/laendertabelle
1602644405,908,649,259,10,3,https://www.intensivregister.de/api/public/reporting/laendertabelle
1602648005,908,642,266,11,3,https://www.intensivregister.de/api/public/reporting/laendertabelle
1602651605,908,647,261,12,3,https://www.intensivregister.de/api/public/reporting/laendertabelle
1602655205,908,642,266,12,3,https://www.intensivregister.de/api/public/reporting/laendertabelle
1602658805,908,642,266,13,3,https://www.intensivregister.de/api/public/reporting/laendertabelle
1602662405,908,641,267,13,3,https://www.intensivregister.de/api/public/reporting/laendertabelle
1602673205,908,632,276,13,3,https://www.intensivregister.de/api/public/reporting/laendertabelle
1602730805,908,621,287,13,3,https://www.intensivregister.de/api/public/reporting/laendertabelle
1602734405,908,630,278,12,3,https://www.intensivregister.de/api/public/reporting/laendertabelle
1602738005,908,629,279,12,3,https://www.intensivregister.de/api/public/reporting/laendertabelle
1602741605,908,642,266,13,3,https://www.intensivregister.de/api/public/reporting/laendertabelle
1602745205,908,637,271,13,3,https://www.intensivregister.de/api/public/reporting/laendertabelle
1602748805,908,636,272,13,3,https://www.intensivregister.de/api/public/reporting/laendertabelle
1602817205,908,637,271,14,4,https://www.intensivregister.de/api/public/reporting/laendertabelle
1602820805,908,628,280,14,4,https://www.intensivregister.de/api/public/reporting/laendertabelle
1602824405,908,626,282,14,4,https://www.intensivregister.de/api/public/reporting/laendertabelle
1602828005,908,624,284,14,4,https://www.intensivregister.de/api/public/reporting/laendertabelle
1602835205,908,627,281,14,4,https://www.intensivregister.de/api/public/reporting/laendertabelle
1602838805,908,625,283,14,4,https://www.intensivregister.de/api/public/reporting/laendertabelle
1602903605,908,627,281,14,4,https://www.intensivregister.de/api/public/reporting/laendertabelle
1602907206,908,626,282,14,4,https://www.intensivregister.de/api/public/reporting/laendertabelle
1602910805,906,635,271,15,3,https://www.intensivregister.de/api/public/reporting/laendertabelle
1602914405,906,638,268,15,3,https://www.intensivregister.de/api/public/reporting/laendertabelle
1602921605,906,638,268,16,3,https://www.intensivregister.de/api/public/reporting/laendertabelle
1602925205,906,637,269,16,3,https://www.intensivregister.de/api/public/reporting/laendertabelle
1602990005,906,638,268,16,3,https://www.intensivregister.de/api/public/reporting/laendertabelle
1602993605,906,629,277,15,3,https://www.intensivregister.de/api/public/reporting/laendertabelle
1602997205,906,616,290,16,3,https://www.intensivregister.de/api/public/reporting/laendertabelle
1603000805,906,624,282,16,3,https://www.intensivregister.de/api/public/reporting/laendertabelle
1603004405,906,617,289,16,3,https://www.intensivregister.de/api/public/reporting/laendertabelle
1603008005,906,615,291,16,3,https://www.intensivregister.de/api/public/reporting/laendertabelle
1603072805,906,613,293,16,3,https://www.intensivregister.de/api/public/reporting/laendertabelle
1603080005,903,608,295,16,3,https://www.intensivregister.de/api/public/reporting/laendertabelle
1603083605,892,600,292,18,3,https://www.intensivregister.de/api/public/reporting/laendertabelle
1603087205,892,603,289,19,2,https://www.intensivregister.de/api/public/reporting/laendertabelle
1603094405,892,601,291,19,2,https://www.intensivregister.de/api/public/reporting/laendertabelle
1603098005,892,605,287,19,2,https://www.intensivregister.de/api/public/reporting/laendertabelle
1603141205,892,603,289,19,2,https://www.intensivregister.de/api/public/reporting/laendertabelle
1603162805,894,620,274,17,2,https://www.intensivregister.de/api/public/reporting/laendertabelle
1603166405,894,629,265,17,2,https://www.intensivregister.de/api/public/reporting/laendertabelle
1603170005,894,642,252,16,2,https://www.intensivregister.de/api/public/reporting/laendertabelle
1603173605,897,654,243,18,3,https://www.intensivregister.de/api/public/reporting/laendertabelle
1603177205,897,652,245,18,4,https://www.intensivregister.de/api/public/reporting/laendertabelle
1603180805,897,654,243,17,4,https://www.intensivregister.de/api/public/reporting/laendertabelle
1603227605,897,653,244,17,4,https://www.intensivregister.de/api/public/reporting/laendertabelle
1603249205,896,647,249,18,4,https://www.intensivregister.de/api/public/reporting/laendertabelle
1603252805,896,639,257,17,3,https://www.intensivregister.de/api/public/reporting/laendertabelle
1603256405,898,643,255,19,5,https://www.intensivregister.de/api/public/reporting/laendertabelle
1603260005,898,640,258,19,5,https://www.intensivregister.de/api/public/reporting/laendertabelle
1603263605,898,642,256,19,5,https://www.intensivregister.de/api/public/reporting/laendertabelle
1603267205,898,644,254,19,4,https://www.intensivregister.de/api/public/reporting/laendertabelle
1603339205,897,648,249,21,4,https://www.intensivregister.de/api/public/reporting/laendertabelle
1603342805,897,635,262,22,4,https://www.intensivregister.de/api/public/reporting/laendertabelle
1603346405,901,628,273,22,4,https://www.intensivregister.de/api/public/reporting/laendertabelle
1603350005,901,627,274,22,4,https://www.intensivregister.de/api/public/reporting/laendertabelle
1603422005,901,630,271,24,4,https://www.intensivregister.de/api/public/reporting/laendertabelle
1603425605,901,631,270,24,4,https://www.intensivregister.de/api/public/reporting/laendertabelle
1603429205,901,636,265,25,4,https://www.intensivregister.de/api/public/reporting/laendertabelle
1603432805,901,641,260,26,4,https://www.intensivregister.de/api/public/reporting/laendertabelle
1603440005,901,644,257,26,4,https://www.intensivregister.de/api/public/reporting/laendertabelle
1603443605,894,637,257,24,4,https://www.intensivregister.de/api/public/reporting/laendertabelle
1603508405,894,629,265,25,4,https://www.intensivregister.de/api/public/reporting/laendertabelle
1603512005,896,628,268,24,5,https://www.intensivregister.de/api/public/reporting/laendertabelle
1603515605,896,636,260,24,5,https://www.intensivregister.de/api/public/reporting/laendertabelle
1603519205,896,621,275,23,5,https://www.intensivregister.de/api/public/reporting/laendertabelle
1603526405,896,615,281,23,5,https://www.intensivregister.de/api/public/reporting/laendertabelle
1603591205,896,614,282,23,5,https://www.intensivregister.de/api/public/reporting/laendertabelle
1603602005,896,599,297,23,5,https://www.intensivregister.de/api/public/reporting/laendertabelle
1603605605,896,579,317,26,5,https://www.intensivregister.de/api/public/reporting/laendertabelle
1603609205,896,575,321,27,5,https://www.intensivregister.de/api/public/reporting/laendertabelle
1603612805,896,568,328,27,5,https://www.intensivregister.de/api/public/reporting/laendertabelle
1603641605,896,565,331,27,5,https://www.intensivregister.de/api/public/reporting/laendertabelle
1603688405,896,564,332,28,5,https://www.intensivregister.de/api/public/reporting/laendertabelle
1603692005,896,572,324,28,5,https://www.intensivregister.de/api/public/reporting/laendertabelle
1603695605,896,587,309,28,6,https://www.intensivregister.de/api/public/reporting/laendertabelle
1603699205,896,587,309,27,6,https://www.intensivregister.de/api/public/reporting/laendertabelle
1603702805,902,579,323,28,6,https://www.intensivregister.de/api/public/reporting/laendertabelle
1603774805,904,592,312,27,6,https://www.intensivregister.de/api/public/reporting/laendertabelle
1603778405,904,596,308,28,6,https://www.intensivregister.de/api/public/reporting/laendertabelle
1603782005,901,603,298,26,6,https://www.intensivregister.de/api/public/reporting/laendertabelle
1603785605,901,602,299,26,6,https://www.intensivregister.de/api/public/reporting/laendertabelle
1603789205,901,604,297,27,6,https://www.intensivregister.de/api/public/reporting/laendertabelle
1603861205,901,606,295,31,6,https://www.intensivregister.de/api/public/reporting/laendertabelle
1603864805,901,612,289,31,6,https://www.intensivregister.de/api/public/reporting/laendertabelle
1603868405,905,613,292,30,6,https://www.intensivregister.de/api/public/reporting/laendertabelle
1603872005,905,614,291,30,6,https://www.intensivregister.de/api/public/reporting/laendertabelle
1603875605,905,620,285,31,6,https://www.intensivregister.de/api/public/reporting/laendertabelle
1603897205,905,622,283,31,6,https://www.intensivregister.de/api/public/reporting/laendertabelle
1603940405,905,624,281,31,6,https://www.intensivregister.de/api/public/reporting/laendertabelle
1603947605,939,629,310,29,6,https://www.intensivregister.de/api/public/reporting/laendertabelle
1603951205,939,632,307,33,6,https://www.intensivregister.de/api/public/reporting/laendertabelle
1603954805,939,623,316,32,6,https://www.intensivregister.de/api/public/reporting/laendertabelle
1603958405,939,624,315,32,6,https://www.intensivregister.de/api/public/reporting/laendertabelle
1603969205,939,625,314,32,6,https://www.intensivregister.de/api/public/reporting/laendertabelle
1603972805,939,626,313,32,6,https://www.intensivregister.de/api/public/reporting/laendertabelle
1603976405,939,623,316,32,6,https://www.intensivregister.de/api/public/reporting/laendertabelle
1604034005,939,627,312,31,6,https://www.intensivregister.de/api/public/reporting/laendertabelle
1604037605,939,623,316,29,6,https://www.intensivregister.de/api/public/reporting/laendertabelle
1604041205,939,622,317,29,8,https://www.intensivregister.de/api/public/reporting/laendertabelle
1604044805,939,623,316,29,8,https://www.intensivregister.de/api/public/reporting/laendertabelle
1604116805,939,618,321,28,8,https://www.intensivregister.de/api/public/reporting/laendertabelle
1604120405,939,618,321,29,9,https://www.intensivregister.de/api/public/reporting/laendertabelle
1604124005,939,599,340,27,9,https://www.intensivregister.de/api/public/reporting/laendertabelle
1604127605,935,591,344,26,9,https://www.intensivregister.de/api/public/reporting/laendertabelle
1604131205,935,584,351,26,10,https://www.intensivregister.de/api/public/reporting/laendertabelle
1604134805,935,586,349,26,10,https://www.intensivregister.de/api/public/reporting/laendertabelle
1604138405,935,587,348,24,10,https://www.intensivregister.de/api/public/reporting/laendertabelle
1604142005,935,585,350,24,10,https://www.intensivregister.de/api/public/reporting/laendertabelle
1604188805,935,586,349,24,10,https://www.intensivregister.de/api/public/reporting/laendertabelle
1604210405,935,591,344,23,11,https://www.intensivregister.de/api/public/reporting/laendertabelle
1604214005,935,597,338,22,11,https://www.intensivregister.de/api/public/reporting/laendertabelle
1604217605,935,598,337,24,11,https://www.intensivregister.de/api/public/reporting/laendertabelle
1604221205,935,595,340,24,11,https://www.intensivregister.de/api/public/reporting/laendertabelle
1604228405,935,589,346,24,11,https://www.intensivregister.de/api/public/reporting/laendertabelle
1604250005,935,588,347,24,11,https://www.intensivregister.de/api/public/reporting/laendertabelle
1604293205,933,595,338,26,12,https://www.intensivregister.de/api/public/reporting/laendertabelle
1604296805,933,596,337,27,12,https://www.intensivregister.de/api/public/reporting/laendertabelle
1604300405,933,593,340,28,12,https://www.intensivregister.de/api/public/reporting/laendertabelle
1604304005,933,597,336,29,12,https://www.intensivregister.de/api/public/reporting/laendertabelle
1604311205,933,596,337,29,12,https://www.intensivregister.de/api/public/reporting/laendertabelle
1604376005,933,595,338,29,12,https://www.intensivregister.de/api/public/reporting/laendertabelle
1604379605,933,594,339,33,12,https://www.intensivregister.de/api/public/reporting/laendertabelle
1604383205,935,605,330,35,11,https://www.intensivregister.de/api/public/reporting/laendertabelle
1604386805,935,608,327,33,11,https://www.intensivregister.de/api/public/reporting/laendertabelle
1604390405,935,603,332,33,11,https://www.intensivregister.de/api/public/reporting/laendertabelle
1604394005,935,608,327,33,11,https://www.intensivregister.de/api/public/reporting/laendertabelle
1604408405,935,611,324,33,11,https://www.intensivregister.de/api/public/reporting/laendertabelle
1604444405,935,612,323,33,11,https://www.intensivregister.de/api/public/reporting/laendertabelle
1604466005,935,620,315,35,13,https://www.intensivregister.de/api/public/reporting/laendertabelle
1604469605,935,641,294,37,13,https://www.intensivregister.de/api/public/reporting/laendertabelle
1604473205,935,648,287,38,13,https://www.intensivregister.de/api/public/reporting/laendertabelle
1604476805,934,649,285,39,12,https://www.intensivregister.de/api/public/reporting/laendertabelle
1604480405,934,644,290,44,16,https://www.intensivregister.de/api/public/reporting/laendertabelle
1604484005,934,639,295,44,16,https://www.intensivregister.de/api/public/reporting/laendertabelle
1604494805,934,640,294,44,16,https://www.intensivregister.de/api/public/reporting/laendertabelle
1604509205,934,640,294,45,16,https://www.intensivregister.de/api/public/reporting/laendertabelle
1604552405,934,646,288,45,15,https://www.intensivregister.de/api/public/reporting/laendertabelle
1604556005,935,653,282,48,16,https://www.intensivregister.de/api/public/reporting/laendertabelle
1604559605,936,659,277,48,16,https://www.intensivregister.de/api/public/reporting/laendertabelle
1604563205,925,655,270,48,16,https://www.intensivregister.de/api/public/reporting/laendertabelle
1604566805,925,658,267,48,16,https://www.intensivregister.de/api/public/reporting/laendertabelle
1604577605,925,659,266,48,16,https://www.intensivregister.de/api/public/reporting/laendertabelle
1604581205,925,658,267,48,16,https://www.intensivregister.de/api/public/reporting/laendertabelle
1604638805,925,649,276,47,16,https://www.intensivregister.de/api/public/reporting/laendertabelle
1604642405,927,641,286,50,16,https://www.intensivregister.de/api/public/reporting/laendertabelle
1604646005,927,643,284,52,16,https://www.intensivregister.de/api/public/reporting/laendertabelle
1604649605,927,644,283,52,17,https://www.intensivregister.de/api/public/reporting/laendertabelle
1604653205,927,646,281,52,17,https://www.intensivregister.de/api/public/reporting/laendertabelle
1604725205,927,643,284,52,17,https://www.intensivregister.de/api/public/reporting/laendertabelle
1604728805,926,644,282,54,17,https://www.intensivregister.de/api/public/reporting/laendertabelle
1604732405,926,635,291,53,16,https://www.intensivregister.de/api/public/reporting/laendertabelle
1604736005,928,633,295,53,16,https://www.intensivregister.de/api/public/reporting/laendertabelle
1604739605,928,631,297,53,16,https://www.intensivregister.de/api/public/reporting/laendertabelle
1604743205,928,627,301,54,15,https://www.intensivregister.de/api/public/reporting/laendertabelle
1604746805,928,624,304,54,15,https://www.intensivregister.de/api/public/reporting/laendertabelle
1604811605,928,627,301,54,15,https://www.intensivregister.de/api/public/reporting/laendertabelle
1604815205,928,613,315,55,15,https://www.intensivregister.de/api/public/reporting/laendertabelle
1604818805,920,605,315,57,15,https://www.intensivregister.de/api/public/reporting/laendertabelle
1604822405,920,603,317,58,15,https://www.intensivregister.de/api/public/reporting/laendertabelle
1604826005,920,599,321,58,15,https://www.intensivregister.de/api/public/reporting/laendertabelle
1604894405,920,597,323,58,15,https://www.intensivregister.de/api/public/reporting/laendertabelle
1604898005,920,597,323,61,16,https://www.intensivregister.de/api/public/reporting/laendertabelle
1604901605,920,601,319,61,17,https://www.intensivregister.de/api/public/reporting/laendertabelle
1604905205,921,597,324,60,17,https://www.intensivregister.de/api/public/reporting/laendertabelle
1604908805,921,601,320,60,16,https://www.intensivregister.de/api/public/reporting/laendertabelle
1604916005,921,600,321,60,16,https://www.intensivregister.de/api/public/reporting/laendertabelle
1604923205,921,600,321,61,16,https://www.intensivregister.de/api/public/reporting/laendertabelle
1604930405,921,599,322,61,16,https://www.intensivregister.de/api/public/reporting/laendertabelle
1604980805,921,602,319,61,16,https://www.intensivregister.de/api/public/reporting/laendertabelle
1604984405,921,606,315,61,16,https://www.intensivregister.de/api/public/reporting/laendertabelle
1604988005,921,617,304,55,16,https://www.intensivregister.de/api/public/reporting/laendertabelle
1604991605,920,619,301,54,16,https://www.intensivregister.de/api/public/reporting/laendertabelle
1604995205,920,622,298,54,16,https://www.intensivregister.de/api/public/reporting/laendertabelle
1604998805,920,624,296,54,16,https://www.intensivregister.de/api/public/reporting/laendertabelle
1605006005,920,621,299,54,16,https://www.intensivregister.de/api/public/reporting/laendertabelle
1605070805,922,620,302,51,15,https://www.intensivregister.de/api/public/reporting/laendertabelle
1605074405,922,621,301,53,16,https://www.intensivregister.de/api/public/reporting/laendertabelle
1605078005,922,628,294,55,16,https://www.intensivregister.de/api/public/reporting/laendertabelle
1605081605,922,635,287,53,16,https://www.intensivregister.de/api/public/reporting/laendertabelle
1605099605,922,635,287,54,17,https://www.intensivregister.de/api/public/reporting/laendertabelle
1605153605,922,634,288,54,17,https://www.intensivregister.de/api/public/reporting/laendertabelle
1605157205,960,653,307,57,18,https://www.intensivregister.de/api/public/reporting/laendertabelle
1605160805,960,652,308,57,16,https://www.intensivregister.de/api/public/reporting/laendertabelle
1605164405,960,645,315,55,14,https://www.intensivregister.de/api/public/reporting/laendertabelle
1605186005,960,649,311,55,14,https://www.intensivregister.de/api/public/reporting/laendertabelle
1605240005,960,650,310,55,14,https://www.intensivregister.de/api/public/reporting/laendertabelle
1605243605,957,643,314,64,14,https://www.intensivregister.de/api/public/reporting/laendertabelle
1605247205,948,644,304,65,14,https://www.intensivregister.de/api/public/reporting/laendertabelle
1605250805,948,642,306,65,14,https://www.intensivregister.de/api/public/reporting/laendertabelle
1605254405,944,636,308,69,16,https://www.intensivregister.de/api/public/reporting/laendertabelle
1605258005,944,642,302,69,16,https://www.intensivregister.de/api/public/reporting/laendertabelle
1605261605,944,644,300,69,16,https://www.intensivregister.de/api/public/reporting/laendertabelle
1605293095,946,648,298,69,16,https://www.intensivregister.de/api/public/reporting/laendertabelle
1605293095,947,635,312,67,17,https://www.intensivregister.de/api/public/reporting/laendertabelle
1605338983,947,641,306,70,19,https://www.intensivregister.de/api/public/reporting/laendertabelle
1605347474,949,635,314,69,19,https://www.intensivregister.de/api/public/reporting/laendertabelle
1605417548,949,634,315,68,16,https://www.intensivregister.de/api/public/reporting/laendertabelle
1605421144,949,627,322,68,15,https://www.intensivregister.de/api/public/reporting/laendertabelle
1605424749,945,622,323,69,17,https://www.intensivregister.de/api/public/reporting/laendertabelle
1605431950,945,623,322,69,17,https://www.intensivregister.de/api/public/reporting/laendertabelle
1605500347,945,619,326,75,19,https://www.intensivregister.de/api/public/reporting/laendertabelle
1605503953,945,624,321,72,19,https://www.intensivregister.de/api/public/reporting/laendertabelle
1605507548,945,621,324,74,19,https://www.intensivregister.de/api/public/reporting/laendertabelle
1605511144,945,624,321,74,19,https://www.intensivregister.de/api/public/reporting/laendertabelle
1605514751,943,626,317,74,19,https://www.intensivregister.de/api/public/reporting/laendertabelle
1605586747,943,633,310,81,22,https://www.intensivregister.de/api/public/reporting/laendertabelle
1605590352,943,648,295,83,23,https://www.intensivregister.de/api/public/reporting/laendertabelle
1605597544,942,656,286,83,24,https://www.intensivregister.de/api/public/reporting/laendertabelle
1605601150,935,654,281,84,25,https://www.intensivregister.de/api/public/reporting/laendertabelle
1605611947,934,654,280,84,25,https://www.intensivregister.de/api/public/reporting/laendertabelle
1605658753,934,655,279,84,25,https://www.intensivregister.de/api/public/reporting/laendertabelle
1605673145,934,658,276,86,24,https://www.intensivregister.de/api/public/reporting/laendertabelle
1605676750,934,664,270,87,26,https://www.intensivregister.de/api/public/reporting/laendertabelle
1605680346,937,667,270,87,27,https://www.intensivregister.de/api/public/reporting/laendertabelle
1605683952,937,669,268,87,27,https://www.intensivregister.de/api/public/reporting/laendertabelle
1605687547,937,669,268,88,28,https://www.intensivregister.de/api/public/reporting/laendertabelle
1605691158,937,668,269,88,28,https://www.intensivregister.de/api/public/reporting/laendertabelle
1605709152,934,672,262,88,28,https://www.intensivregister.de/api/public/reporting/laendertabelle
1605737948,934,672,262,89,28,https://www.intensivregister.de/api/public/reporting/laendertabelle
1605755945,934,673,261,89,28,https://www.intensivregister.de/api/public/reporting/laendertabelle
1605759551,934,671,263,91,28,https://www.intensivregister.de/api/public/reporting/laendertabelle
1605763147,934,677,257,94,29,https://www.intensivregister.de/api/public/reporting/laendertabelle
1605766752,934,668,266,88,26,https://www.intensivregister.de/api/public/reporting/laendertabelle
1605770348,932,669,263,88,26,https://www.intensivregister.de/api/public/reporting/laendertabelle
1605773944,932,668,264,87,27,https://www.intensivregister.de/api/public/reporting/laendertabelle
1605777549,932,667,265,87,27,https://www.intensivregister.de/api/public/reporting/laendertabelle
1605781145,932,669,263,87,27,https://www.intensivregister.de/api/public/reporting/laendertabelle
1605845946,932,654,278,87,26,https://www.intensivregister.de/api/public/reporting/laendertabelle
1605849551,932,661,271,85,26,https://www.intensivregister.de/api/public/reporting/laendertabelle
1605853147,932,668,264,83,25,https://www.intensivregister.de/api/public/reporting/laendertabelle
1605856753,931,665,266,84,25,https://www.intensivregister.de/api/public/reporting/laendertabelle
1605860349,931,669,262,84,25,https://www.intensivregister.de/api/public/reporting/laendertabelle
1605863944,931,669,262,86,25,https://www.intensivregister.de/api/public/reporting/laendertabelle
1605874751,927,671,256,88,25,https://www.intensivregister.de/api/public/reporting/laendertabelle
1605925148,927,672,255,88,25,https://www.intensivregister.de/api/public/reporting/laendertabelle
1605932350,927,670,257,88,25,https://www.intensivregister.de/api/public/reporting/laendertabelle
1605935947,927,669,258,89,26,https://www.intensivregister.de/api/public/reporting/laendertabelle
1605939553,929,667,262,90,28,https://www.intensivregister.de/api/public/reporting/laendertabelle
1605943149,929,652,277,91,27,https://www.intensivregister.de/api/public/reporting/laendertabelle
1605950354,929,654,275,91,28,https://www.intensivregister.de/api/public/reporting/laendertabelle
1605993544,929,651,278,91,28,https://www.intensivregister.de/api/public/reporting/laendertabelle
1606022345,927,627,300,89,28,https://www.intensivregister.de/api/public/reporting/laendertabelle
1606025949,925,622,303,93,27,https://www.intensivregister.de/api/public/reporting/laendertabelle
1606029553,925,628,297,97,26,https://www.intensivregister.de/api/public/reporting/laendertabelle
1606033147,925,626,299,96,26,https://www.intensivregister.de/api/public/reporting/laendertabelle
1606105152,925,630,295,97,26,https://www.intensivregister.de/api/public/reporting/laendertabelle
1606108747,925,625,300,97,26,https://www.intensivregister.de/api/public/reporting/laendertabelle
1606112353,856,593,263,74,28,https://www.intensivregister.de/api/public/reporting/laendertabelle
1606115947,856,595,261,73,28,https://www.intensivregister.de/api/public/reporting/laendertabelle
1606119551,856,595,261,72,27,https://www.intensivregister.de/api/public/reporting/laendertabelle
1606123145,856,598,258,73,28,https://www.intensivregister.de/api/public/reporting/laendertabelle
1606169953,856,597,259,73,28,https://www.intensivregister.de/api/public/reporting/laendertabelle
1606191544,856,606,250,74,30,https://www.intensivregister.de/api/public/reporting/laendertabelle
1606195148,856,631,225,76,33,https://www.intensivregister.de/api/public/reporting/laendertabelle
1606198752,855,632,223,72,33,https://www.intensivregister.de/api/public/reporting/laendertabelle
1606202346,855,633,222,72,33,https://www.intensivregister.de/api/public/reporting/laendertabelle
1606216753,848,633,215,72,33,https://www.intensivregister.de/api/public/reporting/laendertabelle
1606238345,848,641,207,74,33,https://www.intensivregister.de/api/public/reporting/laendertabelle
1606267151,848,639,209,74,33,https://www.intensivregister.de/api/public/reporting/laendertabelle
1606277947,848,628,220,72,32,https://www.intensivregister.de/api/public/reporting/laendertabelle
1606281553,844,639,205,71,33,https://www.intensivregister.de/api/public/reporting/laendertabelle
1606285153,846,648,198,74,32,https://www.intensivregister.de/api/public/reporting/laendertabelle
1606292345,846,647,199,75,31,https://www.intensivregister.de/api/public/reporting/laendertabelle
1606299547,846,645,201,75,31,https://www.intensivregister.de/api/public/reporting/laendertabelle
1606342747,846,648,198,75,31,https://www.intensivregister.de/api/public/reporting/laendertabelle
1606364346,846,648,198,73,31,https://www.intensivregister.de/api/public/reporting/laendertabelle
1606367952,846,641,205,71,30,https://www.intensivregister.de/api/public/reporting/laendertabelle
1606371544,846,640,206,72,31,https://www.intensivregister.de/api/public/reporting/laendertabelle
1606375148,846,641,205,74,32,https://www.intensivregister.de/api/public/reporting/laendertabelle
1606378752,846,643,203,74,32,https://www.intensivregister.de/api/public/reporting/laendertabelle
1606382354,846,639,207,74,32,https://www.intensivregister.de/api/public/reporting/laendertabelle
1606385951,846,638,208,74,32,https://www.intensivregister.de/api/public/reporting/laendertabelle
1606389545,844,638,206,74,35,https://www.intensivregister.de/api/public/reporting/laendertabelle
1606393149,843,637,206,73,34,https://www.intensivregister.de/api/public/reporting/laendertabelle
1606450749,844,656,188,72,33,https://www.intensivregister.de/api/public/reporting/laendertabelle
1606454346,844,661,183,75,33,https://www.intensivregister.de/api/public/reporting/laendertabelle
1606457953,845,659,186,73,32,https://www.intensivregister.de/api/public/reporting/laendertabelle
1606461550,845,661,184,73,32,https://www.intensivregister.de/api/public/reporting/laendertabelle
1606468751,845,656,189,73,32,https://www.intensivregister.de/api/public/reporting/laendertabelle
1606472352,841,657,184,74,34,https://www.intensivregister.de/api/public/reporting/laendertabelle
1606537152,841,653,188,74,34,https://www.intensivregister.de/api/public/reporting/laendertabelle
1606540750,839,641,198,74,36,https://www.intensivregister.de/api/public/reporting/laendertabelle
1606544348,839,642,197,78,39,https://www.intensivregister.de/api/public/reporting/laendertabelle
1606547945,839,648,191,77,38,https://www.intensivregister.de/api/public/reporting/laendertabelle
1606551544,839,651,188,77,38,https://www.intensivregister.de/api/public/reporting/laendertabelle
1606555147,839,644,195,77,38,https://www.intensivregister.de/api/public/reporting/laendertabelle
1606619948,839,645,194,77,38,https://www.intensivregister.de/api/public/reporting/laendertabelle
1606623545,839,646,193,77,38,https://www.intensivregister.de/api/public/reporting/laendertabelle
1606627153,839,638,201,77,38,https://www.intensivregister.de/api/public/reporting/laendertabelle
1606630749,839,625,214,79,39,https://www.intensivregister.de/api/public/reporting/laendertabelle
1606634346,838,622,216,80,38,https://www.intensivregister.de/api/public/reporting/laendertabelle
1606637953,838,619,219,78,37,https://www.intensivregister.de/api/public/reporting/laendertabelle
1606641549,838,621,217,78,37,https://www.intensivregister.de/api/public/reporting/laendertabelle
1606648744,838,621,217,79,38,https://www.intensivregister.de/api/public/reporting/laendertabelle
1606655948,838,619,219,79,38,https://www.intensivregister.de/api/public/reporting/laendertabelle
1606709946,838,621,217,81,39,https://www.intensivregister.de/api/public/reporting/laendertabelle
1606713549,838,633,205,81,39,https://www.intensivregister.de/api/public/reporting/laendertabelle
1606717153,838,632,206,81,39,https://www.intensivregister.de/api/public/reporting/laendertabelle
1606720748,839,636,203,79,38,https://www.intensivregister.de/api/public/reporting/laendertabelle
1606724352,839,636,203,80,38,https://www.intensivregister.de/api/public/reporting/laendertabelle
1606727947,839,631,208,82,39,https://www.intensivregister.de/api/public/reporting/laendertabelle
1606796343,841,635,206,84,39,https://www.intensivregister.de/api/public/reporting/laendertabelle
1606799948,840,632,208,85,40,https://www.intensivregister.de/api/public/reporting/laendertabelle
1606803553,840,639,201,86,37,https://www.intensivregister.de/api/public/reporting/laendertabelle
1606807149,840,636,204,87,37,https://www.intensivregister.de/api/public/reporting/laendertabelle
1606810746,840,633,207,85,37,https://www.intensivregister.de/api/public/reporting/laendertabelle
1606814352,844,638,206,85,37,https://www.intensivregister.de/api/public/reporting/laendertabelle
1606821545,842,638,204,85,36,https://www.intensivregister.de/api/public/reporting/laendertabelle
1606864751,842,637,205,85,36,https://www.intensivregister.de/api/public/reporting/laendertabelle
1606879145,842,638,204,85,36,https://www.intensivregister.de/api/public/reporting/laendertabelle
1606882752,842,651,191,85,36,https://www.intensivregister.de/api/public/reporting/laendertabelle
1606886348,842,650,192,85,36,https://www.intensivregister.de/api/public/reporting/laendertabelle
1606889952,840,651,189,85,36,https://www.intensivregister.de/api/public/reporting/laendertabelle
1606893545,831,646,185,86,36,https://www.intensivregister.de/api/public/reporting/laendertabelle
1606897147,825,643,182,86,35,https://www.intensivregister.de/api/public/reporting/laendertabelle
1606900749,825,650,175,87,35,https://www.intensivregister.de/api/public/reporting/laendertabelle
1606904352,825,652,173,87,35,https://www.intensivregister.de/api/public/reporting/laendertabelle
1606907945,822,653,169,88,35,https://www.intensivregister.de/api/public/reporting/laendertabelle
1606929546,822,654,168,88,35,https://www.intensivregister.de/api/public/reporting/laendertabelle
1606965550,822,653,169,88,35,https://www.intensivregister.de/api/public/reporting/laendertabelle
1606969149,822,648,174,85,33,https://www.intensivregister.de/api/public/reporting/laendertabelle
1606972750,822,644,178,89,34,https://www.intensivregister.de/api/public/reporting/laendertabelle
1606976345,823,649,174,92,34,https://www.intensivregister.de/api/public/reporting/laendertabelle
1606983545,823,651,172,91,35,https://www.intensivregister.de/api/public/reporting/laendertabelle
1606987145,823,651,172,88,35,https://www.intensivregister.de/api/public/reporting/laendertabelle
1606997950,823,650,173,89,36,https://www.intensivregister.de/api/public/reporting/laendertabelle
1607051948,823,654,169,89,36,https://www.intensivregister.de/api/public/reporting/laendertabelle
1607055553,823,652,171,88,36,https://www.intensivregister.de/api/public/reporting/laendertabelle
1607059152,825,650,175,88,37,https://www.intensivregister.de/api/public/reporting/laendertabelle
1607062751,825,649,176,89,38,https://www.intensivregister.de/api/public/reporting/laendertabelle
1607066345,825,653,172,88,38,https://www.intensivregister.de/api/public/reporting/laendertabelle
1607069949,825,652,173,89,38,https://www.intensivregister.de/api/public/reporting/laendertabelle
1607077146,825,654,171,89,38,https://www.intensivregister.de/api/public/reporting/laendertabelle
1607120348,825,652,173,89,40,https://www.intensivregister.de/api/public/reporting/laendertabelle
1607145553,821,653,168,91,40,https://www.intensivregister.de/api/public/reporting/laendertabelle
1607149151,820,646,174,88,41,https://www.intensivregister.de/api/public/reporting/laendertabelle
1607152749,820,633,187,88,43,https://www.intensivregister.de/api/public/reporting/laendertabelle
1607156350,812,627,185,88,43,https://www.intensivregister.de/api/public/reporting/laendertabelle
1607159966,812,631,181,89,43,https://www.intensivregister.de/api/public/reporting/laendertabelle
1607174351,812,632,180,89,43,https://www.intensivregister.de/api/public/reporting/laendertabelle
1607206748,812,633,179,89,43,https://www.intensivregister.de/api/public/reporting/laendertabelle
1607228344,812,633,179,88,42,https://www.intensivregister.de/api/public/reporting/laendertabelle
1607231946,812,626,186,90,42,https://www.intensivregister.de/api/public/reporting/laendertabelle
1607235544,810,612,198,86,41,https://www.intensivregister.de/api/public/reporting/laendertabelle
1607239153,811,603,208,90,42,https://www.intensivregister.de/api/public/reporting/laendertabelle
1607242752,811,602,209,90,42,https://www.intensivregister.de/api/public/reporting/laendertabelle
1607246350,811,598,213,91,42,https://www.intensivregister.de/api/public/reporting/laendertabelle
1607253546,811,600,211,91,42,https://www.intensivregister.de/api/public/reporting/laendertabelle
1607293149,811,599,212,91,42,https://www.intensivregister.de/api/public/reporting/laendertabelle
1607314752,811,598,213,89,41,https://www.intensivregister.de/api/public/reporting/laendertabelle
1607318349,812,598,214,89,40,https://www.intensivregister.de/api/public/reporting/laendertabelle
1607321947,811,605,206,87,38,https://www.intensivregister.de/api/public/reporting/laendertabelle
1607325551,811,606,205,87,39,https://www.intensivregister.de/api/public/reporting/laendertabelle
1607329146,811,606,205,86,39,https://www.intensivregister.de/api/public/reporting/laendertabelle
1607332749,811,612,199,89,39,https://www.intensivregister.de/api/public/reporting/laendertabelle
1607336344,811,613,198,89,39,https://www.intensivregister.de/api/public/reporting/laendertabelle
1607357948,811,614,197,90,39,https://www.intensivregister.de/api/public/reporting/laendertabelle
1607397544,811,614,197,91,40,https://www.intensivregister.de/api/public/reporting/laendertabelle
1607401151,814,635,179,88,40,https://www.intensivregister.de/api/public/reporting/laendertabelle
1607404749,814,646,168,89,40,https://www.intensivregister.de/api/public/reporting/laendertabelle
1607408346,814,648,166,92,39,https://www.intensivregister.de/api/public/reporting/laendertabelle
1607411944,813,652,161,93,40,https://www.intensivregister.de/api/public/reporting/laendertabelle
1607415550,813,653,160,90,41,https://www.intensivregister.de/api/public/reporting/laendertabelle
1607426346,813,654,159,90,41,https://www.intensivregister.de/api/public/reporting/laendertabelle
1607483948,813,655,158,90,41,https://www.intensivregister.de/api/public/reporting/laendertabelle
1607487553,813,637,176,88,41,https://www.intensivregister.de/api/public/reporting/laendertabelle
1607491147,812,645,167,92,42,https://www.intensivregister.de/api/public/reporting/laendertabelle
1607494752,805,645,160,92,42,https://www.intensivregister.de/api/public/reporting/laendertabelle
1607498346,804,641,163,89,40,https://www.intensivregister.de/api/public/reporting/laendertabelle
1607501949,804,642,162,90,40,https://www.intensivregister.de/api/public/reporting/laendertabelle
1607505552,804,643,161,90,41,https://www.intensivregister.de/api/public/reporting/laendertabelle
1607516344,804,644,160,90,41,https://www.intensivregister.de/api/public/reporting/laendertabelle
1607559544,804,642,162,90,41,https://www.intensivregister.de/api/public/reporting/laendertabelle
1607563149,804,643,161,90,41,https://www.intensivregister.de/api/public/reporting/laendertabelle
1607566753,804,644,160,90,41,https://www.intensivregister.de/api/public/reporting/laendertabelle
1607570347,804,645,159,91,41,https://www.intensivregister.de/api/public/reporting/laendertabelle
1607573947,804,649,155,92,43,https://www.intensivregister.de/api/public/reporting/laendertabelle
1607577543,802,649,153,93,44,https://www.intensivregister.de/api/public/reporting/laendertabelle
1607581151,802,652,150,96,44,https://www.intensivregister.de/api/public/reporting/laendertabelle
1607591946,802,659,143,101,44,https://www.intensivregister.de/api/public/reporting/laendertabelle
1607602747,802,658,144,102,45,https://www.intensivregister.de/api/public/reporting/laendertabelle
1607656748,802,656,146,101,45,https://www.intensivregister.de/api/public/reporting/laendertabelle
1607660348,802,646,156,100,46,https://www.intensivregister.de/api/public/reporting/laendertabelle
1607663949,802,641,161,102,50,https://www.intensivregister.de/api/public/reporting/laendertabelle
1607667550,802,639,163,102,50,https://www.intensivregister.de/api/public/reporting/laendertabelle
1607671150,803,637,166,106,51,https://www.intensivregister.de/api/public/reporting/laendertabelle
1607674750,803,636,167,106,52,https://www.intensivregister.de/api/public/reporting/laendertabelle
1607692750,803,636,167,105,53,https://www.intensivregister.de/api/public/reporting/laendertabelle
1607735945,803,637,166,105,53,https://www.intensivregister.de/api/public/reporting/laendertabelle
1607746753,803,629,174,104,54,https://www.intensivregister.de/api/public/reporting/laendertabelle
1607750352,803,631,172,104,52,https://www.intensivregister.de/api/public/reporting/laendertabelle
1607753951,802,624,178,106,54,https://www.intensivregister.de/api/public/reporting/laendertabelle
1607757550,802,623,179,102,52,https://www.intensivregister.de/api/public/reporting/laendertabelle
1607761150,802,621,181,102,52,https://www.intensivregister.de/api/public/reporting/laendertabelle
1607764749,802,620,182,102,53,https://www.intensivregister.de/api/public/reporting/laendertabelle
1607771947,798,620,178,102,53,https://www.intensivregister.de/api/public/reporting/laendertabelle
1607782745,798,620,178,103,54,https://www.intensivregister.de/api/public/reporting/laendertabelle
1607822347,798,618,180,103,54,https://www.intensivregister.de/api/public/reporting/laendertabelle
1607836744,796,609,187,104,55,https://www.intensivregister.de/api/public/reporting/laendertabelle
1607840344,787,616,171,106,51,https://www.intensivregister.de/api/public/reporting/laendertabelle
1607843943,787,606,181,107,52,https://www.intensivregister.de/api/public/reporting/laendertabelle
1607847552,787,598,189,108,50,https://www.intensivregister.de/api/public/reporting/laendertabelle
1607851152,787,605,182,111,52,https://www.intensivregister.de/api/public/reporting/laendertabelle
1607897952,787,604,183,111,52,https://www.intensivregister.de/api/public/reporting/laendertabelle
1607919548,799,610,189,112,51,https://www.intensivregister.de/api/public/reporting/laendertabelle
1607923147,797,607,190,112,52,https://www.intensivregister.de/api/public/reporting/laendertabelle
1607928919,798,608,190,111,52,https://www.intensivregister.de/api/public/reporting/laendertabelle
1607930346,798,617,181,114,54,https://www.intensivregister.de/api/public/reporting/laendertabelle
1607948344,798,618,180,113,56,https://www.intensivregister.de/api/public/reporting/laendertabelle
1607984346,798,617,181,113,56,https://www.intensivregister.de/api/public/reporting/laendertabelle
1608005952,798,628,170,115,53,https://www.intensivregister.de/api/public/reporting/laendertabelle
1608009549,798,626,172,117,53,https://www.intensivregister.de/api/public/reporting/laendertabelle
1608013147,798,634,164,118,52,https://www.intensivregister.de/api/public/reporting/laendertabelle
1608016744,796,635,161,119,51,https://www.intensivregister.de/api/public/reporting/laendertabelle
1608023950,796,633,163,120,51,https://www.intensivregister.de/api/public/reporting/laendertabelle
1608070748,796,632,164,120,51,https://www.intensivregister.de/api/public/reporting/laendertabelle
1608074346,796,635,161,120,51,https://www.intensivregister.de/api/public/reporting/laendertabelle
1608092344,796,641,155,119,54,https://www.intensivregister.de/api/public/reporting/laendertabelle
1608095943,794,651,143,120,51,https://www.intensivregister.de/api/public/reporting/laendertabelle
1608099552,788,653,135,120,51,https://www.intensivregister.de/api/public/reporting/laendertabelle
1608106750,788,652,136,120,52,https://www.intensivregister.de/api/public/reporting/laendertabelle
1608113947,792,655,137,127,52,https://www.intensivregister.de/api/public/reporting/laendertabelle
1608117545,792,656,136,128,52,https://www.intensivregister.de/api/public/reporting/laendertabelle
1608157145,792,657,135,128,52,https://www.intensivregister.de/api/public/reporting/laendertabelle
1608178743,791,655,136,127,58,https://www.intensivregister.de/api/public/reporting/laendertabelle
1608182344,791,662,129,126,60,https://www.intensivregister.de/api/public/reporting/laendertabelle
1608185948,791,651,140,122,56,https://www.intensivregister.de/api/public/reporting/laendertabelle
1608196749,791,645,146,122,55,https://www.intensivregister.de/api/public/reporting/laendertabelle
1608250744,791,644,147,122,55,https://www.intensivregister.de/api/public/reporting/laendertabelle
1608265148,791,644,147,123,53,https://www.intensivregister.de/api/public/reporting/laendertabelle
1608268751,788,633,155,120,48,https://www.intensivregister.de/api/public/reporting/laendertabelle
1608272348,788,632,156,121,52,https://www.intensivregister.de/api/public/reporting/laendertabelle
1608279551,788,637,151,123,52,https://www.intensivregister.de/api/public/reporting/laendertabelle
1608283148,788,636,152,122,52,https://www.intensivregister.de/api/public/reporting/laendertabelle
1608286744,788,635,153,122,52,https://www.intensivregister.de/api/public/reporting/laendertabelle
1608293947,788,638,150,122,52,https://www.intensivregister.de/api/public/reporting/laendertabelle
1608297543,788,640,148,122,52,https://www.intensivregister.de/api/public/reporting/laendertabelle
1608333547,788,642,146,122,52,https://www.intensivregister.de/api/public/reporting/laendertabelle
1608337143,788,643,145,122,52,https://www.intensivregister.de/api/public/reporting/laendertabelle
1608351549,784,641,143,124,52,https://www.intensivregister.de/api/public/reporting/laendertabelle
1608355145,785,636,149,127,54,https://www.intensivregister.de/api/public/reporting/laendertabelle
1608358752,785,624,161,125,54,https://www.intensivregister.de/api/public/reporting/laendertabelle
1608362349,790,618,172,131,57,https://www.intensivregister.de/api/public/reporting/laendertabelle
1608365945,790,617,173,131,59,https://www.intensivregister.de/api/public/reporting/laendertabelle
1608369551,782,615,167,133,62,https://www.intensivregister.de/api/public/reporting/laendertabelle
1608416353,782,613,169,133,63,https://www.intensivregister.de/api/public/reporting/laendertabelle
1608419949,782,612,170,133,63,https://www.intensivregister.de/api/public/reporting/laendertabelle
1608437949,784,616,168,139,65,https://www.intensivregister.de/api/public/reporting/laendertabelle
1608441545,782,617,165,138,65,https://www.intensivregister.de/api/public/reporting/laendertabelle
1608445151,782,616,166,143,66,https://www.intensivregister.de/api/public/reporting/laendertabelle
1608448747,777,612,165,146,68,https://www.intensivregister.de/api/public/reporting/laendertabelle
1608452353,773,605,168,146,68,https://www.intensivregister.de/api/public/reporting/laendertabelle
1608455949,773,604,169,146,68,https://www.intensivregister.de/api/public/reporting/laendertabelle
1608502747,773,603,170,146,68,https://www.intensivregister.de/api/public/reporting/laendertabelle
1608506344,773,601,172,146,68,https://www.intensivregister.de/api/public/reporting/laendertabelle
1608520748,773,600,173,146,68,https://www.intensivregister.de/api/public/reporting/laendertabelle
1608524344,775,599,176,147,70,https://www.intensivregister.de/api/public/reporting/laendertabelle
1608527951,770,600,170,145,68,https://www.intensivregister.de/api/public/reporting/laendertabelle
1608531547,780,599,181,146,70,https://www.intensivregister.de/api/public/reporting/laendertabelle
1608535143,780,600,180,148,74,https://www.intensivregister.de/api/public/reporting/laendertabelle
1608538749,781,601,180,148,74,https://www.intensivregister.de/api/public/reporting/laendertabelle
1608542346,783,607,176,148,74,https://www.intensivregister.de/api/public/reporting/laendertabelle
1608596351,783,608,175,148,74,https://www.intensivregister.de/api/public/reporting/laendertabelle
1608607149,783,607,176,148,74,https://www.intensivregister.de/api/public/reporting/laendertabelle
1608610745,784,612,172,152,77,https://www.intensivregister.de/api/public/reporting/laendertabelle
1608614352,785,626,159,158,79,https://www.intensivregister.de/api/public/reporting/laendertabelle
1608617950,787,617,170,156,77,https://www.intensivregister.de/api/public/reporting/laendertabelle
1608621546,787,615,172,155,77,https://www.intensivregister.de/api/public/reporting/laendertabelle
1608625153,787,616,171,155,77,https://www.intensivregister.de/api/public/reporting/laendertabelle
1608646749,787,616,171,157,77,https://www.intensivregister.de/api/public/reporting/laendertabelle
1608675550,787,617,170,157,77,https://www.intensivregister.de/api/public/reporting/laendertabelle
1608689945,787,615,172,157,77,https://www.intensivregister.de/api/public/reporting/laendertabelle
1608693552,787,617,170,154,77,https://www.intensivregister.de/api/public/reporting/laendertabelle
1608697148,790,624,166,160,79,https://www.intensivregister.de/api/public/reporting/laendertabelle
1608700744,790,616,174,164,82,https://www.intensivregister.de/api/public/reporting/laendertabelle
1608704350,790,618,172,171,88,https://www.intensivregister.de/api/public/reporting/laendertabelle
1608707946,790,617,173,173,88,https://www.intensivregister.de/api/public/reporting/laendertabelle
1608711553,790,620,170,173,88,https://www.intensivregister.de/api/public/reporting/laendertabelle
1608729543,798,612,186,173,88,https://www.intensivregister.de/api/public/reporting/laendertabelle
1608740352,798,612,186,174,88,https://www.intensivregister.de/api/public/reporting/laendertabelle
1608754749,798,611,187,172,88,https://www.intensivregister.de/api/public/reporting/laendertabelle
1608783548,802,613,189,172,88,https://www.intensivregister.de/api/public/reporting/laendertabelle
1608787145,802,612,190,175,92,https://www.intensivregister.de/api/public/reporting/laendertabelle
1608790751,803,614,189,175,96,https://www.intensivregister.de/api/public/reporting/laendertabelle
1608794347,801,636,165,179,95,https://www.intensivregister.de/api/public/reporting/laendertabelle
1608797943,800,621,179,181,97,https://www.intensivregister.de/api/public/reporting/laendertabelle
1608801550,800,619,181,183,96,https://www.intensivregister.de/api/public/reporting/laendertabelle
1608823148,798,617,181,183,97,https://www.intensivregister.de/api/public/reporting/laendertabelle
1608841149,798,618,180,183,97,https://www.intensivregister.de/api/public/reporting/laendertabelle
1608869950,798,617,181,184,99,https://www.intensivregister.de/api/public/reporting/laendertabelle
1608873547,788,619,169,187,100,https://www.intensivregister.de/api/public/reporting/laendertabelle
1608877144,788,609,179,185,96,https://www.intensivregister.de/api/public/reporting/laendertabelle
1608880750,790,609,181,185,98,https://www.intensivregister.de/api/public/reporting/laendertabelle
1608884346,790,606,184,186,100,https://www.intensivregister.de/api/public/reporting/laendertabelle
1608887953,792,608,184,186,99,https://www.intensivregister.de/api/public/reporting/laendertabelle
1608920350,792,610,182,188,100,https://www.intensivregister.de/api/public/reporting/laendertabelle
1608923946,793,611,182,189,101,https://www.intensivregister.de/api/public/reporting/laendertabelle
1608949149,792,612,180,189,102,https://www.intensivregister.de/api/public/reporting/laendertabelle
1608959948,792,614,178,190,98,https://www.intensivregister.de/api/public/reporting/laendertabelle
1608963544,792,606,186,193,97,https://www.intensivregister.de/api/public/reporting/laendertabelle
1608967151,792,613,179,194,97,https://www.intensivregister.de/api/public/reporting/laendertabelle
1608970748,796,617,179,198,99,https://www.intensivregister.de/api/public/reporting/laendertabelle
1608974345,791,612,179,198,100,https://www.intensivregister.de/api/public/reporting/laendertabelle
1609024745,791,613,178,198,101,https://www.intensivregister.de/api/public/reporting/laendertabelle
1609042748,791,616,175,199,101,https://www.intensivregister.de/api/public/reporting/laendertabelle
1609046344,791,615,176,199,103,https://www.intensivregister.de/api/public/reporting/laendertabelle
1609049952,787,613,174,199,104,https://www.intensivregister.de/api/public/reporting/laendertabelle
1609053548,786,618,168,202,101,https://www.intensivregister.de/api/public/reporting/laendertabelle
1609057145,786,622,164,203,100,https://www.intensivregister.de/api/public/reporting/laendertabelle
1609060751,786,622,164,202,99,https://www.intensivregister.de/api/public/reporting/laendertabelle
1609067945,786,623,163,202,99,https://www.intensivregister.de/api/public/reporting/laendertabelle
1609071551,786,624,162,202,99,https://www.intensivregister.de/api/public/reporting/laendertabelle
1609082351,786,622,164,200,98,https://www.intensivregister.de/api/public/reporting/laendertabelle
1609093148,786,622,164,201,100,https://www.intensivregister.de/api/public/reporting/laendertabelle
1609125552,786,620,166,201,100,https://www.intensivregister.de/api/public/reporting/laendertabelle
1609129150,786,618,168,204,102,https://www.intensivregister.de/api/public/reporting/laendertabelle
1609132749,786,616,170,201,104,https://www.intensivregister.de/api/public/reporting/laendertabelle
1609136352,786,623,163,206,102,https://www.intensivregister.de/api/public/reporting/laendertabelle
1609139950,781,622,159,205,102,https://www.intensivregister.de/api/public/reporting/laendertabelle
1609143548,784,630,154,205,108,https://www.intensivregister.de/api/public/reporting/laendertabelle
1609147146,783,630,153,205,108,https://www.intensivregister.de/api/public/reporting/laendertabelle
1609157951,782,628,154,203,106,https://www.intensivregister.de/api/public/reporting/laendertabelle
1609211947,778,626,152,203,106,https://www.intensivregister.de/api/public/reporting/laendertabelle
1609215547,779,630,149,205,107,https://www.intensivregister.de/api/public/reporting/laendertabelle
1609219153,779,633,146,209,108,https://www.intensivregister.de/api/public/reporting/laendertabelle
1609222748,790,639,151,211,109,https://www.intensivregister.de/api/public/reporting/laendertabelle
1609233544,790,638,152,211,110,https://www.intensivregister.de/api/public/reporting/laendertabelle
1609301944,789,638,151,208,107,https://www.intensivregister.de/api/public/reporting/laendertabelle
1609305553,789,641,148,210,108,https://www.intensivregister.de/api/public/reporting/laendertabelle
1609309151,789,638,151,209,106,https://www.intensivregister.de/api/public/reporting/laendertabelle
1609312754,788,638,150,209,107,https://www.intensivregister.de/api/public/reporting/laendertabelle
1609316348,788,640,148,211,107,https://www.intensivregister.de/api/public/reporting/laendertabelle
1609334353,788,636,152,211,107,https://www.intensivregister.de/api/public/reporting/laendertabelle
1609366753,788,634,154,211,107,https://www.intensivregister.de/api/public/reporting/laendertabelle
1609388345,788,635,153,213,109,https://www.intensivregister.de/api/public/reporting/laendertabelle
1609391944,789,638,151,212,101,https://www.intensivregister.de/api/public/reporting/laendertabelle
1609395545,789,636,153,211,100,https://www.intensivregister.de/api/public/reporting/laendertabelle
1609399152,786,627,159,212,103,https://www.intensivregister.de/api/public/reporting/laendertabelle
1609402752,781,629,152,215,111,https://www.intensivregister.de/api/public/reporting/laendertabelle
1609406351,781,631,150,215,113,https://www.intensivregister.de/api/public/reporting/laendertabelle
1609460351,781,630,151,215,113,https://www.intensivregister.de/api/public/reporting/laendertabelle
1609474743,781,628,153,213,113,https://www.intensivregister.de/api/public/reporting/laendertabelle
1609478352,781,634,147,210,113,https://www.intensivregister.de/api/public/reporting/laendertabelle
1609481951,780,636,144,208,118,https://www.intensivregister.de/api/public/reporting/laendertabelle
1609485549,777,637,140,211,121,https://www.intensivregister.de/api/public/reporting/laendertabelle
1609489147,776,634,142,208,120,https://www.intensivregister.de/api/public/reporting/laendertabelle
1609492746,775,634,141,207,119,https://www.intensivregister.de/api/public/reporting/laendertabelle
1609521551,775,633,142,208,119,https://www.intensivregister.de/api/public/reporting/laendertabelle
1609539551,775,639,136,208,119,https://www.intensivregister.de/api/public/reporting/laendertabelle
1609561144,775,638,137,208,119,https://www.intensivregister.de/api/public/reporting/laendertabelle
1609564752,778,646,132,207,120,https://www.intensivregister.de/api/public/reporting/laendertabelle
1609568351,780,640,140,213,120,https://www.intensivregister.de/api/public/reporting/laendertabelle
1609571948,782,637,145,213,119,https://www.intensivregister.de/api/public/reporting/laendertabelle
1609575546,784,632,152,216,120,https://www.intensivregister.de/api/public/reporting/laendertabelle
1609597147,784,632,152,215,121,https://www.intensivregister.de/api/public/reporting/laendertabelle
1609633145,784,631,153,215,121,https://www.intensivregister.de/api/public/reporting/laendertabelle
1609647551,784,632,152,216,122,https://www.intensivregister.de/api/public/reporting/laendertabelle
1609651153,786,634,152,218,123,https://www.intensivregister.de/api/public/reporting/laendertabelle
1609654745,786,635,151,218,123,https://www.intensivregister.de/api/public/reporting/laendertabelle
1609658346,783,641,142,219,126,https://www.intensivregister.de/api/public/reporting/laendertabelle
1609661948,783,643,140,216,129,https://www.intensivregister.de/api/public/reporting/laendertabelle
1609665549,784,648,136,220,128,https://www.intensivregister.de/api/public/reporting/laendertabelle
1609730346,785,648,137,220,128,https://www.intensivregister.de/api/public/reporting/laendertabelle
1609733948,783,634,149,218,127,https://www.intensivregister.de/api/public/reporting/laendertabelle
1609737549,783,638,145,223,126,https://www.intensivregister.de/api/public/reporting/laendertabelle
1609741153,783,640,143,218,121,https://www.intensivregister.de/api/public/reporting/laendertabelle
1609744745,781,642,139,219,124,https://www.intensivregister.de/api/public/reporting/laendertabelle
1609748349,780,640,140,219,123,https://www.intensivregister.de/api/public/reporting/laendertabelle
1609798745,780,642,138,219,123,https://www.intensivregister.de/api/public/reporting/laendertabelle
1609802353,780,641,139,218,124,https://www.intensivregister.de/api/public/reporting/laendertabelle
1609820348,781,643,138,213,120,https://www.intensivregister.de/api/public/reporting/laendertabelle
1609823946,776,644,132,206,118,https://www.intensivregister.de/api/public/reporting/laendertabelle
1609827547,777,643,134,204,115,https://www.intensivregister.de/api/public/reporting/laendertabelle
1609831145,777,644,133,202,118,https://www.intensivregister.de/api/public/reporting/laendertabelle
1609870751,778,645,133,202,118,https://www.intensivregister.de/api/public/reporting/laendertabelle
1609885149,778,650,128,203,117,https://www.intensivregister.de/api/public/reporting/laendertabelle
1609888750,778,653,125,203,117,https://www.intensivregister.de/api/public/reporting/laendertabelle
1609906750,780,655,125,203,116,https://www.intensivregister.de/api/public/reporting/laendertabelle
1609910351,783,661,122,205,116,https://www.intensivregister.de/api/public/reporting/laendertabelle
1609913944,783,652,131,200,112,https://www.intensivregister.de/api/public/reporting/laendertabelle
1609917545,782,654,128,202,116,https://www.intensivregister.de/api/public/reporting/laendertabelle
1609921148,785,659,126,204,117,https://www.intensivregister.de/api/public/reporting/laendertabelle
1609924750,787,660,127,204,116,https://www.intensivregister.de/api/public/reporting/laendertabelle
1609939149,782,660,122,204,118,https://www.intensivregister.de/api/public/reporting/laendertabelle
1609971550,782,657,125,204,118,https://www.intensivregister.de/api/public/reporting/laendertabelle
1609989544,782,657,125,205,118,https://www.intensivregister.de/api/public/reporting/laendertabelle
1609993143,783,640,143,199,120,https://www.intensivregister.de/api/public/reporting/laendertabelle
1609996752,790,649,141,202,124,https://www.intensivregister.de/api/public/reporting/laendertabelle
1610000351,790,656,134,201,124,https://www.intensivregister.de/api/public/reporting/laendertabelle
1610007550,791,662,129,204,123,https://www.intensivregister.de/api/public/reporting/laendertabelle
1610014750,791,663,128,204,122,https://www.intensivregister.de/api/public/reporting/laendertabelle
1610068749,791,664,127,205,123,https://www.intensivregister.de/api/public/reporting/laendertabelle
1610079550,791,662,129,211,119,https://www.intensivregister.de/api/public/reporting/laendertabelle
1610083146,787,669,118,209,116,https://www.intensivregister.de/api/public/reporting/laendertabelle
1610086744,787,663,124,206,116,https://www.intensivregister.de/api/public/reporting/laendertabelle
1610090352,786,662,124,206,116,https://www.intensivregister.de/api/public/reporting/laendertabelle
1610093951,785,664,121,208,115,https://www.intensivregister.de/api/public/reporting/laendertabelle
1610104752,785,664,121,209,116,https://www.intensivregister.de/api/public/reporting/laendertabelle
1610162345,785,666,119,210,115,https://www.intensivregister.de/api/public/reporting/laendertabelle
1610165945,785,666,119,208,115,https://www.intensivregister.de/api/public/reporting/laendertabelle
1610169549,783,668,115,206,113,https://www.intensivregister.de/api/public/reporting/laendertabelle
1610173144,784,666,118,209,115,https://www.intensivregister.de/api/public/reporting/laendertabelle
1610176749,783,669,114,202,113,https://www.intensivregister.de/api/public/reporting/laendertabelle
1610183948,783,668,115,204,113,https://www.intensivregister.de/api/public/reporting/laendertabelle
1610237945,783,667,116,204,113,https://www.intensivregister.de/api/public/reporting/laendertabelle
1610252351,783,662,121,201,113,https://www.intensivregister.de/api/public/reporting/laendertabelle
1610255948,783,659,124,201,110,https://www.intensivregister.de/api/public/reporting/laendertabelle
1610259544,781,657,124,203,111,https://www.intensivregister.de/api/public/reporting/laendertabelle
1610263151,780,652,128,200,114,https://www.intensivregister.de/api/public/reporting/laendertabelle
1610266749,780,647,133,200,114,https://www.intensivregister.de/api/public/reporting/laendertabelle
1610270344,778,649,129,202,114,https://www.intensivregister.de/api/public/reporting/laendertabelle
1610302747,778,648,130,203,114,https://www.intensivregister.de/api/public/reporting/laendertabelle
1610331549,778,650,128,203,114,https://www.intensivregister.de/api/public/reporting/laendertabelle
1610335145,778,649,129,203,114,https://www.intensivregister.de/api/public/reporting/laendertabelle
1610338752,778,657,121,207,114,https://www.intensivregister.de/api/public/reporting/laendertabelle
1610342348,774,651,123,209,115,https://www.intensivregister.de/api/public/reporting/laendertabelle
1610345947,776,646,130,203,111,https://www.intensivregister.de/api/public/reporting/laendertabelle
1610349545,776,647,129,203,111,https://www.intensivregister.de/api/public/reporting/laendertabelle
1610353152,776,648,128,204,112,https://www.intensivregister.de/api/public/reporting/laendertabelle
1610378343,776,653,123,206,113,https://www.intensivregister.de/api/public/reporting/laendertabelle
1610403551,776,651,125,206,113,https://www.intensivregister.de/api/public/reporting/laendertabelle
1610407147,776,652,124,206,113,https://www.intensivregister.de/api/public/reporting/laendertabelle
1610425151,776,661,115,213,114,https://www.intensivregister.de/api/public/reporting/laendertabelle
1610428748,781,666,115,208,114,https://www.intensivregister.de/api/public/reporting/laendertabelle
1610432345,785,675,110,212,119,https://www.intensivregister.de/api/public/reporting/laendertabelle
1610435952,785,677,108,212,120,https://www.intensivregister.de/api/public/reporting/laendertabelle
1610439550,785,677,108,209,117,https://www.intensivregister.de/api/public/reporting/laendertabelle
1610450354,785,678,107,209,117,https://www.intensivregister.de/api/public/reporting/laendertabelle
1610489951,785,675,110,209,117,https://www.intensivregister.de/api/public/reporting/laendertabelle
1610507953,785,673,112,208,117,https://www.intensivregister.de/api/public/reporting/laendertabelle
1610511547,790,674,116,203,111,https://www.intensivregister.de/api/public/reporting/laendertabelle
1610515151,788,664,124,200,110,https://www.intensivregister.de/api/public/reporting/laendertabelle
1610518746,786,666,120,195,107,https://www.intensivregister.de/api/public/reporting/laendertabelle
1610522352,787,670,117,193,106,https://www.intensivregister.de/api/public/reporting/laendertabelle
1610525947,787,674,113,194,106,https://www.intensivregister.de/api/public/reporting/laendertabelle
1610529553,789,673,116,196,105,https://www.intensivregister.de/api/public/reporting/laendertabelle
1610583551,789,674,115,196,105,https://www.intensivregister.de/api/public/reporting/laendertabelle
1610594352,789,676,113,196,105,https://www.intensivregister.de/api/public/reporting/laendertabelle
1610597949,789,676,113,198,106,https://www.intensivregister.de/api/public/reporting/laendertabelle
1610601545,791,678,113,194,105,https://www.intensivregister.de/api/public/reporting/laendertabelle
1610605153,793,670,123,197,110,https://www.intensivregister.de/api/public/reporting/laendertabelle
1610612348,794,673,121,198,112,https://www.intensivregister.de/api/public/reporting/laendertabelle
1610615946,790,672,118,198,112,https://www.intensivregister.de/api/public/reporting/laendertabelle
1610630347,790,672,118,197,112,https://www.intensivregister.de/api/public/reporting/laendertabelle
1610644747,790,672,118,196,111,https://www.intensivregister.de/api/public/reporting/laendertabelle
1610662751,790,671,119,196,111,https://www.intensivregister.de/api/public/reporting/laendertabelle
1610684352,791,673,118,196,109,https://www.intensivregister.de/api/public/reporting/laendertabelle
1610687950,788,667,121,193,112,https://www.intensivregister.de/api/public/reporting/laendertabelle
1610691548,790,668,122,195,115,https://www.intensivregister.de/api/public/reporting/laendertabelle
1610695145,788,667,121,195,115,https://www.intensivregister.de/api/public/reporting/laendertabelle
1610698744,788,666,122,195,117,https://www.intensivregister.de/api/public/reporting/laendertabelle
1610702351,791,667,124,193,116,https://www.intensivregister.de/api/public/reporting/laendertabelle
1610705949,791,668,123,193,117,https://www.intensivregister.de/api/public/reporting/laendertabelle
1610770752,792,664,128,194,117,https://www.intensivregister.de/api/public/reporting/laendertabelle
1610774344,793,665,128,193,118,https://www.intensivregister.de/api/public/reporting/laendertabelle
1610777952,799,671,128,193,115,https://www.intensivregister.de/api/public/reporting/laendertabelle
1610781548,799,669,130,190,117,https://www.intensivregister.de/api/public/reporting/laendertabelle
1610785146,799,667,132,190,114,https://www.intensivregister.de/api/public/reporting/laendertabelle
1610846347,799,668,131,190,114,https://www.intensivregister.de/api/public/reporting/laendertabelle
1610860753,799,659,140,187,111,https://www.intensivregister.de/api/public/reporting/laendertabelle
1610864344,798,656,142,185,111,https://www.intensivregister.de/api/public/reporting/laendertabelle
1610867944,800,647,153,182,111,https://www.intensivregister.de/api/public/reporting/laendertabelle
1610871545,800,643,157,179,110,https://www.intensivregister.de/api/public/reporting/laendertabelle
1610929151,799,644,155,179,110,https://www.intensivregister.de/api/public/reporting/laendertabelle
1610939946,799,646,153,179,110,https://www.intensivregister.de/api/public/reporting/laendertabelle
1610943548,796,640,156,179,110,https://www.intensivregister.de/api/public/reporting/laendertabelle
1610947150,796,648,148,182,115,https://www.intensivregister.de/api/public/reporting/laendertabelle
1610950746,797,655,142,185,112,https://www.intensivregister.de/api/public/reporting/laendertabelle
1610954347,795,657,138,184,112,https://www.intensivregister.de/api/public/reporting/laendertabelle
1610957947,795,659,136,185,110,https://www.intensivregister.de/api/public/reporting/laendertabelle
1610968752,795,660,135,185,110,https://www.intensivregister.de/api/public/reporting/laendertabelle
1610975949,795,661,134,185,110,https://www.intensivregister.de/api/public/reporting/laendertabelle
1610979552,795,662,133,185,110,https://www.intensivregister.de/api/public/reporting/laendertabelle
1611026343,795,665,130,187,110,https://www.intensivregister.de/api/public/reporting/laendertabelle
1611029946,796,664,132,187,108,https://www.intensivregister.de/api/public/reporting/laendertabelle
1611033549,796,675,121,187,109,https://www.intensivregister.de/api/public/reporting/laendertabelle
1611037150,801,686,115,187,111,https://www.intensivregister.de/api/public/reporting/laendertabelle
1611040753,801,687,114,186,112,https://www.intensivregister.de/api/public/reporting/laendertabelle
1611087546,801,687,114,185,111,https://www.intensivregister.de/api/public/reporting/laendertabelle
1611098473,801,685,116,185,111,https://www.intensivregister.de/api/public/reporting/laendertabelle
1611101945,801,683,118,185,111,https://www.intensivregister.de/api/public/reporting/laendertabelle
1611116464,801,671,130,178,105,https://www.intensivregister.de/api/public/reporting/laendertabelle
1611120053,802,665,137,177,108,https://www.intensivregister.de/api/public/reporting/laendertabelle
1611123549,802,669,133,178,105,https://www.intensivregister.de/api/public/reporting/laendertabelle
1611127152,802,669,133,177,104,https://www.intensivregister.de/api/public/reporting/laendertabelle
1611130744,802,668,134,178,103,https://www.intensivregister.de/api/public/reporting/laendertabelle
1611163146,802,666,136,177,103,https://www.intensivregister.de/api/public/reporting/laendertabelle
1611202747,802,664,138,176,104,https://www.intensivregister.de/api/public/reporting/laendertabelle
1611206521,813,681,132,175,104,https://www.intensivregister.de/api/public/reporting/laendertabelle
1611209945,810,676,134,173,103,https://www.intensivregister.de/api/public/reporting/laendertabelle
1611213549,810,677,133,173,103,https://www.intensivregister.de/api/public/reporting/laendertabelle
1611217271,810,677,133,171,101,https://www.intensivregister.de/api/public/reporting/laendertabelle
1611231670,810,675,135,171,101,https://www.intensivregister.de/api/public/reporting/laendertabelle
1611274874,810,674,136,171,101,https://www.intensivregister.de/api/public/reporting/laendertabelle
1611289366,810,675,135,165,99,https://www.intensivregister.de/api/public/reporting/laendertabelle
1611292959,808,672,136,168,105,https://www.intensivregister.de/api/public/reporting/laendertabelle
1611296483,808,678,130,169,102,https://www.intensivregister.de/api/public/reporting/laendertabelle
1611300438,811,676,135,171,103,https://www.intensivregister.de/api/public/reporting/laendertabelle
1611303668,810,679,131,175,103,https://www.intensivregister.de/api/public/reporting/laendertabelle
1611307314,810,680,130,175,103,https://www.intensivregister.de/api/public/reporting/laendertabelle
1611376808,810,677,133,175,103,https://www.intensivregister.de/api/public/reporting/laendertabelle
1611379365,810,675,135,175,103,https://www.intensivregister.de/api/public/reporting/laendertabelle
1611382877,813,674,139,177,100,https://www.intensivregister.de/api/public/reporting/laendertabelle
1611386563,814,677,137,180,98,https://www.intensivregister.de/api/public/reporting/laendertabelle
1611390142,814,675,139,178,98,https://www.intensivregister.de/api/public/reporting/laendertabelle
1611440571,814,674,140,178,98,https://www.intensivregister.de/api/public/reporting/laendertabelle
1611462498,814,673,141,178,98,https://www.intensivregister.de/api/public/reporting/laendertabelle
1611466181,814,664,150,180,99,https://www.intensivregister.de/api/public/reporting/laendertabelle
1611469276,814,662,152,183,100,https://www.intensivregister.de/api/public/reporting/laendertabelle
1611473234,804,645,159,183,102,https://www.intensivregister.de/api/public/reporting/laendertabelle
1611476542,803,645,158,183,106,https://www.intensivregister.de/api/public/reporting/laendertabelle
1611544928,803,647,156,183,107,https://www.intensivregister.de/api/public/reporting/laendertabelle
1611548477,803,655,148,177,107,https://www.intensivregister.de/api/public/reporting/laendertabelle
1611552170,805,659,146,181,105,https://www.intensivregister.de/api/public/reporting/laendertabelle
1611555782,806,673,133,180,104,https://www.intensivregister.de/api/public/reporting/laendertabelle
1611559376,806,676,130,180,105,https://www.intensivregister.de/api/public/reporting/laendertabelle
1611562874,808,680,128,181,104,https://www.intensivregister.de/api/public/reporting/laendertabelle
1611566852,808,681,127,181,104,https://www.intensivregister.de/api/public/reporting/laendertabelle
1611616985,808,682,126,181,104,https://www.intensivregister.de/api/public/reporting/laendertabelle
1611635283,808,687,121,182,103,https://www.intensivregister.de/api/public/reporting/laendertabelle
1611638852,808,692,116,181,101,https://www.intensivregister.de/api/public/reporting/laendertabelle
1611642123,815,695,120,179,99,https://www.intensivregister.de/api/public/reporting/laendertabelle
1611645738,815,691,124,176,98,https://www.intensivregister.de/api/public/reporting/laendertabelle
1611649390,815,691,124,174,96,https://www.intensivregister.de/api/public/reporting/laendertabelle
1611656540,815,690,125,172,96,https://www.intensivregister.de/api/public/reporting/laendertabelle
1611660130,815,692,123,172,97,https://www.intensivregister.de/api/public/reporting/laendertabelle
1611734282,808,695,113,170,97,https://www.intensivregister.de/api/public/reporting/laendertabelle
1611743148,808,695,113,173,98,https://www.intensivregister.de/api/public/reporting/laendertabelle
1611753739,810,699,111,175,98,https://www.intensivregister.de/api/public/reporting/laendertabelle
1611793278,810,696,114,175,98,https://www.intensivregister.de/api/public/reporting/laendertabelle
1611807688,810,700,110,175,99,https://www.intensivregister.de/api/public/reporting/laendertabelle
1611811418,809,696,113,174,99,https://www.intensivregister.de/api/public/reporting/laendertabelle
1611814751,802,693,109,173,102,https://www.intensivregister.de/api/public/reporting/laendertabelle
1611818480,802,693,109,172,100,https://www.intensivregister.de/api/public/reporting/laendertabelle
1611822149,802,692,110,172,100,https://www.intensivregister.de/api/public/reporting/laendertabelle
1611825687,802,685,117,173,100,https://www.intensivregister.de/api/public/reporting/laendertabelle
1611832872,803,686,117,173,100,https://www.intensivregister.de/api/public/reporting/laendertabelle
1611847362,804,687,117,174,100,https://www.intensivregister.de/api/public/reporting/laendertabelle
1611851303,804,685,119,176,99,https://www.intensivregister.de/api/public/reporting/laendertabelle
1611876469,804,683,121,176,99,https://www.intensivregister.de/api/public/reporting/laendertabelle
1611890456,804,682,122,176,98,https://www.intensivregister.de/api/public/reporting/laendertabelle
1611894116,798,676,122,177,96,https://www.intensivregister.de/api/public/reporting/laendertabelle
1611897790,798,680,118,172,94,https://www.intensivregister.de/api/public/reporting/laendertabelle
1611901372,797,675,122,172,94,https://www.intensivregister.de/api/public/reporting/laendertabelle
1611904975,802,683,119,175,99,https://www.intensivregister.de/api/public/reporting/laendertabelle
1611908523,802,684,118,177,99,https://www.intensivregister.de/api/public/reporting/laendertabelle
1611912131,800,678,122,174,95,https://www.intensivregister.de/api/public/reporting/laendertabelle
1611980469,800,678,122,173,96,https://www.intensivregister.de/api/public/reporting/laendertabelle
1611984455,798,678,120,169,95,https://www.intensivregister.de/api/public/reporting/laendertabelle
1611987680,801,676,125,167,96,https://www.intensivregister.de/api/public/reporting/laendertabelle
1611991284,800,676,124,165,93,https://www.intensivregister.de/api/public/reporting/laendertabelle
1611994987,801,673,128,167,92,https://www.intensivregister.de/api/public/reporting/laendertabelle
1612066929,801,667,134,169,92,https://www.intensivregister.de/api/public/reporting/laendertabelle
1612070464,801,660,141,166,91,https://www.intensivregister.de/api/public/reporting/laendertabelle
1612074189,800,656,144,167,89,https://www.intensivregister.de/api/public/reporting/laendertabelle
1612078088,799,647,152,169,86,https://www.intensivregister.de/api/public/reporting/laendertabelle
1612081680,799,645,154,169,86,https://www.intensivregister.de/api/public/reporting/laendertabelle
1612084976,799,650,149,171,86,https://www.intensivregister.de/api/public/reporting/laendertabelle
1612132098,799,651,148,171,86,https://www.intensivregister.de/api/public/reporting/laendertabelle
1612150109,801,653,148,172,86,https://www.intensivregister.de/api/public/reporting/laendertabelle
1612153372,801,656,145,172,83,https://www.intensivregister.de/api/public/reporting/laendertabelle
1612156888,794,652,142,171,82,https://www.intensivregister.de/api/public/reporting/laendertabelle
1612160478,795,653,142,171,80,https://www.intensivregister.de/api/public/reporting/laendertabelle
1612164573,794,655,139,171,85,https://www.intensivregister.de/api/public/reporting/laendertabelle
1612167743,795,654,141,172,84,https://www.intensivregister.de/api/public/reporting/laendertabelle
1612171351,795,655,140,171,84,https://www.intensivregister.de/api/public/reporting/laendertabelle
1612181945,795,659,136,172,84,https://www.intensivregister.de/api/public/reporting/laendertabelle
1612235953,795,658,137,173,85,https://www.intensivregister.de/api/public/reporting/laendertabelle
1612239553,800,658,142,172,86,https://www.intensivregister.de/api/public/reporting/laendertabelle
1612243154,801,661,140,170,85,https://www.intensivregister.de/api/public/reporting/laendertabelle
1612246755,801,663,138,171,85,https://www.intensivregister.de/api/public/reporting/laendertabelle
1612257545,801,662,139,168,86,https://www.intensivregister.de/api/public/reporting/laendertabelle
1612322348,801,663,138,169,86,https://www.intensivregister.de/api/public/reporting/laendertabelle
1612325949,803,672,131,175,90,https://www.intensivregister.de/api/public/reporting/laendertabelle
1612329550,800,666,134,178,90,https://www.intensivregister.de/api/public/reporting/laendertabelle
1612333150,801,668,133,179,90,https://www.intensivregister.de/api/public/reporting/laendertabelle
1612336751,801,680,121,179,88,https://www.intensivregister.de/api/public/reporting/laendertabelle
1612340353,803,684,119,180,90,https://www.intensivregister.de/api/public/reporting/laendertabelle
1612306800,803,684,119,180,90,https://www.intensivregister.de/api/public/reporting/laendertabelle
1612393200,804,701,103,178,92,https://www.intensivregister.de/api/public/reporting/laendertabelle
1612479600,797,684,113,177,95,https://www.intensivregister.de/api/public/reporting/laendertabelle
1612566000,798,667,131,158,82,https://www.intensivregister.de/api/public/reporting/laendertabelle
1612652400,785,646,139,148,85,https://www.intensivregister.de/api/public/reporting/laendertabelle
1612738800,783,654,129,158,87,https://www.intensivregister.de/api/public/reporting/laendertabelle
1612825200,779,651,128,157,86,https://www.intensivregister.de/api/public/reporting/laendertabelle
1612911600,786,682,104,159,85,https://www.intensivregister.de/api/public/reporting/laendertabelle
1612998000,782,673,109,152,80,https://www.intensivregister.de/api/public/reporting/laendertabelle
1613084400,780,656,124,140,79,https://www.intensivregister.de/api/public/reporting/laendertabelle
1613170800,775,647,128,136,74,https://www.intensivregister.de/api/public/reporting/laendertabelle
1613257200,766,644,122,130,66,https://www.intensivregister.de/api/public/reporting/laendertabelle
1613343600,762,652,110,130,66,https://www.intensivregister.de/api/public/reporting/laendertabelle
1613402350,762,652,110,130,66,https://www.intensivregister.de/api/public/reporting/laendertabelle
1613431153,762,653,109,130,66,https://www.intensivregister.de/api/public/reporting/laendertabelle
1613445551,762,652,110,129,65,https://www.intensivregister.de/api/public/reporting/laendertabelle
1613449151,760,646,114,124,65,https://www.intensivregister.de/api/public/reporting/laendertabelle
1613452752,766,660,106,121,64,https://www.intensivregister.de/api/public/reporting/laendertabelle
1613456350,766,661,105,121,63,https://www.intensivregister.de/api/public/reporting/laendertabelle
1613459949,764,662,102,120,61,https://www.intensivregister.de/api/public/reporting/laendertabelle
1613467146,765,660,105,117,60,https://www.intensivregister.de/api/public/reporting/laendertabelle
1613485145,765,658,107,117,60,https://www.intensivregister.de/api/public/reporting/laendertabelle
1613513952,765,654,111,117,60,https://www.intensivregister.de/api/public/reporting/laendertabelle
1613535549,771,666,105,125,65,https://www.intensivregister.de/api/public/reporting/laendertabelle
1613539148,772,664,108,129,67,https://www.intensivregister.de/api/public/reporting/laendertabelle
1613542748,770,664,106,132,67,https://www.intensivregister.de/api/public/reporting/laendertabelle
1613549948,774,664,110,129,68,https://www.intensivregister.de/api/public/reporting/laendertabelle
1613600344,774,663,111,129,68,https://www.intensivregister.de/api/public/reporting/laendertabelle
1613614747,774,664,110,129,68,https://www.intensivregister.de/api/public/reporting/laendertabelle
1613618345,774,665,109,129,68,https://www.intensivregister.de/api/public/reporting/laendertabelle
1613621946,774,666,108,128,67,https://www.intensivregister.de/api/public/reporting/laendertabelle
1613625545,775,661,114,128,68,https://www.intensivregister.de/api/public/reporting/laendertabelle
1613629145,774,657,117,127,69,https://www.intensivregister.de/api/public/reporting/laendertabelle
1613632745,772,663,109,127,69,https://www.intensivregister.de/api/public/reporting/laendertabelle
1613636345,773,666,107,126,69,https://www.intensivregister.de/api/public/reporting/laendertabelle
1613708349,774,656,118,126,70,https://www.intensivregister.de/api/public/reporting/laendertabelle
1613711949,772,662,110,129,71,https://www.intensivregister.de/api/public/reporting/laendertabelle
1613715549,772,661,111,130,71,https://www.intensivregister.de/api/public/reporting/laendertabelle
1613719149,770,659,111,129,69,https://www.intensivregister.de/api/public/reporting/laendertabelle
1613722748,769,657,112,129,68,https://www.intensivregister.de/api/public/reporting/laendertabelle
1613794746,769,652,117,129,68,https://www.intensivregister.de/api/public/reporting/laendertabelle
1613798350,768,648,120,126,69,https://www.intensivregister.de/api/public/reporting/laendertabelle
1613801943,769,647,122,127,69,https://www.intensivregister.de/api/public/reporting/laendertabelle
1613805547,762,640,122,128,68,https://www.intensivregister.de/api/public/reporting/laendertabelle
1613809150,764,642,122,127,69,https://www.intensivregister.de/api/public/reporting/laendertabelle
1613884743,764,641,123,127,71,https://www.intensivregister.de/api/public/reporting/laendertabelle
1613888344,762,643,119,129,74,https://www.intensivregister.de/api/public/reporting/laendertabelle
1613891944,759,639,120,130,76,https://www.intensivregister.de/api/public/reporting/laendertabelle
1613895544,759,632,127,128,74,https://www.intensivregister.de/api/public/reporting/laendertabelle
1613899145,759,634,125,128,74,https://www.intensivregister.de/api/public/reporting/laendertabelle
1613902746,759,635,124,128,74,https://www.intensivregister.de/api/public/reporting/laendertabelle
1613963952,759,634,125,128,74,https://www.intensivregister.de/api/public/reporting/laendertabelle
1613967552,759,635,124,133,76,https://www.intensivregister.de/api/public/reporting/laendertabelle
1613971153,768,652,116,136,75,https://www.intensivregister.de/api/public/reporting/laendertabelle
1613974753,769,650,119,136,75,https://www.intensivregister.de/api/public/reporting/laendertabelle
1613978343,767,649,118,137,75,https://www.intensivregister.de/api/public/reporting/laendertabelle
1613981944,767,647,120,136,76,https://www.intensivregister.de/api/public/reporting/laendertabelle
1613996347,767,644,123,135,75,https://www.intensivregister.de/api/public/reporting/laendertabelle
1614032350,767,643,124,135,75,https://www.intensivregister.de/api/public/reporting/laendertabelle
1614046752,767,644,123,135,75,https://www.intensivregister.de/api/public/reporting/laendertabelle
1614050353,767,646,121,135,75,https://www.intensivregister.de/api/public/reporting/laendertabelle
1614053943,768,650,118,134,74,https://www.intensivregister.de/api/public/reporting/laendertabelle
1614057544,765,647,118,134,74,https://www.intensivregister.de/api/public/reporting/laendertabelle
1614061145,765,657,108,131,75,https://www.intensivregister.de/api/public/reporting/laendertabelle
1614064745,768,667,101,134,77,https://www.intensivregister.de/api/public/reporting/laendertabelle
1614068346,768,672,96,135,77,https://www.intensivregister.de/api/public/reporting/laendertabelle
1614125943,768,671,97,135,77,https://www.intensivregister.de/api/public/reporting/laendertabelle
1614140349,767,667,100,135,75,https://www.intensivregister.de/api/public/reporting/laendertabelle
1614143949,769,668,101,131,72,https://www.intensivregister.de/api/public/reporting/laendertabelle
1614147550,769,671,98,132,71,https://www.intensivregister.de/api/public/reporting/laendertabelle
1614151150,767,660,107,132,70,https://www.intensivregister.de/api/public/reporting/laendertabelle
1614154752,767,658,109,132,69,https://www.intensivregister.de/api/public/reporting/laendertabelle
1614226749,774,667,107,132,69,https://www.intensivregister.de/api/public/reporting/laendertabelle
1614230347,776,667,109,132,70,https://www.intensivregister.de/api/public/reporting/laendertabelle
1614233945,776,661,115,131,70,https://www.intensivregister.de/api/public/reporting/laendertabelle
1614237543,776,665,111,131,70,https://www.intensivregister.de/api/public/reporting/laendertabelle
1614241151,776,668,108,131,69,https://www.intensivregister.de/api/public/reporting/laendertabelle
1614298748,776,667,109,131,69,https://www.intensivregister.de/api/public/reporting/laendertabelle
1614313149,778,678,100,131,69,https://www.intensivregister.de/api/public/reporting/laendertabelle
1614316747,778,675,103,131,68,https://www.intensivregister.de/api/public/reporting/laendertabelle
1614320345,778,682,96,130,67,https://www.intensivregister.de/api/public/reporting/laendertabelle
1614323943,778,685,93,129,67,https://www.intensivregister.de/api/public/reporting/laendertabelle
1614327551,780,686,94,131,69,https://www.intensivregister.de/api/public/reporting/laendertabelle
1614331149,780,684,96,131,69,https://www.intensivregister.de/api/public/reporting/laendertabelle
1614377952,780,683,97,132,70,https://www.intensivregister.de/api/public/reporting/laendertabelle
1614399550,780,684,96,132,70,https://www.intensivregister.de/api/public/reporting/laendertabelle
1614403148,780,678,102,129,72,https://www.intensivregister.de/api/public/reporting/laendertabelle
1614406746,781,673,108,130,76,https://www.intensivregister.de/api/public/reporting/laendertabelle
1614410344,771,657,114,130,77,https://www.intensivregister.de/api/public/reporting/laendertabelle
1614413952,771,652,119,128,72,https://www.intensivregister.de/api/public/reporting/laendertabelle
1614489550,769,641,128,130,73,https://www.intensivregister.de/api/public/reporting/laendertabelle
1614493150,769,644,125,130,77,https://www.intensivregister.de/api/public/reporting/laendertabelle
1614496747,765,643,122,132,79,https://www.intensivregister.de/api/public/reporting/laendertabelle
1614500345,766,647,119,135,81,https://www.intensivregister.de/api/public/reporting/laendertabelle
1614503943,766,648,118,135,81,https://www.intensivregister.de/api/public/reporting/laendertabelle
1614550748,766,650,116,135,82,https://www.intensivregister.de/api/public/reporting/laendertabelle
1614554350,766,648,118,135,82,https://www.intensivregister.de/api/public/reporting/laendertabelle
1614572347,764,649,115,135,80,https://www.intensivregister.de/api/public/reporting/laendertabelle
1614575949,760,650,110,136,78,https://www.intensivregister.de/api/public/reporting/laendertabelle
1614579551,758,653,105,139,77,https://www.intensivregister.de/api/public/reporting/laendertabelle
1614583143,755,653,102,140,77,https://www.intensivregister.de/api/public/reporting/laendertabelle
1614586745,756,653,103,139,76,https://www.intensivregister.de/api/public/reporting/laendertabelle
1614637143,756,655,101,139,76,https://www.intensivregister.de/api/public/reporting/laendertabelle
1614658752,760,658,102,139,76,https://www.intensivregister.de/api/public/reporting/laendertabelle
1614662344,763,668,95,138,77,https://www.intensivregister.de/api/public/reporting/laendertabelle
1614665947,772,680,92,141,76,https://www.intensivregister.de/api/public/reporting/laendertabelle
1614669548,772,677,95,141,76,https://www.intensivregister.de/api/public/reporting/laendertabelle
1614673151,774,679,95,141,77,https://www.intensivregister.de/api/public/reporting/laendertabelle
1614723547,774,677,97,141,77,https://www.intensivregister.de/api/public/reporting/laendertabelle
1614741545,774,676,98,141,77,https://www.intensivregister.de/api/public/reporting/laendertabelle
1614745147,776,676,100,139,77,https://www.intensivregister.de/api/public/reporting/laendertabelle
1614748749,776,674,102,139,77,https://www.intensivregister.de/api/public/reporting/laendertabelle
1614752351,775,668,107,136,75,https://www.intensivregister.de/api/public/reporting/laendertabelle
1614755943,775,668,107,134,74,https://www.intensivregister.de/api/public/reporting/laendertabelle
1614766750,775,667,108,134,74,https://www.intensivregister.de/api/public/reporting/laendertabelle
1614817147,776,668,108,134,74,https://www.intensivregister.de/api/public/reporting/laendertabelle
1614827952,777,671,106,134,74,https://www.intensivregister.de/api/public/reporting/laendertabelle
1614835145,777,654,123,139,75,https://www.intensivregister.de/api/public/reporting/laendertabelle
1614838747,777,655,122,137,74,https://www.intensivregister.de/api/public/reporting/laendertabelle
1614842349,781,661,120,137,75,https://www.intensivregister.de/api/public/reporting/laendertabelle
1614845951,781,664,117,138,76,https://www.intensivregister.de/api/public/reporting/laendertabelle
1614892746,781,663,118,138,76,https://www.intensivregister.de/api/public/reporting/laendertabelle
1614896348,781,661,120,138,76,https://www.intensivregister.de/api/public/reporting/laendertabelle
1614914345,781,660,121,138,76,https://www.intensivregister.de/api/public/reporting/laendertabelle
1614917946,775,653,122,136,74,https://www.intensivregister.de/api/public/reporting/laendertabelle
1614921548,775,657,118,135,76,https://www.intensivregister.de/api/public/reporting/laendertabelle
1614925150,776,664,112,136,78,https://www.intensivregister.de/api/public/reporting/laendertabelle
1614928752,776,661,115,136,78,https://www.intensivregister.de/api/public/reporting/laendertabelle
1614932344,777,661,116,137,78,https://www.intensivregister.de/api/public/reporting/laendertabelle
1614935946,777,656,121,135,78,https://www.intensivregister.de/api/public/reporting/laendertabelle
1614982748,776,656,120,135,78,https://www.intensivregister.de/api/public/reporting/laendertabelle
1615004348,775,654,121,135,78,https://www.intensivregister.de/api/public/reporting/laendertabelle
1615007950,775,655,120,135,78,https://www.intensivregister.de/api/public/reporting/laendertabelle
1615011553,776,656,120,136,77,https://www.intensivregister.de/api/public/reporting/laendertabelle
1615015143,774,660,114,136,73,https://www.intensivregister.de/api/public/reporting/laendertabelle
1615018744,776,660,116,134,71,https://www.intensivregister.de/api/public/reporting/laendertabelle
1615069150,776,661,115,133,71,https://www.intensivregister.de/api/public/reporting/laendertabelle
1615090750,776,658,118,133,71,https://www.intensivregister.de/api/public/reporting/laendertabelle
1615094352,776,656,120,133,71,https://www.intensivregister.de/api/public/reporting/laendertabelle
1615097944,776,643,133,135,71,https://www.intensivregister.de/api/public/reporting/laendertabelle
1615101545,771,641,130,133,70,https://www.intensivregister.de/api/public/reporting/laendertabelle
1615105147,771,642,129,133,70,https://www.intensivregister.de/api/public/reporting/laendertabelle
1615108750,765,634,131,136,71,https://www.intensivregister.de/api/public/reporting/laendertabelle
1615173547,765,635,130,136,71,https://www.intensivregister.de/api/public/reporting/laendertabelle
1615177149,765,636,129,136,71,https://www.intensivregister.de/api/public/reporting/laendertabelle
1615180750,757,641,116,136,71,https://www.intensivregister.de/api/public/reporting/laendertabelle
1615184352,757,646,111,134,67,https://www.intensivregister.de/api/public/reporting/laendertabelle
1615187945,755,641,114,135,67,https://www.intensivregister.de/api/public/reporting/laendertabelle
1615191546,755,640,115,135,67,https://www.intensivregister.de/api/public/reporting/laendertabelle
1615195149,756,640,116,135,67,https://www.intensivregister.de/api/public/reporting/laendertabelle
1615259943,756,639,117,135,67,https://www.intensivregister.de/api/public/reporting/laendertabelle
1615263547,767,643,124,130,63,https://www.intensivregister.de/api/public/reporting/laendertabelle
1615267149,769,642,127,129,62,https://www.intensivregister.de/api/public/reporting/laendertabelle
1615270752,767,646,121,130,65,https://www.intensivregister.de/api/public/reporting/laendertabelle
1615277946,770,650,120,130,65,https://www.intensivregister.de/api/public/reporting/laendertabelle
1615281549,771,652,119,130,65,https://www.intensivregister.de/api/public/reporting/laendertabelle
1615349948,776,654,122,129,67,https://www.intensivregister.de/api/public/reporting/laendertabelle
1615357143,776,665,111,123,67,https://www.intensivregister.de/api/public/reporting/laendertabelle
1615360745,776,668,108,120,66,https://www.intensivregister.de/api/public/reporting/laendertabelle
1615364348,777,661,116,117,67,https://www.intensivregister.de/api/public/reporting/laendertabelle
1615367951,777,660,117,118,67,https://www.intensivregister.de/api/public/reporting/laendertabelle
1615432746,777,660,117,116,66,https://www.intensivregister.de/api/public/reporting/laendertabelle
1615439950,777,656,121,117,66,https://www.intensivregister.de/api/public/reporting/laendertabelle
1615443552,777,657,120,117,66,https://www.intensivregister.de/api/public/reporting/laendertabelle
1615447146,777,655,122,116,65,https://www.intensivregister.de/api/public/reporting/laendertabelle
1615450749,774,652,122,116,64,https://www.intensivregister.de/api/public/reporting/laendertabelle
1615454350,774,653,121,116,65,https://www.intensivregister.de/api/public/reporting/laendertabelle
1615483149,774,654,120,116,65,https://www.intensivregister.de/api/public/reporting/laendertabelle
1615501148,774,655,119,117,66,https://www.intensivregister.de/api/public/reporting/laendertabelle
1615504749,774,654,120,117,66,https://www.intensivregister.de/api/public/reporting/laendertabelle
1615522747,775,657,118,114,65,https://www.intensivregister.de/api/public/reporting/laendertabelle
1615526349,776,664,112,115,67,https://www.intensivregister.de/api/public/reporting/laendertabelle
1615529951,776,662,114,116,69,https://www.intensivregister.de/api/public/reporting/laendertabelle
1615533543,776,659,117,114,70,https://www.intensivregister.de/api/public/reporting/laendertabelle
1615537145,774,653,121,113,69,https://www.intensivregister.de/api/public/reporting/laendertabelle
1615594747,773,654,119,113,69,https://www.intensivregister.de/api/public/reporting/laendertabelle
1615609144,773,652,121,116,67,https://www.intensivregister.de/api/public/reporting/laendertabelle
1615612745,773,651,122,116,67,https://www.intensivregister.de/api/public/reporting/laendertabelle
1615616347,773,643,130,119,66,https://www.intensivregister.de/api/public/reporting/laendertabelle
1615619948,775,651,124,120,64,https://www.intensivregister.de/api/public/reporting/laendertabelle
1615623550,775,653,122,120,65,https://www.intensivregister.de/api/public/reporting/laendertabelle
1615627152,775,650,125,119,65,https://www.intensivregister.de/api/public/reporting/laendertabelle
1615637946,775,649,126,119,65,https://www.intensivregister.de/api/public/reporting/laendertabelle
1615641548,775,649,126,120,65,https://www.intensivregister.de/api/public/reporting/laendertabelle
1615681145,775,648,127,119,65,https://www.intensivregister.de/api/public/reporting/laendertabelle
1615684747,774,649,125,119,65,https://www.intensivregister.de/api/public/reporting/laendertabelle
1615699143,776,648,128,117,64,https://www.intensivregister.de/api/public/reporting/laendertabelle
1615702745,776,646,130,117,64,https://www.intensivregister.de/api/public/reporting/laendertabelle
1615706346,770,643,127,122,65,https://www.intensivregister.de/api/public/reporting/laendertabelle
1615709948,766,643,123,126,68,https://www.intensivregister.de/api/public/reporting/laendertabelle
1615717152,766,644,122,126,68,https://www.intensivregister.de/api/public/reporting/laendertabelle
1615720744,766,645,121,126,68,https://www.intensivregister.de/api/public/reporting/laendertabelle
1615760344,766,647,119,126,68,https://www.intensivregister.de/api/public/reporting/laendertabelle
1615781945,764,648,116,129,69,https://www.intensivregister.de/api/public/reporting/laendertabelle
1615785547,764,643,121,134,71,https://www.intensivregister.de/api/public/reporting/laendertabelle
1615789150,770,643,127,131,70,https://www.intensivregister.de/api/public/reporting/laendertabelle
1615792752,767,633,134,130,70,https://www.intensivregister.de/api/public/reporting/laendertabelle
1615853946,767,632,135,130,70,https://www.intensivregister.de/api/public/reporting/laendertabelle
1615868352,769,638,131,127,69,https://www.intensivregister.de/api/public/reporting/laendertabelle
1615871944,770,649,121,124,70,https://www.intensivregister.de/api/public/reporting/laendertabelle
1615875546,770,649,121,126,70,https://www.intensivregister.de/api/public/reporting/laendertabelle
1615879148,767,652,115,125,71,https://www.intensivregister.de/api/public/reporting/laendertabelle
1615882751,767,649,118,126,71,https://www.intensivregister.de/api/public/reporting/laendertabelle
1615900744,767,651,116,126,71,https://www.intensivregister.de/api/public/reporting/laendertabelle
1615933143,767,647,120,126,71,https://www.intensivregister.de/api/public/reporting/laendertabelle
1615936745,767,649,118,126,71,https://www.intensivregister.de/api/public/reporting/laendertabelle
1615954744,767,657,110,138,70,https://www.intensivregister.de/api/public/reporting/laendertabelle
1615961948,765,655,110,139,73,https://www.intensivregister.de/api/public/reporting/laendertabelle
1615965550,764,657,107,142,76,https://www.intensivregister.de/api/public/reporting/laendertabelle
1615972746,764,655,109,142,76,https://www.intensivregister.de/api/public/reporting/laendertabelle
1616041147,764,655,109,143,76,https://www.intensivregister.de/api/public/reporting/laendertabelle
1616044749,773,667,106,143,76,https://www.intensivregister.de/api/public/reporting/laendertabelle
1616048351,773,669,104,143,76,https://www.intensivregister.de/api/public/reporting/laendertabelle
1616051944,773,665,108,144,77,https://www.intensivregister.de/api/public/reporting/laendertabelle
1616055546,773,668,105,141,77,https://www.intensivregister.de/api/public/reporting/laendertabelle
1616113162,773,672,101,141,77,https://www.intensivregister.de/api/public/reporting/laendertabelle
1616127543,775,672,103,140,79,https://www.intensivregister.de/api/public/reporting/laendertabelle
1616131153,772,662,110,142,80,https://www.intensivregister.de/api/public/reporting/laendertabelle
1616134753,771,663,108,143,78,https://www.intensivregister.de/api/public/reporting/laendertabelle
1616141952,771,659,112,144,78,https://www.intensivregister.de/api/public/reporting/laendertabelle
1616213952,771,656,115,144,78,https://www.intensivregister.de/api/public/reporting/laendertabelle
1616217552,772,658,114,146,77,https://www.intensivregister.de/api/public/reporting/laendertabelle
1616221152,770,653,117,144,76,https://www.intensivregister.de/api/public/reporting/laendertabelle
1616224752,774,651,123,147,81,https://www.intensivregister.de/api/public/reporting/laendertabelle
1616228352,770,648,122,151,83,https://www.intensivregister.de/api/public/reporting/laendertabelle
1616257151,770,649,121,152,83,https://www.intensivregister.de/api/public/reporting/laendertabelle
1616278750,770,650,120,152,84,https://www.intensivregister.de/api/public/reporting/laendertabelle
1616300349,769,653,116,152,84,https://www.intensivregister.de/api/public/reporting/laendertabelle
1616303949,769,654,115,150,83,https://www.intensivregister.de/api/public/reporting/laendertabelle
1616311149,769,645,124,151,84,https://www.intensivregister.de/api/public/reporting/laendertabelle
1616314749,769,642,127,152,86,https://www.intensivregister.de/api/public/reporting/laendertabelle
1616321949,769,644,125,153,88,https://www.intensivregister.de/api/public/reporting/laendertabelle
1616332748,771,642,129,155,87,https://www.intensivregister.de/api/public/reporting/laendertabelle
1616336348,771,644,127,155,87,https://www.intensivregister.de/api/public/reporting/laendertabelle
1616372348,771,642,129,155,87,https://www.intensivregister.de/api/public/reporting/laendertabelle
1616383150,771,643,128,155,87,https://www.intensivregister.de/api/public/reporting/laendertabelle
1616386750,767,641,126,153,89,https://www.intensivregister.de/api/public/reporting/laendertabelle
1616390350,769,643,126,154,92,https://www.intensivregister.de/api/public/reporting/laendertabelle
1616393950,771,650,121,152,91,https://www.intensivregister.de/api/public/reporting/laendertabelle
1616397549,772,654,118,153,91,https://www.intensivregister.de/api/public/reporting/laendertabelle
1616401149,770,652,118,152,91,https://www.intensivregister.de/api/public/reporting/laendertabelle
1616447949,770,652,118,154,92,https://www.intensivregister.de/api/public/reporting/laendertabelle
1616462350,770,653,117,154,92,https://www.intensivregister.de/api/public/reporting/laendertabelle
1616469548,770,655,115,154,92,https://www.intensivregister.de/api/public/reporting/laendertabelle
1616473152,772,666,106,156,93,https://www.intensivregister.de/api/public/reporting/laendertabelle
1616476747,773,665,108,156,93,https://www.intensivregister.de/api/public/reporting/laendertabelle
1616480351,772,667,105,154,90,https://www.intensivregister.de/api/public/reporting/laendertabelle
1616483945,772,669,103,157,92,https://www.intensivregister.de/api/public/reporting/laendertabelle
1616487549,772,677,95,158,93,https://www.intensivregister.de/api/public/reporting/laendertabelle
1616541549,772,679,93,158,93,https://www.intensivregister.de/api/public/reporting/laendertabelle
1616555945,772,680,92,158,93,https://www.intensivregister.de/api/public/reporting/laendertabelle
1616559549,770,679,91,161,93,https://www.intensivregister.de/api/public/reporting/laendertabelle
1616563152,772,679,93,163,95,https://www.intensivregister.de/api/public/reporting/laendertabelle
1616566746,769,680,89,165,94,https://www.intensivregister.de/api/public/reporting/laendertabelle
1616573944,770,682,88,167,96,https://www.intensivregister.de/api/public/reporting/laendertabelle
1616581151,770,686,84,168,96,https://www.intensivregister.de/api/public/reporting/laendertabelle
1616642345,770,685,85,169,96,https://www.intensivregister.de/api/public/reporting/laendertabelle
1616645952,774,680,94,167,99,https://www.intensivregister.de/api/public/reporting/laendertabelle
1616649548,775,675,100,171,101,https://www.intensivregister.de/api/public/reporting/laendertabelle
1616653145,775,676,99,176,104,https://www.intensivregister.de/api/public/reporting/laendertabelle
1616660349,774,674,100,175,101,https://www.intensivregister.de/api/public/reporting/laendertabelle
1616678353,774,675,99,175,101,https://www.intensivregister.de/api/public/reporting/laendertabelle
1616699952,774,673,101,174,101,https://www.intensivregister.de/api/public/reporting/laendertabelle
1616710752,774,669,105,174,101,https://www.intensivregister.de/api/public/reporting/laendertabelle
1616717945,774,670,104,174,101,https://www.intensivregister.de/api/public/reporting/laendertabelle
1616732351,775,662,113,174,99,https://www.intensivregister.de/api/public/reporting/laendertabelle
1616735947,775,667,108,176,104,https://www.intensivregister.de/api/public/reporting/laendertabelle
1616739544,774,667,107,172,106,https://www.intensivregister.de/api/public/reporting/laendertabelle
1616743151,774,664,110,169,104,https://www.intensivregister.de/api/public/reporting/laendertabelle
1616746747,774,663,111,169,104,https://www.intensivregister.de/api/public/reporting/laendertabelle
1616750344,774,663,111,170,105,https://www.intensivregister.de/api/public/reporting/laendertabelle
1616797150,774,664,110,170,105,https://www.intensivregister.de/api/public/reporting/laendertabelle
1616804343,774,665,109,170,105,https://www.intensivregister.de/api/public/reporting/laendertabelle
1616822343,749,637,112,170,108,https://www.intensivregister.de/api/public/reporting/laendertabelle
1616825948,766,645,121,169,110,https://www.intensivregister.de/api/public/reporting/laendertabelle
1616829544,764,641,123,171,111,https://www.intensivregister.de/api/public/reporting/laendertabelle
1616833148,764,642,122,171,110,https://www.intensivregister.de/api/public/reporting/laendertabelle
1616836743,762,643,119,172,110,https://www.intensivregister.de/api/public/reporting/laendertabelle
1616865552,762,644,118,172,110,https://www.intensivregister.de/api/public/reporting/laendertabelle
1616879952,762,645,117,172,110,https://www.intensivregister.de/api/public/reporting/laendertabelle
1616897952,762,639,123,173,110,https://www.intensivregister.de/api/public/reporting/laendertabelle
1616901547,754,623,131,173,110,https://www.intensivregister.de/api/public/reporting/laendertabelle
1616905152,754,624,130,172,108,https://www.intensivregister.de/api/public/reporting/laendertabelle
1616908747,755,627,128,173,107,https://www.intensivregister.de/api/public/reporting/laendertabelle
1616912352,755,628,127,173,107,https://www.intensivregister.de/api/public/reporting/laendertabelle
1616919551,755,631,124,174,107,https://www.intensivregister.de/api/public/reporting/laendertabelle
1616962751,755,633,122,174,107,https://www.intensivregister.de/api/public/reporting/laendertabelle
1616984351,754,637,117,172,105,https://www.intensivregister.de/api/public/reporting/laendertabelle
1616987946,760,637,123,172,105,https://www.intensivregister.de/api/public/reporting/laendertabelle
1616991552,762,640,122,174,106,https://www.intensivregister.de/api/public/reporting/laendertabelle
1616995147,765,642,123,173,104,https://www.intensivregister.de/api/public/reporting/laendertabelle
1616998752,763,638,125,173,104,https://www.intensivregister.de/api/public/reporting/laendertabelle
1617049146,763,634,129,171,102,https://www.intensivregister.de/api/public/reporting/laendertabelle
1617056347,763,635,128,171,102,https://www.intensivregister.de/api/public/reporting/laendertabelle
1617067153,763,636,127,171,102,https://www.intensivregister.de/api/public/reporting/laendertabelle
1617070748,766,653,113,166,99,https://www.intensivregister.de/api/public/reporting/laendertabelle
1617074343,769,654,115,163,97,https://www.intensivregister.de/api/public/reporting/laendertabelle
1617077948,769,659,110,167,99,https://www.intensivregister.de/api/public/reporting/laendertabelle
1617081544,769,661,108,167,99,https://www.intensivregister.de/api/public/reporting/laendertabelle
1617085149,769,661,108,166,99,https://www.intensivregister.de/api/public/reporting/laendertabelle
1617124747,769,662,107,167,96,https://www.intensivregister.de/api/public/reporting/laendertabelle
1617157144,768,668,100,178,94,https://www.intensivregister.de/api/public/reporting/laendertabelle
1617160749,767,665,102,178,93,https://www.intensivregister.de/api/public/reporting/laendertabelle
1617164344,765,668,97,183,94,https://www.intensivregister.de/api/public/reporting/laendertabelle
1617167950,765,665,100,181,93,https://www.intensivregister.de/api/public/reporting/laendertabelle
1617171545,765,666,99,181,94,https://www.intensivregister.de/api/public/reporting/laendertabelle
1617175151,765,671,94,181,94,https://www.intensivregister.de/api/public/reporting/laendertabelle
1617178746,765,671,94,171,94,https://www.intensivregister.de/api/public/reporting/laendertabelle
1617185947,767,673,94,174,96,https://www.intensivregister.de/api/public/reporting/laendertabelle
1617232745,767,671,96,174,96,https://www.intensivregister.de/api/public/reporting/laendertabelle
1617236350,767,672,95,175,96,https://www.intensivregister.de/api/public/reporting/laendertabelle
1617243551,767,663,104,175,99,https://www.intensivregister.de/api/public/reporting/laendertabelle
1617247146,768,657,111,175,96,https://www.intensivregister.de/api/public/reporting/laendertabelle
1617250752,768,654,114,174,95,https://www.intensivregister.de/api/public/reporting/laendertabelle
1617257953,754,641,113,174,95,https://www.intensivregister.de/api/public/reporting/laendertabelle
1617261548,754,640,114,176,96,https://www.intensivregister.de/api/public/reporting/laendertabelle
1617283149,750,636,114,178,97,https://www.intensivregister.de/api/public/reporting/laendertabelle
1617315545,750,635,115,178,97,https://www.intensivregister.de/api/public/reporting/laendertabelle
1617322745,750,636,114,178,97,https://www.intensivregister.de/api/public/reporting/laendertabelle
1617329945,750,636,114,179,98,https://www.intensivregister.de/api/public/reporting/laendertabelle
1617333550,751,635,116,181,99,https://www.intensivregister.de/api/public/reporting/laendertabelle
1617337145,754,628,126,178,101,https://www.intensivregister.de/api/public/reporting/laendertabelle
1617340751,751,632,119,186,108,https://www.intensivregister.de/api/public/reporting/laendertabelle
1617344346,754,639,115,188,109,https://www.intensivregister.de/api/public/reporting/laendertabelle
1617347951,754,640,114,187,109,https://www.intensivregister.de/api/public/reporting/laendertabelle
1617405553,754,638,116,188,109,https://www.intensivregister.de/api/public/reporting/laendertabelle
1617416347,752,634,118,184,110,https://www.intensivregister.de/api/public/reporting/laendertabelle
1617419952,751,635,116,184,109,https://www.intensivregister.de/api/public/reporting/laendertabelle
1617423547,749,631,118,183,108,https://www.intensivregister.de/api/public/reporting/laendertabelle
1617427153,753,637,116,185,109,https://www.intensivregister.de/api/public/reporting/laendertabelle
1617430748,750,638,112,187,109,https://www.intensivregister.de/api/public/reporting/laendertabelle
1617434343,749,622,127,186,108,https://www.intensivregister.de/api/public/reporting/laendertabelle
1617477543,749,619,130,183,109,https://www.intensivregister.de/api/public/reporting/laendertabelle
1617481165,749,620,129,183,109,https://www.intensivregister.de/api/public/reporting/laendertabelle
1617502748,751,616,135,182,110,https://www.intensivregister.de/api/public/reporting/laendertabelle
1617506343,744,609,135,179,112,https://www.intensivregister.de/api/public/reporting/laendertabelle
1617509948,743,608,135,181,112,https://www.intensivregister.de/api/public/reporting/laendertabelle
1617513543,744,614,130,182,114,https://www.intensivregister.de/api/public/reporting/laendertabelle
1617517148,745,611,134,186,117,https://www.intensivregister.de/api/public/reporting/laendertabelle
1617571144,745,612,133,186,117,https://www.intensivregister.de/api/public/reporting/laendertabelle
1617589150,745,614,131,187,117,https://www.intensivregister.de/api/public/reporting/laendertabelle
1617592745,746,610,136,187,116,https://www.intensivregister.de/api/public/reporting/laendertabelle
1617596351,749,611,138,191,118,https://www.intensivregister.de/api/public/reporting/laendertabelle
1617599946,738,611,127,195,121,https://www.intensivregister.de/api/public/reporting/laendertabelle
1617603552,738,605,133,194,121,https://www.intensivregister.de/api/public/reporting/laendertabelle
1617614348,740,609,131,198,126,https://www.intensivregister.de/api/public/reporting/laendertabelle
1617628749,742,611,131,199,128,https://www.intensivregister.de/api/public/reporting/laendertabelle
1617675551,743,609,134,198,126,https://www.intensivregister.de/api/public/reporting/laendertabelle
1617679148,740,620,120,202,128,https://www.intensivregister.de/api/public/reporting/laendertabelle
1617682745,750,627,123,206,127,https://www.intensivregister.de/api/public/reporting/laendertabelle
1617686352,750,629,121,206,126,https://www.intensivregister.de/api/public/reporting/laendertabelle
1617689950,750,628,122,206,126,https://www.intensivregister.de/api/public/reporting/laendertabelle
1617729546,750,630,120,207,126,https://www.intensivregister.de/api/public/reporting/laendertabelle
1617743951,750,632,118,207,126,https://www.intensivregister.de/api/public/reporting/laendertabelle
1617761951,750,637,113,202,125,https://www.intensivregister.de/api/public/reporting/laendertabelle
1617765547,753,644,109,203,126,https://www.intensivregister.de/api/public/reporting/laendertabelle
1617769144,756,655,101,202,127,https://www.intensivregister.de/api/public/reporting/laendertabelle
1617772752,754,658,96,205,128,https://www.intensivregister.de/api/public/reporting/laendertabelle
1617830347,754,657,97,206,128,https://www.intensivregister.de/api/public/reporting/laendertabelle
1617841145,754,658,96,206,128,https://www.intensivregister.de/api/public/reporting/laendertabelle
1617844751,754,657,97,205,130,https://www.intensivregister.de/api/public/reporting/laendertabelle
1617848349,755,659,96,207,131,https://www.intensivregister.de/api/public/reporting/laendertabelle
1617851943,761,665,96,214,131,https://www.intensivregister.de/api/public/reporting/laendertabelle
1617855549,755,658,97,211,129,https://www.intensivregister.de/api/public/reporting/laendertabelle
1617859145,755,660,95,212,131,https://www.intensivregister.de/api/public/reporting/laendertabelle
1617862752,755,658,97,211,131,https://www.intensivregister.de/api/public/reporting/laendertabelle
1617866348,755,662,93,213,132,https://www.intensivregister.de/api/public/reporting/laendertabelle
1617877147,755,662,93,212,132,https://www.intensivregister.de/api/public/reporting/laendertabelle
1617920350,755,660,95,212,132,https://www.intensivregister.de/api/public/reporting/laendertabelle
1617934745,755,649,106,217,132,https://www.intensivregister.de/api/public/reporting/laendertabelle
1617938351,758,653,105,220,130,https://www.intensivregister.de/api/public/reporting/laendertabelle
1617941946,757,654,103,221,127,https://www.intensivregister.de/api/public/reporting/laendertabelle
1617945543,757,655,102,222,127,https://www.intensivregister.de/api/public/reporting/laendertabelle
1617945543,757,654,103,221,126,https://www.intensivregister.de/api/public/reporting/laendertabelle
1617952746,758,655,103,223,128,https://www.intensivregister.de/api/public/reporting/laendertabelle
1617967151,753,650,103,225,128,https://www.intensivregister.de/api/public/reporting/laendertabelle
1618013949,753,652,101,225,128,https://www.intensivregister.de/api/public/reporting/laendertabelle
1618021151,752,644,108,223,127,https://www.intensivregister.de/api/public/reporting/laendertabelle
1618024746,754,646,108,225,131,https://www.intensivregister.de/api/public/reporting/laendertabelle
1618028352,753,647,106,221,132,https://www.intensivregister.de/api/public/reporting/laendertabelle
1618031948,753,647,106,223,132,https://www.intensivregister.de/api/public/reporting/laendertabelle
1618035544,755,652,103,225,133,https://www.intensivregister.de/api/public/reporting/laendertabelle
1618039149,755,651,104,225,133,https://www.intensivregister.de/api/public/reporting/laendertabelle
1618085943,755,651,104,226,133,https://www.intensivregister.de/api/public/reporting/laendertabelle
1618100346,755,648,107,226,133,https://www.intensivregister.de/api/public/reporting/laendertabelle
1618107548,752,641,111,227,132,https://www.intensivregister.de/api/public/reporting/laendertabelle
1618111143,750,637,113,226,131,https://www.intensivregister.de/api/public/reporting/laendertabelle
1618114749,748,627,121,227,133,https://www.intensivregister.de/api/public/reporting/laendertabelle
1618118345,748,630,118,229,133,https://www.intensivregister.de/api/public/reporting/laendertabelle
1618121951,748,631,117,230,133,https://www.intensivregister.de/api/public/reporting/laendertabelle
1618125547,748,633,115,232,135,https://www.intensivregister.de/api/public/reporting/laendertabelle
1618183151,748,632,116,232,135,https://www.intensivregister.de/api/public/reporting/laendertabelle
1618190343,748,635,113,232,135,https://www.intensivregister.de/api/public/reporting/laendertabelle
1618193949,748,636,112,229,129,https://www.intensivregister.de/api/public/reporting/laendertabelle
1618197545,750,640,110,231,128,https://www.intensivregister.de/api/public/reporting/laendertabelle
1618201152,754,653,101,237,130,https://www.intensivregister.de/api/public/reporting/laendertabelle
1618204748,754,651,103,234,131,https://www.intensivregister.de/api/public/reporting/laendertabelle
1618208344,754,650,104,235,131,https://www.intensivregister.de/api/public/reporting/laendertabelle
1618211951,754,650,104,236,131,https://www.intensivregister.de/api/public/reporting/laendertabelle
1618215547,754,650,104,237,131,https://www.intensivregister.de/api/public/reporting/laendertabelle
1618219144,754,651,103,236,131,https://www.intensivregister.de/api/public/reporting/laendertabelle
1618280348,757,665,92,232,134,https://www.intensivregister.de/api/public/reporting/laendertabelle
1618283944,762,668,94,227,132,https://www.intensivregister.de/api/public/reporting/laendertabelle
1618287550,762,666,96,223,132,https://www.intensivregister.de/api/public/reporting/laendertabelle
1618291147,761,663,98,227,133,https://www.intensivregister.de/api/public/reporting/laendertabelle
1618294743,761,665,96,226,133,https://www.intensivregister.de/api/public/reporting/laendertabelle
1618298350,761,668,93,226,133,https://www.intensivregister.de/api/public/reporting/laendertabelle
1618375735,762,688,74,233,132,https://www.intensivregister.de/api/public/reporting/laendertabelle
1618381144,762,687,75,233,133,https://www.intensivregister.de/api/public/reporting/laendertabelle
1618384750,762,690,72,232,133,https://www.intensivregister.de/api/public/reporting/laendertabelle
1618435148,762,686,76,232,133,https://www.intensivregister.de/api/public/reporting/laendertabelle
1618449551,762,685,77,232,132,https://www.intensivregister.de/api/public/reporting/laendertabelle
1618453148,758,681,77,232,132,https://www.intensivregister.de/api/public/reporting/laendertabelle
1618456744,763,675,88,223,128,https://www.intensivregister.de/api/public/reporting/laendertabelle
1618460350,764,674,90,222,126,https://www.intensivregister.de/api/public/reporting/laendertabelle
1618463947,764,675,89,222,126,https://www.intensivregister.de/api/public/reporting/laendertabelle
1618467544,764,672,92,223,127,https://www.intensivregister.de/api/public/reporting/laendertabelle
1618471150,764,670,94,222,128,https://www.intensivregister.de/api/public/reporting/laendertabelle
1618489152,764,672,92,223,129,https://www.intensivregister.de/api/public/reporting/laendertabelle
1618525144,764,672,92,222,129,https://www.intensivregister.de/api/public/reporting/laendertabelle
1618535953,764,672,92,221,128,https://www.intensivregister.de/api/public/reporting/laendertabelle
1618539548,766,672,94,220,122,https://www.intensivregister.de/api/public/reporting/laendertabelle
1618543144,769,677,92,221,122,https://www.intensivregister.de/api/public/reporting/laendertabelle
1618546750,769,675,94,218,120,https://www.intensivregister.de/api/public/reporting/laendertabelle
1618550346,769,674,95,218,119,https://www.intensivregister.de/api/public/reporting/laendertabelle
1618553943,769,672,97,218,119,https://www.intensivregister.de/api/public/reporting/laendertabelle
1618564753,767,667,100,217,117,https://www.intensivregister.de/api/public/reporting/laendertabelle
1618615146,767,669,98,217,117,https://www.intensivregister.de/api/public/reporting/laendertabelle
1618629549,766,665,101,215,124,https://www.intensivregister.de/api/public/reporting/laendertabelle
1618633145,769,660,109,217,128,https://www.intensivregister.de/api/public/reporting/laendertabelle
1618636751,771,657,114,213,122,https://www.intensivregister.de/api/public/reporting/laendertabelle
1618640346,773,658,115,214,120,https://www.intensivregister.de/api/public/reporting/laendertabelle
1618643952,773,659,114,219,120,https://www.intensivregister.de/api/public/reporting/laendertabelle
1618647548,773,658,115,219,120,https://www.intensivregister.de/api/public/reporting/laendertabelle
1618654749,775,659,116,219,120,https://www.intensivregister.de/api/public/reporting/laendertabelle
1618708748,775,660,115,219,120,https://www.intensivregister.de/api/public/reporting/laendertabelle
1618715943,770,656,114,220,120,https://www.intensivregister.de/api/public/reporting/laendertabelle
1618719550,765,640,125,216,123,https://www.intensivregister.de/api/public/reporting/laendertabelle
1618723149,762,633,129,216,121,https://www.intensivregister.de/api/public/reporting/laendertabelle
1618726744,759,634,125,214,121,https://www.intensivregister.de/api/public/reporting/laendertabelle
1618798744,757,629,128,215,119,https://www.intensivregister.de/api/public/reporting/laendertabelle
1618802343,762,638,124,215,118,https://www.intensivregister.de/api/public/reporting/laendertabelle
1618805952,766,643,123,218,118,https://www.intensivregister.de/api/public/reporting/laendertabelle
1618809551,766,644,122,219,118,https://www.intensivregister.de/api/public/reporting/laendertabelle
1618820348,766,647,119,219,118,https://www.intensivregister.de/api/public/reporting/laendertabelle
1618823948,766,646,120,218,118,https://www.intensivregister.de/api/public/reporting/laendertabelle
1618834745,770,648,122,217,118,https://www.intensivregister.de/api/public/reporting/laendertabelle
1618870751,770,650,120,217,118,https://www.intensivregister.de/api/public/reporting/laendertabelle
1618885147,765,649,116,211,119,https://www.intensivregister.de/api/public/reporting/laendertabelle
1618888751,765,649,116,213,117,https://www.intensivregister.de/api/public/reporting/laendertabelle
1618892346,765,663,102,214,118,https://www.intensivregister.de/api/public/reporting/laendertabelle
1618899545,765,665,100,216,117,https://www.intensivregister.de/api/public/reporting/laendertabelle
1618906745,765,665,100,215,117,https://www.intensivregister.de/api/public/reporting/laendertabelle
1618921154,765,666,99,217,117,https://www.intensivregister.de/api/public/reporting/laendertabelle
1618949949,765,665,100,217,117,https://www.intensivregister.de/api/public/reporting/laendertabelle
1618967950,765,662,103,216,117,https://www.intensivregister.de/api/public/reporting/laendertabelle
1618971544,768,672,96,217,116,https://www.intensivregister.de/api/public/reporting/laendertabelle
1618975148,768,675,93,219,113,https://www.intensivregister.de/api/public/reporting/laendertabelle
1618978743,768,674,94,218,112,https://www.intensivregister.de/api/public/reporting/laendertabelle
1618982347,768,672,96,218,112,https://www.intensivregister.de/api/public/reporting/laendertabelle
1618989547,769,664,105,217,112,https://www.intensivregister.de/api/public/reporting/laendertabelle
1618996746,769,663,106,218,113,https://www.intensivregister.de/api/public/reporting/laendertabelle
1619043548,769,665,104,218,113,https://www.intensivregister.de/api/public/reporting/laendertabelle
1619057946,773,673,100,217,117,https://www.intensivregister.de/api/public/reporting/laendertabelle
1619061551,775,676,99,211,118,https://www.intensivregister.de/api/public/reporting/laendertabelle
1619065145,775,676,99,213,120,https://www.intensivregister.de/api/public/reporting/laendertabelle
1619068750,776,677,99,213,120,https://www.intensivregister.de/api/public/reporting/laendertabelle
1619072344,776,680,96,212,119,https://www.intensivregister.de/api/public/reporting/laendertabelle
1619075948,775,675,100,211,118,https://www.intensivregister.de/api/public/reporting/laendertabelle
1619144352,775,673,102,209,115,https://www.intensivregister.de/api/public/reporting/laendertabelle
1619147947,776,676,100,213,112,https://www.intensivregister.de/api/public/reporting/laendertabelle
1619151551,776,679,97,215,114,https://www.intensivregister.de/api/public/reporting/laendertabelle
1619155147,776,679,97,214,114,https://www.intensivregister.de/api/public/reporting/laendertabelle
1619158752,777,680,97,216,115,https://www.intensivregister.de/api/public/reporting/laendertabelle
1619162346,777,684,93,216,117,https://www.intensivregister.de/api/public/reporting/laendertabelle
1619230752,777,683,94,214,117,https://www.intensivregister.de/api/public/reporting/laendertabelle
1619234347,777,683,94,212,112,https://www.intensivregister.de/api/public/reporting/laendertabelle
1619237952,777,681,96,210,107,https://www.intensivregister.de/api/public/reporting/laendertabelle
1619241547,776,682,94,212,108,https://www.intensivregister.de/api/public/reporting/laendertabelle
1619245151,776,680,96,212,108,https://www.intensivregister.de/api/public/reporting/laendertabelle
1619248745,776,678,98,212,108,https://www.intensivregister.de/api/public/reporting/laendertabelle
1619252349,776,679,97,213,109,https://www.intensivregister.de/api/public/reporting/laendertabelle
1619291944,776,680,96,214,109,https://www.intensivregister.de/api/public/reporting/laendertabelle
1619309947,776,679,97,214,109,https://www.intensivregister.de/api/public/reporting/laendertabelle
1619317145,776,680,96,215,110,https://www.intensivregister.de/api/public/reporting/laendertabelle
1619320750,776,676,100,216,112,https://www.intensivregister.de/api/public/reporting/laendertabelle
1619324344,776,676,100,218,110,https://www.intensivregister.de/api/public/reporting/laendertabelle
1619327949,772,672,100,217,109,https://www.intensivregister.de/api/public/reporting/laendertabelle
1619331543,772,666,106,215,106,https://www.intensivregister.de/api/public/reporting/laendertabelle
1619338751,772,667,105,215,106,https://www.intensivregister.de/api/public/reporting/laendertabelle
1619381944,772,666,106,215,106,https://www.intensivregister.de/api/public/reporting/laendertabelle
1619399943,772,664,108,214,104,https://www.intensivregister.de/api/public/reporting/laendertabelle
1619403549,772,662,110,215,105,https://www.intensivregister.de/api/public/reporting/laendertabelle
1619407145,768,663,105,216,106,https://www.intensivregister.de/api/public/reporting/laendertabelle
1619410750,768,667,101,217,108,https://www.intensivregister.de/api/public/reporting/laendertabelle
1619414345,768,668,100,220,108,https://www.intensivregister.de/api/public/reporting/laendertabelle
1619417950,767,667,100,221,109,https://www.intensivregister.de/api/public/reporting/laendertabelle
1619421546,767,665,102,221,109,https://www.intensivregister.de/api/public/reporting/laendertabelle
1619432352,767,665,102,220,109,https://www.intensivregister.de/api/public/reporting/laendertabelle
1619468343,767,664,103,220,109,https://www.intensivregister.de/api/public/reporting/laendertabelle
1619471948,767,667,100,222,110,https://www.intensivregister.de/api/public/reporting/laendertabelle
1619482744,767,666,101,222,110,https://www.intensivregister.de/api/public/reporting/laendertabelle
1619489945,767,666,101,215,104,https://www.intensivregister.de/api/public/reporting/laendertabelle
1619493550,767,659,108,214,102,https://www.intensivregister.de/api/public/reporting/laendertabelle
1619497145,771,662,109,214,102,https://www.intensivregister.de/api/public/reporting/laendertabelle
1619500750,771,655,116,211,101,https://www.intensivregister.de/api/public/reporting/laendertabelle
1619504345,773,657,116,210,102,https://www.intensivregister.de/api/public/reporting/laendertabelle
1619507950,773,658,115,209,99,https://www.intensivregister.de/api/public/reporting/laendertabelle
1619518745,773,658,115,210,99,https://www.intensivregister.de/api/public/reporting/laendertabelle
1619533148,773,658,115,211,99,https://www.intensivregister.de/api/public/reporting/laendertabelle
1619558345,773,659,114,211,99,https://www.intensivregister.de/api/public/reporting/laendertabelle
1619569149,773,659,114,208,101,https://www.intensivregister.de/api/public/reporting/laendertabelle
1619572744,773,660,113,208,101,https://www.intensivregister.de/api/public/reporting/laendertabelle
1619576348,770,657,113,206,104,https://www.intensivregister.de/api/public/reporting/laendertabelle
1619579953,771,657,114,207,104,https://www.intensivregister.de/api/public/reporting/laendertabelle
1619583547,773,657,116,207,104,https://www.intensivregister.de/api/public/reporting/laendertabelle
1619587152,773,662,111,208,104,https://www.intensivregister.de/api/public/reporting/laendertabelle
1619590745,773,663,110,206,102,https://www.intensivregister.de/api/public/reporting/laendertabelle
1619594350,773,661,112,208,101,https://www.intensivregister.de/api/public/reporting/laendertabelle
1619597945,773,657,116,206,99,https://www.intensivregister.de/api/public/reporting/laendertabelle
1619662751,773,667,106,208,100,https://www.intensivregister.de/api/public/reporting/laendertabelle
1619666345,774,672,102,205,104,https://www.intensivregister.de/api/public/reporting/laendertabelle
1619669950,775,678,97,203,106,https://www.intensivregister.de/api/public/reporting/laendertabelle
1619673544,776,676,100,203,109,https://www.intensivregister.de/api/public/reporting/laendertabelle
1619677149,776,681,95,203,110,https://www.intensivregister.de/api/public/reporting/laendertabelle
1619684349,776,682,94,203,110,https://www.intensivregister.de/api/public/reporting/laendertabelle
1619731149,776,683,93,203,110,https://www.intensivregister.de/api/public/reporting/laendertabelle
1619738348,776,684,92,203,110,https://www.intensivregister.de/api/public/reporting/laendertabelle
1619749152,776,686,90,206,110,https://www.intensivregister.de/api/public/reporting/laendertabelle
1619752747,775,686,89,206,112,https://www.intensivregister.de/api/public/reporting/laendertabelle
1619756351,775,681,94,203,112,https://www.intensivregister.de/api/public/reporting/laendertabelle
1619759945,775,679,96,201,114,https://www.intensivregister.de/api/public/reporting/laendertabelle
1619763550,775,679,96,199,114,https://www.intensivregister.de/api/public/reporting/laendertabelle
1619767144,773,680,93,190,111,https://www.intensivregister.de/api/public/reporting/laendertabelle
1619813945,773,673,100,187,111,https://www.intensivregister.de/api/public/reporting/laendertabelle
1619821145,773,674,99,187,111,https://www.intensivregister.de/api/public/reporting/laendertabelle
1619835544,773,675,98,187,111,https://www.intensivregister.de/api/public/reporting/laendertabelle
1619839149,768,663,105,187,109,https://www.intensivregister.de/api/public/reporting/laendertabelle
1619842744,768,669,99,187,109,https://www.intensivregister.de/api/public/reporting/laendertabelle
1619846349,767,668,99,182,110,https://www.intensivregister.de/api/public/reporting/laendertabelle
1619849943,767,666,101,181,110,https://www.intensivregister.de/api/public/reporting/laendertabelle
1619853548,766,661,105,180,109,https://www.intensivregister.de/api/public/reporting/laendertabelle
1619857154,766,660,106,180,109,https://www.intensivregister.de/api/public/reporting/laendertabelle
1619921947,766,670,96,183,111,https://www.intensivregister.de/api/public/reporting/laendertabelle
1619925552,766,671,95,185,111,https://www.intensivregister.de/api/public/reporting/laendertabelle
1619929146,766,670,96,187,113,https://www.intensivregister.de/api/public/reporting/laendertabelle
1619932750,767,670,97,192,113,https://www.intensivregister.de/api/public/reporting/laendertabelle
1619936345,767,667,100,192,113,https://www.intensivregister.de/api/public/reporting/laendertabelle
1619939950,767,660,107,191,111,https://www.intensivregister.de/api/public/reporting/laendertabelle
1619986750,767,661,106,191,111,https://www.intensivregister.de/api/public/reporting/laendertabelle
1620008348,769,658,111,186,114,https://www.intensivregister.de/api/public/reporting/laendertabelle
1620011952,769,658,111,190,114,https://www.intensivregister.de/api/public/reporting/laendertabelle
1620015546,768,658,110,190,116,https://www.intensivregister.de/api/public/reporting/laendertabelle
1620019151,768,658,110,191,114,https://www.intensivregister.de/api/public/reporting/laendertabelle
1620022746,768,656,112,191,114,https://www.intensivregister.de/api/public/reporting/laendertabelle
1620026350,768,659,109,193,113,https://www.intensivregister.de/api/public/reporting/laendertabelle
1620073152,768,662,106,193,113,https://www.intensivregister.de/api/public/reporting/laendertabelle
1620091146,768,663,105,195,115,https://www.intensivregister.de/api/public/reporting/laendertabelle
1620094751,768,665,103,189,109,https://www.intensivregister.de/api/public/reporting/laendertabelle
1620098345,767,667,100,190,113,https://www.intensivregister.de/api/public/reporting/laendertabelle
1620101950,767,666,101,189,113,https://www.intensivregister.de/api/public/reporting/laendertabelle
1620105545,768,671,97,191,115,https://www.intensivregister.de/api/public/reporting/laendertabelle
1620112746,766,673,93,191,116,https://www.intensivregister.de/api/public/reporting/laendertabelle
1620119946,766,673,93,187,115,https://www.intensivregister.de/api/public/reporting/laendertabelle
1620127146,766,672,94,187,115,https://www.intensivregister.de/api/public/reporting/laendertabelle
1620166750,766,671,95,188,118,https://www.intensivregister.de/api/public/reporting/laendertabelle
1620177545,766,673,93,188,118,https://www.intensivregister.de/api/public/reporting/laendertabelle
1620181150,766,666,100,190,118,https://www.intensivregister.de/api/public/reporting/laendertabelle
1620184744,769,665,104,187,115,https://www.intensivregister.de/api/public/reporting/laendertabelle
1620188349,769,670,99,189,112,https://www.intensivregister.de/api/public/reporting/laendertabelle
1620191944,769,670,99,190,112,https://www.intensivregister.de/api/public/reporting/laendertabelle
1620195549,769,668,101,188,111,https://www.intensivregister.de/api/public/reporting/laendertabelle
1620199144,769,667,102,188,111,https://www.intensivregister.de/api/public/reporting/laendertabelle
1620213543,769,669,100,189,111,https://www.intensivregister.de/api/public/reporting/laendertabelle
1620245947,769,668,101,189,111,https://www.intensivregister.de/api/public/reporting/laendertabelle
1620249552,769,669,100,189,111,https://www.intensivregister.de/api/public/reporting/laendertabelle
1620267552,762,660,102,191,115,https://www.intensivregister.de/api/public/reporting/laendertabelle
1620271145,759,657,102,189,113,https://www.intensivregister.de/api/public/reporting/laendertabelle
1620274747,758,655,103,188,110,https://www.intensivregister.de/api/public/reporting/laendertabelle
1620278350,758,650,108,182,109,https://www.intensivregister.de/api/public/reporting/laendertabelle
1620281943,758,651,107,182,110,https://www.intensivregister.de/api/public/reporting/laendertabelle
1620285547,758,650,108,182,110,https://www.intensivregister.de/api/public/reporting/laendertabelle
1620332347,758,651,107,182,110,https://www.intensivregister.de/api/public/reporting/laendertabelle
1620346749,758,650,108,182,110,https://www.intensivregister.de/api/public/reporting/laendertabelle
1620353945,758,647,111,177,106,https://www.intensivregister.de/api/public/reporting/laendertabelle
1620357549,759,655,104,175,104,https://www.intensivregister.de/api/public/reporting/laendertabelle
1620361152,760,655,105,171,99,https://www.intensivregister.de/api/public/reporting/laendertabelle
1620364745,760,650,110,174,100,https://www.intensivregister.de/api/public/reporting/laendertabelle
1620368348,760,650,110,172,100,https://www.intensivregister.de/api/public/reporting/laendertabelle
1620375544,760,652,108,172,100,https://www.intensivregister.de/api/public/reporting/laendertabelle
1620389946,760,648,112,171,100,https://www.intensivregister.de/api/public/reporting/laendertabelle
1620425947,760,647,113,171,100,https://www.intensivregister.de/api/public/reporting/laendertabelle
1620440351,760,649,111,165,98,https://www.intensivregister.de/api/public/reporting/laendertabelle
1620443944,759,640,119,162,102,https://www.intensivregister.de/api/public/reporting/laendertabelle
1620447547,759,636,123,162,102,https://www.intensivregister.de/api/public/reporting/laendertabelle
1620451151,761,637,124,167,104,https://www.intensivregister.de/api/public/reporting/laendertabelle
1620454744,761,635,126,169,104,https://www.intensivregister.de/api/public/reporting/laendertabelle
1620526746,761,636,125,168,103,https://www.intensivregister.de/api/public/reporting/laendertabelle
1620530349,760,635,125,170,103,https://www.intensivregister.de/api/public/reporting/laendertabelle
1620533952,760,644,116,169,99,https://www.intensivregister.de/api/public/reporting/laendertabelle
1620537545,758,643,115,169,100,https://www.intensivregister.de/api/public/reporting/laendertabelle
1620541148,757,641,116,171,99,https://www.intensivregister.de/api/public/reporting/laendertabelle
1620544751,757,640,117,171,100,https://www.intensivregister.de/api/public/reporting/laendertabelle
1620548344,755,636,119,171,101,https://www.intensivregister.de/api/public/reporting/laendertabelle
1620559143,755,636,119,172,102,https://www.intensivregister.de/api/public/reporting/laendertabelle
1620595143,755,637,118,172,102,https://www.intensivregister.de/api/public/reporting/laendertabelle
1620609545,755,635,120,172,102,https://www.intensivregister.de/api/public/reporting/laendertabelle
1620613148,756,632,124,165,100,https://www.intensivregister.de/api/public/reporting/laendertabelle
1620616751,758,637,121,164,99,https://www.intensivregister.de/api/public/reporting/laendertabelle
1620620344,757,634,123,167,101,https://www.intensivregister.de/api/public/reporting/laendertabelle
1620623947,757,637,120,170,100,https://www.intensivregister.de/api/public/reporting/laendertabelle
1620631143,757,635,122,172,101,https://www.intensivregister.de/api/public/reporting/laendertabelle
1620634746,757,634,123,172,101,https://www.intensivregister.de/api/public/reporting/laendertabelle
1620681544,750,629,121,172,101,https://www.intensivregister.de/api/public/reporting/laendertabelle
1620699548,750,633,117,174,101,https://www.intensivregister.de/api/public/reporting/laendertabelle
1620703152,751,633,118,176,103,https://www.intensivregister.de/api/public/reporting/laendertabelle
1620706745,751,635,116,171,101,https://www.intensivregister.de/api/public/reporting/laendertabelle
1620717544,751,636,115,171,102,https://www.intensivregister.de/api/public/reporting/laendertabelle
1620742747,751,635,116,168,101,https://www.intensivregister.de/api/public/reporting/laendertabelle
1620775145,749,635,114,168,101,https://www.intensivregister.de/api/public/reporting/laendertabelle
1620782352,749,637,112,168,101,https://www.intensivregister.de/api/public/reporting/laendertabelle
1620785945,750,638,112,169,102,https://www.intensivregister.de/api/public/reporting/laendertabelle
1620789548,755,650,105,167,101,https://www.intensivregister.de/api/public/reporting/laendertabelle
1620793152,755,652,103,167,101,https://www.intensivregister.de/api/public/reporting/laendertabelle
1620796746,755,652,103,166,101,https://www.intensivregister.de/api/public/reporting/laendertabelle
1620800350,757,648,109,163,102,https://www.intensivregister.de/api/public/reporting/laendertabelle
1620803945,759,651,108,165,103,https://www.intensivregister.de/api/public/reporting/laendertabelle
1620829152,759,650,109,163,103,https://www.intensivregister.de/api/public/reporting/laendertabelle
1620850744,759,649,110,163,103,https://www.intensivregister.de/api/public/reporting/laendertabelle
1620861544,756,651,105,163,103,https://www.intensivregister.de/api/public/reporting/laendertabelle
1620868751,756,652,104,163,103,https://www.intensivregister.de/api/public/reporting/laendertabelle
1620872344,756,649,107,163,104,https://www.intensivregister.de/api/public/reporting/laendertabelle
1620875948,741,635,106,167,104,https://www.intensivregister.de/api/public/reporting/laendertabelle
1620879551,739,628,111,167,101,https://www.intensivregister.de/api/public/reporting/laendertabelle
1620883144,739,625,114,166,101,https://www.intensivregister.de/api/public/reporting/laendertabelle
1620886747,738,626,112,165,102,https://www.intensivregister.de/api/public/reporting/laendertabelle
1620890351,738,626,112,163,101,https://www.intensivregister.de/api/public/reporting/laendertabelle
1620897547,738,627,111,163,101,https://www.intensivregister.de/api/public/reporting/laendertabelle
1620901150,738,627,111,162,100,https://www.intensivregister.de/api/public/reporting/laendertabelle
1620940745,738,626,112,162,100,https://www.intensivregister.de/api/public/reporting/laendertabelle
1620955149,739,627,112,162,100,https://www.intensivregister.de/api/public/reporting/laendertabelle
1620958752,734,616,118,161,100,https://www.intensivregister.de/api/public/reporting/laendertabelle
1620962346,735,616,119,162,101,https://www.intensivregister.de/api/public/reporting/laendertabelle
1620965950,735,615,120,163,99,https://www.intensivregister.de/api/public/reporting/laendertabelle
1620973147,734,611,123,163,105,https://www.intensivregister.de/api/public/reporting/laendertabelle
1620976751,734,612,122,163,105,https://www.intensivregister.de/api/public/reporting/laendertabelle
1621023550,734,610,124,162,105,https://www.intensivregister.de/api/public/reporting/laendertabelle
1621037952,734,612,122,162,105,https://www.intensivregister.de/api/public/reporting/laendertabelle
1621045152,733,611,122,160,104,https://www.intensivregister.de/api/public/reporting/laendertabelle
1621048748,733,610,123,158,104,https://www.intensivregister.de/api/public/reporting/laendertabelle
1621052344,736,627,109,170,108,https://www.intensivregister.de/api/public/reporting/laendertabelle
1621055951,738,625,113,166,104,https://www.intensivregister.de/api/public/reporting/laendertabelle
1621059546,738,627,111,166,103,https://www.intensivregister.de/api/public/reporting/laendertabelle
1621066748,738,626,112,166,103,https://www.intensivregister.de/api/public/reporting/laendertabelle
1621124350,749,627,122,166,103,https://www.intensivregister.de/api/public/reporting/laendertabelle
1621135150,749,624,125,165,102,https://www.intensivregister.de/api/public/reporting/laendertabelle
1621138746,747,616,131,164,101,https://www.intensivregister.de/api/public/reporting/laendertabelle
1621142352,745,605,140,158,95,https://www.intensivregister.de/api/public/reporting/laendertabelle
1621145948,745,607,138,158,95,https://www.intensivregister.de/api/public/reporting/laendertabelle
1621149544,745,609,136,158,95,https://www.intensivregister.de/api/public/reporting/laendertabelle
1621217950,741,602,139,159,96,https://www.intensivregister.de/api/public/reporting/laendertabelle
1621221546,733,595,138,158,96,https://www.intensivregister.de/api/public/reporting/laendertabelle
1621225152,733,593,140,158,96,https://www.intensivregister.de/api/public/reporting/laendertabelle
1621228747,731,588,143,156,93,https://www.intensivregister.de/api/public/reporting/laendertabelle
1621235949,731,589,142,156,93,https://www.intensivregister.de/api/public/reporting/laendertabelle
1621286346,731,590,141,156,93,https://www.intensivregister.de/api/public/reporting/laendertabelle
1621304345,735,600,135,151,86,https://www.intensivregister.de/api/public/reporting/laendertabelle
1621307951,741,609,132,157,84,https://www.intensivregister.de/api/public/reporting/laendertabelle
1621311547,748,618,130,156,82,https://www.intensivregister.de/api/public/reporting/laendertabelle
1621315153,748,622,126,155,82,https://www.intensivregister.de/api/public/reporting/laendertabelle
1621318749,746,627,119,155,82,https://www.intensivregister.de/api/public/reporting/laendertabelle
1621322344,746,623,123,154,81,https://www.intensivregister.de/api/public/reporting/laendertabelle
1621372752,746,623,123,153,85,https://www.intensivregister.de/api/public/reporting/laendertabelle
1621376348,746,622,124,153,85,https://www.intensivregister.de/api/public/reporting/laendertabelle
1621390751,746,619,127,150,86,https://www.intensivregister.de/api/public/reporting/laendertabelle
1621394348,745,622,123,146,86,https://www.intensivregister.de/api/public/reporting/laendertabelle
1621397943,750,635,115,143,84,https://www.intensivregister.de/api/public/reporting/laendertabelle
1621401549,750,634,116,142,84,https://www.intensivregister.de/api/public/reporting/laendertabelle
1621405145,750,639,111,142,85,https://www.intensivregister.de/api/public/reporting/laendertabelle
1621408751,749,639,110,141,85,https://www.intensivregister.de/api/public/reporting/laendertabelle
1621477145,748,637,111,137,83,https://www.intensivregister.de/api/public/reporting/laendertabelle
1621480750,745,631,114,136,83,https://www.intensivregister.de/api/public/reporting/laendertabelle
1621484347,745,632,113,135,84,https://www.intensivregister.de/api/public/reporting/laendertabelle
1621487952,745,629,116,134,84,https://www.intensivregister.de/api/public/reporting/laendertabelle
1621491548,745,632,113,136,83,https://www.intensivregister.de/api/public/reporting/laendertabelle
1621495144,745,634,111,136,83,https://www.intensivregister.de/api/public/reporting/laendertabelle
1621516748,745,634,111,137,84,https://www.intensivregister.de/api/public/reporting/laendertabelle
1621549148,745,635,110,137,84,https://www.intensivregister.de/api/public/reporting/laendertabelle
1621559945,745,637,108,137,83,https://www.intensivregister.de/api/public/reporting/laendertabelle
1621563550,745,641,104,137,83,https://www.intensivregister.de/api/public/reporting/laendertabelle
1621567146,741,634,107,136,83,https://www.intensivregister.de/api/public/reporting/laendertabelle
1621570752,742,634,108,135,83,https://www.intensivregister.de/api/public/reporting/laendertabelle
1621574347,742,632,110,133,83,https://www.intensivregister.de/api/public/reporting/laendertabelle
1621581549,742,631,111,133,83,https://www.intensivregister.de/api/public/reporting/laendertabelle
1621646345,742,632,110,133,83,https://www.intensivregister.de/api/public/reporting/laendertabelle
1621649952,742,627,115,130,81,https://www.intensivregister.de/api/public/reporting/laendertabelle
1621653549,742,625,117,130,80,https://www.intensivregister.de/api/public/reporting/laendertabelle
1621657147,735,614,121,131,80,https://www.intensivregister.de/api/public/reporting/laendertabelle
1621660744,736,619,117,132,79,https://www.intensivregister.de/api/public/reporting/laendertabelle
1621664351,736,615,121,131,76,https://www.intensivregister.de/api/public/reporting/laendertabelle
1621671545,736,615,121,130,76,https://www.intensivregister.de/api/public/reporting/laendertabelle
1621736347,737,614,123,131,76,https://www.intensivregister.de/api/public/reporting/laendertabelle
1621739944,737,619,118,134,79,https://www.intensivregister.de/api/public/reporting/laendertabelle
1621743552,736,613,123,132,80,https://www.intensivregister.de/api/public/reporting/laendertabelle
1621747149,730,604,126,132,80,https://www.intensivregister.de/api/public/reporting/laendertabelle
1621750747,730,605,125,133,80,https://www.intensivregister.de/api/public/reporting/laendertabelle
1621768743,730,604,126,133,80,https://www.intensivregister.de/api/public/reporting/laendertabelle
1621808351,730,604,126,134,80,https://www.intensivregister.de/api/public/reporting/laendertabelle
1621822750,728,603,125,135,80,https://www.intensivregister.de/api/public/reporting/laendertabelle
1621826348,726,600,126,132,77,https://www.intensivregister.de/api/public/reporting/laendertabelle
1621829945,726,602,124,131,74,https://www.intensivregister.de/api/public/reporting/laendertabelle
1621833552,726,596,130,133,74,https://www.intensivregister.de/api/public/reporting/laendertabelle
1621837150,723,592,131,134,75,https://www.intensivregister.de/api/public/reporting/laendertabelle
1621840747,723,593,130,134,75,https://www.intensivregister.de/api/public/reporting/laendertabelle
1621894744,723,592,131,134,75,https://www.intensivregister.de/api/public/reporting/laendertabelle
1621909143,724,583,141,129,74,https://www.intensivregister.de/api/public/reporting/laendertabelle
1621912750,723,583,140,130,75,https://www.intensivregister.de/api/public/reporting/laendertabelle
1621916348,724,585,139,130,74,https://www.intensivregister.de/api/public/reporting/laendertabelle
1621919946,724,587,137,130,75,https://www.intensivregister.de/api/public/reporting/laendertabelle
1621923544,723,588,135,131,76,https://www.intensivregister.de/api/public/reporting/laendertabelle
1621927151,724,590,134,130,76,https://www.intensivregister.de/api/public/reporting/laendertabelle
1621991945,724,591,133,130,75,https://www.intensivregister.de/api/public/reporting/laendertabelle
1621995551,724,596,128,129,72,https://www.intensivregister.de/api/public/reporting/laendertabelle
1621999149,725,606,119,127,73,https://www.intensivregister.de/api/public/reporting/laendertabelle
1622002747,725,603,122,124,73,https://www.intensivregister.de/api/public/reporting/laendertabelle
1622006349,725,601,124,123,72,https://www.intensivregister.de/api/public/reporting/laendertabelle
1622009944,727,606,121,123,72,https://www.intensivregister.de/api/public/reporting/laendertabelle
1622013550,727,608,119,123,72,https://www.intensivregister.de/api/public/reporting/laendertabelle
1622081943,729,604,125,119,70,https://www.intensivregister.de/api/public/reporting/laendertabelle
1622085548,730,610,120,116,67,https://www.intensivregister.de/api/public/reporting/laendertabelle
1622089143,730,610,120,118,69,https://www.intensivregister.de/api/public/reporting/laendertabelle
1622096351,730,608,122,116,69,https://www.intensivregister.de/api/public/reporting/laendertabelle
1622099952,731,610,121,116,69,https://www.intensivregister.de/api/public/reporting/laendertabelle
1622164744,732,610,122,115,69,https://www.intensivregister.de/api/public/reporting/laendertabelle
1622168348,728,588,140,114,70,https://www.intensivregister.de/api/public/reporting/laendertabelle
1622171952,726,587,139,110,68,https://www.intensivregister.de/api/public/reporting/laendertabelle
1622175547,720,581,139,110,68,https://www.intensivregister.de/api/public/reporting/laendertabelle
1622179150,720,584,136,111,68,https://www.intensivregister.de/api/public/reporting/laendertabelle
1622182743,720,585,135,110,68,https://www.intensivregister.de/api/public/reporting/laendertabelle
1622186345,719,580,139,107,67,https://www.intensivregister.de/api/public/reporting/laendertabelle
1622236745,719,579,140,107,67,https://www.intensivregister.de/api/public/reporting/laendertabelle
1622251152,721,581,140,106,68,https://www.intensivregister.de/api/public/reporting/laendertabelle
1622254751,723,582,141,106,68,https://www.intensivregister.de/api/public/reporting/laendertabelle
1622258350,721,585,136,106,68,https://www.intensivregister.de/api/public/reporting/laendertabelle
1622261950,722,578,144,105,68,https://www.intensivregister.de/api/public/reporting/laendertabelle
1622265549,722,577,145,103,69,https://www.intensivregister.de/api/public/reporting/laendertabelle
1622269148,723,578,145,102,69,https://www.intensivregister.de/api/public/reporting/laendertabelle
1622272748,723,581,142,102,69,https://www.intensivregister.de/api/public/reporting/laendertabelle
1622276350,723,579,144,102,70,https://www.intensivregister.de/api/public/reporting/laendertabelle
1622319549,723,580,143,102,70,https://www.intensivregister.de/api/public/reporting/laendertabelle
1622337545,721,577,144,102,71,https://www.intensivregister.de/api/public/reporting/laendertabelle
1622341144,721,582,139,102,71,https://www.intensivregister.de/api/public/reporting/laendertabelle
1622344743,719,573,146,100,69,https://www.intensivregister.de/api/public/reporting/laendertabelle
1622348353,719,574,145,97,68,https://www.intensivregister.de/api/public/reporting/laendertabelle
1622351953,719,577,142,96,67,https://www.intensivregister.de/api/public/reporting/laendertabelle
1622355552,715,565,150,96,66,https://www.intensivregister.de/api/public/reporting/laendertabelle
1622413151,715,564,151,96,66,https://www.intensivregister.de/api/public/reporting/laendertabelle
1622423950,715,565,150,96,66,https://www.intensivregister.de/api/public/reporting/laendertabelle
1622427549,710,564,146,96,66,https://www.intensivregister.de/api/public/reporting/laendertabelle
1622431148,710,553,157,95,63,https://www.intensivregister.de/api/public/reporting/laendertabelle
1622434749,710,556,154,96,62,https://www.intensivregister.de/api/public/reporting/laendertabelle
1622438348,708,553,155,94,60,https://www.intensivregister.de/api/public/reporting/laendertabelle
1622441948,708,556,152,94,60,https://www.intensivregister.de/api/public/reporting/laendertabelle
1622445548,709,556,153,94,60,https://www.intensivregister.de/api/public/reporting/laendertabelle
1622495950,709,555,154,94,60,https://www.intensivregister.de/api/public/reporting/laendertabelle
1622510348,709,554,155,93,59,https://www.intensivregister.de/api/public/reporting/laendertabelle
1622513947,712,569,143,88,57,https://www.intensivregister.de/api/public/reporting/laendertabelle
1622517546,710,573,137,84,57,https://www.intensivregister.de/api/public/reporting/laendertabelle
1622521146,710,575,135,83,57,https://www.intensivregister.de/api/public/reporting/laendertabelle
1622524745,711,575,136,83,57,https://www.intensivregister.de/api/public/reporting/laendertabelle
1622528345,711,576,135,84,57,https://www.intensivregister.de/api/public/reporting/laendertabelle
1622578746,711,577,134,84,57,https://www.intensivregister.de/api/public/reporting/laendertabelle
1622593147,711,574,137,82,56,https://www.intensivregister.de/api/public/reporting/laendertabelle
1622596744,711,571,140,80,56,https://www.intensivregister.de/api/public/reporting/laendertabelle
1622600352,717,582,135,76,58,https://www.intensivregister.de/api/public/reporting/laendertabelle
1622603950,717,580,137,75,57,https://www.intensivregister.de/api/public/reporting/laendertabelle
1622607550,719,580,139,73,56,https://www.intensivregister.de/api/public/reporting/laendertabelle
1622611149,719,579,140,73,56,https://www.intensivregister.de/api/public/reporting/laendertabelle
1622614748,722,579,143,74,56,https://www.intensivregister.de/api/public/reporting/laendertabelle
1622618347,722,581,141,74,56,https://www.intensivregister.de/api/public/reporting/laendertabelle
1622654346,720,583,137,74,56,https://www.intensivregister.de/api/public/reporting/laendertabelle
1622665143,720,585,135,75,57,https://www.intensivregister.de/api/public/reporting/laendertabelle
1622690345,718,586,132,75,52,https://www.intensivregister.de/api/public/reporting/laendertabelle
1622693944,718,593,125,74,51,https://www.intensivregister.de/api/public/reporting/laendertabelle
1622697543,718,594,124,74,51,https://www.intensivregister.de/api/public/reporting/laendertabelle
1622701150,719,597,122,74,52,https://www.intensivregister.de/api/public/reporting/laendertabelle
1622751548,719,596,123,74,51,https://www.intensivregister.de/api/public/reporting/laendertabelle
1622773148,726,601,125,72,51,https://www.intensivregister.de/api/public/reporting/laendertabelle
1622776743,726,598,128,72,51,https://www.intensivregister.de/api/public/reporting/laendertabelle
1622780348,726,593,133,71,49,https://www.intensivregister.de/api/public/reporting/laendertabelle
1622783944,726,590,136,70,49,https://www.intensivregister.de/api/public/reporting/laendertabelle
1622787549,723,589,134,71,52,https://www.intensivregister.de/api/public/reporting/laendertabelle
1622791144,721,584,137,72,52,https://www.intensivregister.de/api/public/reporting/laendertabelle
1622837944,721,581,140,72,52,https://www.intensivregister.de/api/public/reporting/laendertabelle
1622859546,721,582,139,72,52,https://www.intensivregister.de/api/public/reporting/laendertabelle
1622863143,721,576,145,72,52,https://www.intensivregister.de/api/public/reporting/laendertabelle
1622866750,721,569,152,69,51,https://www.intensivregister.de/api/public/reporting/laendertabelle
1622870347,721,568,153,66,50,https://www.intensivregister.de/api/public/reporting/laendertabelle
1622873944,711,564,147,66,50,https://www.intensivregister.de/api/public/reporting/laendertabelle
1622877548,712,565,147,66,50,https://www.intensivregister.de/api/public/reporting/laendertabelle
1622884748,712,562,150,66,48,https://www.intensivregister.de/api/public/reporting/laendertabelle
1622935148,712,563,149,66,48,https://www.intensivregister.de/api/public/reporting/laendertabelle
1622945944,712,553,159,66,48,https://www.intensivregister.de/api/public/reporting/laendertabelle
1622949549,712,548,164,65,46,https://www.intensivregister.de/api/public/reporting/laendertabelle
1622953145,711,539,172,65,46,https://www.intensivregister.de/api/public/reporting/laendertabelle
1622956750,711,532,179,64,46,https://www.intensivregister.de/api/public/reporting/laendertabelle
1622960346,709,527,182,62,44,https://www.intensivregister.de/api/public/reporting/laendertabelle
1622963944,709,533,176,61,43,https://www.intensivregister.de/api/public/reporting/laendertabelle
1623032344,707,537,170,61,42,https://www.intensivregister.de/api/public/reporting/laendertabelle
1623035949,707,536,171,59,41,https://www.intensivregister.de/api/public/reporting/laendertabelle
1623039545,707,540,167,60,41,https://www.intensivregister.de/api/public/reporting/laendertabelle
1623043150,706,540,166,60,41,https://www.intensivregister.de/api/public/reporting/laendertabelle
1623086345,706,538,168,59,41,https://www.intensivregister.de/api/public/reporting/laendertabelle
1623118743,706,559,147,56,41,https://www.intensivregister.de/api/public/reporting/laendertabelle
1623122349,714,570,144,56,40,https://www.intensivregister.de/api/public/reporting/laendertabelle
1623125944,712,568,144,56,40,https://www.intensivregister.de/api/public/reporting/laendertabelle
1623129550,712,569,143,55,40,https://www.intensivregister.de/api/public/reporting/laendertabelle
1623133145,711,566,145,55,40,https://www.intensivregister.de/api/public/reporting/laendertabelle
1623136751,711,565,146,55,40,https://www.intensivregister.de/api/public/reporting/laendertabelle
1623205144,710,568,142,53,38,https://www.intensivregister.de/api/public/reporting/laendertabelle
1623208748,710,573,137,51,35,https://www.intensivregister.de/api/public/reporting/laendertabelle
1623212352,713,582,131,51,34,https://www.intensivregister.de/api/public/reporting/laendertabelle
1623219549,714,588,126,50,34,https://www.intensivregister.de/api/public/reporting/laendertabelle
1623273552,718,584,134,50,34,https://www.intensivregister.de/api/public/reporting/laendertabelle
1623287945,718,583,135,50,34,https://www.intensivregister.de/api/public/reporting/laendertabelle
1623291544,718,575,143,49,35,https://www.intensivregister.de/api/public/reporting/laendertabelle
1623295152,718,582,136,48,35,https://www.intensivregister.de/api/public/reporting/laendertabelle
1623298751,720,581,139,49,35,https://www.intensivregister.de/api/public/reporting/laendertabelle
1623302350,720,583,137,50,35,https://www.intensivregister.de/api/public/reporting/laendertabelle
1623305952,720,584,136,50,35,https://www.intensivregister.de/api/public/reporting/laendertabelle
1623309549,720,576,144,50,35,https://www.intensivregister.de/api/public/reporting/laendertabelle
1623356346,720,577,143,50,35,https://www.intensivregister.de/api/public/reporting/laendertabelle
1623359943,721,576,145,50,35,https://www.intensivregister.de/api/public/reporting/laendertabelle
1623374344,722,577,145,50,35,https://www.intensivregister.de/api/public/reporting/laendertabelle
1623377952,722,576,146,50,33,https://www.intensivregister.de/api/public/reporting/laendertabelle
1623381550,722,573,149,50,33,https://www.intensivregister.de/api/public/reporting/laendertabelle
1623385147,724,578,146,50,33,https://www.intensivregister.de/api/public/reporting/laendertabelle
1623388745,724,579,145,50,33,https://www.intensivregister.de/api/public/reporting/laendertabelle
1623392353,725,579,146,50,33,https://www.intensivregister.de/api/public/reporting/laendertabelle
1623395950,725,577,148,50,33,https://www.intensivregister.de/api/public/reporting/laendertabelle
1623453551,722,582,140,50,33,https://www.intensivregister.de/api/public/reporting/laendertabelle
1623467949,720,584,136,49,35,https://www.intensivregister.de/api/public/reporting/laendertabelle
1623471547,721,577,144,48,34,https://www.intensivregister.de/api/public/reporting/laendertabelle
1623475146,721,576,145,49,36,https://www.intensivregister.de/api/public/reporting/laendertabelle
1623478746,720,577,143,49,36,https://www.intensivregister.de/api/public/reporting/laendertabelle
1623482345,720,576,144,49,36,https://www.intensivregister.de/api/public/reporting/laendertabelle
1623536351,718,576,142,49,36,https://www.intensivregister.de/api/public/reporting/laendertabelle
1623550748,718,577,141,49,36,https://www.intensivregister.de/api/public/reporting/laendertabelle
1623554347,719,579,140,48,35,https://www.intensivregister.de/api/public/reporting/laendertabelle
1623557946,719,579,140,47,35,https://www.intensivregister.de/api/public/reporting/laendertabelle
1623561545,719,583,136,47,34,https://www.intensivregister.de/api/public/reporting/laendertabelle
1623565144,716,580,136,47,34,https://www.intensivregister.de/api/public/reporting/laendertabelle
1623615552,716,579,137,47,34,https://www.intensivregister.de/api/public/reporting/laendertabelle
1623633549,715,576,139,47,34,https://www.intensivregister.de/api/public/reporting/laendertabelle
1623637148,709,562,147,44,32,https://www.intensivregister.de/api/public/reporting/laendertabelle
1623640747,709,558,151,43,31,https://www.intensivregister.de/api/public/reporting/laendertabelle
1623644346,709,558,151,42,30,https://www.intensivregister.de/api/public/reporting/laendertabelle
1623647946,710,560,150,43,30,https://www.intensivregister.de/api/public/reporting/laendertabelle
1623651545,710,558,152,42,29,https://www.intensivregister.de/api/public/reporting/laendertabelle
1623701946,710,561,149,42,29,https://www.intensivregister.de/api/public/reporting/laendertabelle
1623719952,710,560,150,42,29,https://www.intensivregister.de/api/public/reporting/laendertabelle
1623723551,709,576,133,42,29,https://www.intensivregister.de/api/public/reporting/laendertabelle
1623727151,718,587,131,39,27,https://www.intensivregister.de/api/public/reporting/laendertabelle
1623730750,718,591,127,39,27,https://www.intensivregister.de/api/public/reporting/laendertabelle
1623734349,723,593,130,40,27,https://www.intensivregister.de/api/public/reporting/laendertabelle
1623741548,724,596,128,40,27,https://www.intensivregister.de/api/public/reporting/laendertabelle
1623748747,724,594,130,40,27,https://www.intensivregister.de/api/public/reporting/laendertabelle
1623752346,724,593,131,40,27,https://www.intensivregister.de/api/public/reporting/laendertabelle
1623795547,724,594,130,40,27,https://www.intensivregister.de/api/public/reporting/laendertabelle
1623802745,724,587,137,40,27,https://www.intensivregister.de/api/public/reporting/laendertabelle
1623806344,724,591,133,40,27,https://www.intensivregister.de/api/public/reporting/laendertabelle
1623809950,723,591,132,41,24,https://www.intensivregister.de/api/public/reporting/laendertabelle
1623813545,723,594,129,42,25,https://www.intensivregister.de/api/public/reporting/laendertabelle
1623817152,728,599,129,39,23,https://www.intensivregister.de/api/public/reporting/laendertabelle
1623820749,728,600,128,39,23,https://www.intensivregister.de/api/public/reporting/laendertabelle
1623824346,727,600,127,38,23,https://www.intensivregister.de/api/public/reporting/laendertabelle
1623874752,727,601,126,38,23,https://www.intensivregister.de/api/public/reporting/laendertabelle
1623892749,727,605,122,38,23,https://www.intensivregister.de/api/public/reporting/laendertabelle
1623896348,726,598,128,38,24,https://www.intensivregister.de/api/public/reporting/laendertabelle
1623899947,728,601,127,37,23,https://www.intensivregister.de/api/public/reporting/laendertabelle
1623903547,728,596,132,32,21,https://www.intensivregister.de/api/public/reporting/laendertabelle
1623907147,728,594,134,32,21,https://www.intensivregister.de/api/public/reporting/laendertabelle
1623910746,727,594,133,32,21,https://www.intensivregister.de/api/public/reporting/laendertabelle
1623961144,728,596,132,32,21,https://www.intensivregister.de/api/public/reporting/laendertabelle
1623979150,728,599,129,32,20,https://www.intensivregister.de/api/public/reporting/laendertabelle
1623982745,729,600,129,32,20,https://www.intensivregister.de/api/public/reporting/laendertabelle
1623986349,728,602,126,34,21,https://www.intensivregister.de/api/public/reporting/laendertabelle
1623989944,728,598,130,34,20,https://www.intensivregister.de/api/public/reporting/laendertabelle
1624000750,728,597,131,34,20,https://www.intensivregister.de/api/public/reporting/laendertabelle
1624051143,727,596,131,34,20,https://www.intensivregister.de/api/public/reporting/laendertabelle
1624069151,727,596,131,33,20,https://www.intensivregister.de/api/public/reporting/laendertabelle
1624072747,727,592,135,33,20,https://www.intensivregister.de/api/public/reporting/laendertabelle
1624076343,728,592,136,32,19,https://www.intensivregister.de/api/public/reporting/laendertabelle
1624079949,728,586,142,32,19,https://www.intensivregister.de/api/public/reporting/laendertabelle
1624083545,729,586,143,31,19,https://www.intensivregister.de/api/public/reporting/laendertabelle
1624101548,729,585,144,31,19,https://www.intensivregister.de/api/public/reporting/laendertabelle
1624133950,729,584,145,31,19,https://www.intensivregister.de/api/public/reporting/laendertabelle
1624141145,729,583,146,31,19,https://www.intensivregister.de/api/public/reporting/laendertabelle
1624155549,729,582,147,31,19,https://www.intensivregister.de/api/public/reporting/laendertabelle
1624159143,730,582,148,31,22,https://www.intensivregister.de/api/public/reporting/laendertabelle
1624162747,730,572,158,31,22,https://www.intensivregister.de/api/public/reporting/laendertabelle
1624166351,730,564,166,31,22,https://www.intensivregister.de/api/public/reporting/laendertabelle
1624173549,730,563,167,31,22,https://www.intensivregister.de/api/public/reporting/laendertabelle
1624184343,730,564,166,31,22,https://www.intensivregister.de/api/public/reporting/laendertabelle
1624241951,725,575,150,28,20,https://www.intensivregister.de/api/public/reporting/laendertabelle
1624245549,725,575,150,27,20,https://www.intensivregister.de/api/public/reporting/laendertabelle
1624249148,725,569,156,27,20,https://www.intensivregister.de/api/public/reporting/laendertabelle
1624252746,725,570,155,27,20,https://www.intensivregister.de/api/public/reporting/laendertabelle
1624256345,725,569,156,27,20,https://www.intensivregister.de/api/public/reporting/laendertabelle
1624324751,725,572,153,27,20,https://www.intensivregister.de/api/public/reporting/laendertabelle
1624328352,738,590,148,27,20,https://www.intensivregister.de/api/public/reporting/laendertabelle
1624335544,738,605,133,26,20,https://www.intensivregister.de/api/public/reporting/laendertabelle
1624339146,738,611,127,26,21,https://www.intensivregister.de/api/public/reporting/laendertabelle
1624414749,739,608,131,26,20,https://www.intensivregister.de/api/public/reporting/laendertabelle
1624418352,736,609,127,26,20,https://www.intensivregister.de/api/public/reporting/laendertabelle
1624421945,736,606,130,25,20,https://www.intensivregister.de/api/public/reporting/laendertabelle
1624429152,736,605,131,25,20,https://www.intensivregister.de/api/public/reporting/laendertabelle
1624432745,736,604,132,25,20,https://www.intensivregister.de/api/public/reporting/laendertabelle
1624479544,736,603,133,25,20,https://www.intensivregister.de/api/public/reporting/laendertabelle
1624501151,735,584,151,24,20,https://www.intensivregister.de/api/public/reporting/laendertabelle
1624504749,733,587,146,23,19,https://www.intensivregister.de/api/public/reporting/laendertabelle
1624508346,734,588,146,22,18,https://www.intensivregister.de/api/public/reporting/laendertabelle
1624511944,734,589,145,22,18,https://www.intensivregister.de/api/public/reporting/laendertabelle
1624515552,734,592,142,22,18,https://www.intensivregister.de/api/public/reporting/laendertabelle
1624533551,734,590,144,22,18,https://www.intensivregister.de/api/public/reporting/laendertabelle
1624573148,734,593,141,22,18,https://www.intensivregister.de/api/public/reporting/laendertabelle
1624576745,734,595,139,22,18,https://www.intensivregister.de/api/public/reporting/laendertabelle
1624580344,734,596,138,22,18,https://www.intensivregister.de/api/public/reporting/laendertabelle
1624587550,733,606,127,20,16,https://www.intensivregister.de/api/public/reporting/laendertabelle
1624591148,733,604,129,20,16,https://www.intensivregister.de/api/public/reporting/laendertabelle
1624594746,731,606,125,20,16,https://www.intensivregister.de/api/public/reporting/laendertabelle
1624601952,727,603,124,19,15,https://www.intensivregister.de/api/public/reporting/laendertabelle
1624605550,727,601,126,19,15,https://www.intensivregister.de/api/public/reporting/laendertabelle
1624609148,727,600,127,19,15,https://www.intensivregister.de/api/public/reporting/laendertabelle
1624652343,727,601,126,19,15,https://www.intensivregister.de/api/public/reporting/laendertabelle
1624673950,727,597,130,19,15,https://www.intensivregister.de/api/public/reporting/laendertabelle
1624677547,727,594,133,18,15,https://www.intensivregister.de/api/public/reporting/laendertabelle
1624681145,727,597,130,18,15,https://www.intensivregister.de/api/public/reporting/laendertabelle
1624684743,727,595,132,18,15,https://www.intensivregister.de/api/public/reporting/laendertabelle
1624688351,727,592,135,17,13,https://www.intensivregister.de/api/public/reporting/laendertabelle
1624691949,727,590,137,17,13,https://www.intensivregister.de/api/public/reporting/laendertabelle
1624738751,727,591,136,17,13,https://www.intensivregister.de/api/public/reporting/laendertabelle
1624763945,720,587,133,17,13,https://www.intensivregister.de/api/public/reporting/laendertabelle
1624767543,720,579,141,17,13,https://www.intensivregister.de/api/public/reporting/laendertabelle
1624771151,720,582,138,17,13,https://www.intensivregister.de/api/public/reporting/laendertabelle
1624774747,720,584,136,17,13,https://www.intensivregister.de/api/public/reporting/laendertabelle
1624778346,724,582,142,17,14,https://www.intensivregister.de/api/public/reporting/laendertabelle
1624825153,724,583,141,17,14,https://www.intensivregister.de/api/public/reporting/laendertabelle
1624843144,724,581,143,17,14,https://www.intensivregister.de/api/public/reporting/laendertabelle
1624846752,722,571,151,17,14,https://www.intensivregister.de/api/public/reporting/laendertabelle
1624850350,722,574,148,17,14,https://www.intensivregister.de/api/public/reporting/laendertabelle
1624853948,719,576,143,18,14,https://www.intensivregister.de/api/public/reporting/laendertabelle
1624857547,719,577,142,18,14,https://www.intensivregister.de/api/public/reporting/laendertabelle
1624861145,719,569,150,18,13,https://www.intensivregister.de/api/public/reporting/laendertabelle
1624911552,719,572,147,18,13,https://www.intensivregister.de/api/public/reporting/laendertabelle
1624915150,719,567,152,18,13,https://www.intensivregister.de/api/public/reporting/laendertabelle
1624929543,725,567,158,19,13,https://www.intensivregister.de/api/public/reporting/laendertabelle
1624933151,723,568,155,20,13,https://www.intensivregister.de/api/public/reporting/laendertabelle
1624936746,724,569,155,20,13,https://www.intensivregister.de/api/public/reporting/laendertabelle
1624940352,725,572,153,19,13,https://www.intensivregister.de/api/public/reporting/laendertabelle
1624943948,725,574,151,17,10,https://www.intensivregister.de/api/public/reporting/laendertabelle
1624947544,725,576,149,17,10,https://www.intensivregister.de/api/public/reporting/laendertabelle
1624997947,725,573,152,17,10,https://www.intensivregister.de/api/public/reporting/laendertabelle
1625019543,722,576,146,17,10,https://www.intensivregister.de/api/public/reporting/laendertabelle
1625023151,722,578,144,17,10,https://www.intensivregister.de/api/public/reporting/laendertabelle
1625026749,722,579,143,17,12,https://www.intensivregister.de/api/public/reporting/laendertabelle
1625030346,722,578,144,17,12,https://www.intensivregister.de/api/public/reporting/laendertabelle
1625033944,722,579,143,16,12,https://www.intensivregister.de/api/public/reporting/laendertabelle
1625037552,722,584,138,16,12,https://www.intensivregister.de/api/public/reporting/laendertabelle
1625041150,722,583,139,16,12,https://www.intensivregister.de/api/public/reporting/laendertabelle
1625105951,722,582,140,16,13,https://www.intensivregister.de/api/public/reporting/laendertabelle
1625109549,722,586,136,16,13,https://www.intensivregister.de/api/public/reporting/laendertabelle
1625113147,720,583,137,16,12,https://www.intensivregister.de/api/public/reporting/laendertabelle
1625120353,719,585,134,15,12,https://www.intensivregister.de/api/public/reporting/laendertabelle
1625123950,719,590,129,15,12,https://www.intensivregister.de/api/public/reporting/laendertabelle
1625163546,719,592,127,15,12,https://www.intensivregister.de/api/public/reporting/laendertabelle
1625188752,719,593,126,16,12,https://www.intensivregister.de/api/public/reporting/laendertabelle
1625192350,714,597,117,17,12,https://www.intensivregister.de/api/public/reporting/laendertabelle
1625195948,714,590,124,17,12,https://www.intensivregister.de/api/public/reporting/laendertabelle
1625199546,714,595,119,17,12,https://www.intensivregister.de/api/public/reporting/laendertabelle
1625203144,715,594,121,17,12,https://www.intensivregister.de/api/public/reporting/laendertabelle
1625206752,715,595,120,17,12,https://www.intensivregister.de/api/public/reporting/laendertabelle
1625271544,715,596,119,17,12,https://www.intensivregister.de/api/public/reporting/laendertabelle
1625282348,716,595,121,17,12,https://www.intensivregister.de/api/public/reporting/laendertabelle
1625285946,716,594,122,17,12,https://www.intensivregister.de/api/public/reporting/laendertabelle
1625289544,716,590,126,17,12,https://www.intensivregister.de/api/public/reporting/laendertabelle
1625293152,716,583,133,17,12,https://www.intensivregister.de/api/public/reporting/laendertabelle
1625361552,716,584,132,17,12,https://www.intensivregister.de/api/public/reporting/laendertabelle
1625368747,714,577,137,17,12,https://www.intensivregister.de/api/public/reporting/laendertabelle
1625372345,714,573,141,17,12,https://www.intensivregister.de/api/public/reporting/laendertabelle
1625375943,714,574,140,17,12,https://www.intensivregister.de/api/public/reporting/laendertabelle
1625379551,713,579,134,17,12,https://www.intensivregister.de/api/public/reporting/laendertabelle
1625444344,713,578,135,17,12,https://www.intensivregister.de/api/public/reporting/laendertabelle
1625447952,713,577,136,17,12,https://www.intensivregister.de/api/public/reporting/laendertabelle
1625451550,713,569,144,15,12,https://www.intensivregister.de/api/public/reporting/laendertabelle
1625455148,713,567,146,15,12,https://www.intensivregister.de/api/public/reporting/laendertabelle
1625462344,714,565,149,15,12,https://www.intensivregister.de/api/public/reporting/laendertabelle
1625465952,714,563,151,15,12,https://www.intensivregister.de/api/public/reporting/laendertabelle
1625537994,714,560,154,15,12,https://www.intensivregister.de/api/public/reporting/laendertabelle
1625541546,714,561,153,15,12,https://www.intensivregister.de/api/public/reporting/laendertabelle
1625545144,714,563,151,15,12,https://www.intensivregister.de/api/public/reporting/laendertabelle
1625548752,719,563,156,16,12,https://www.intensivregister.de/api/public/reporting/laendertabelle
1625552350,718,559,159,16,12,https://www.intensivregister.de/api/public/reporting/laendertabelle
1625602751,718,560,158,16,12,https://www.intensivregister.de/api/public/reporting/laendertabelle
1625624347,718,562,156,16,12,https://www.intensivregister.de/api/public/reporting/laendertabelle
1625627944,719,564,155,16,12,https://www.intensivregister.de/api/public/reporting/laendertabelle
1625631552,719,567,152,17,12,https://www.intensivregister.de/api/public/reporting/laendertabelle
1625635150,717,567,150,16,11,https://www.intensivregister.de/api/public/reporting/laendertabelle
1625642345,719,568,151,15,11,https://www.intensivregister.de/api/public/reporting/laendertabelle
1625681952,719,566,153,15,11,https://www.intensivregister.de/api/public/reporting/laendertabelle
1625692745,719,565,154,15,11,https://www.intensivregister.de/api/public/reporting/laendertabelle
1625707143,719,567,152,15,11,https://www.intensivregister.de/api/public/reporting/laendertabelle
1625710751,719,562,157,15,11,https://www.intensivregister.de/api/public/reporting/laendertabelle
1625714348,718,575,143,16,11,https://www.intensivregister.de/api/public/reporting/laendertabelle
1625717945,719,578,141,16,11,https://www.intensivregister.de/api/public/reporting/laendertabelle
1625721557,720,574,146,16,11,https://www.intensivregister.de/api/public/reporting/laendertabelle
1625728747,720,576,144,16,11,https://www.intensivregister.de/api/public/reporting/laendertabelle
1625775549,720,575,145,16,11,https://www.intensivregister.de/api/public/reporting/laendertabelle
1625782744,720,577,143,16,11,https://www.intensivregister.de/api/public/reporting/laendertabelle
1625797153,721,572,149,16,11,https://www.intensivregister.de/api/public/reporting/laendertabelle
1625800750,717,571,146,17,12,https://www.intensivregister.de/api/public/reporting/laendertabelle
1625804347,717,571,146,16,12,https://www.intensivregister.de/api/public/reporting/laendertabelle
1625807945,717,574,143,15,12,https://www.intensivregister.de/api/public/reporting/laendertabelle
1625811554,717,575,142,15,12,https://www.intensivregister.de/api/public/reporting/laendertabelle
1625851143,717,575,142,16,12,https://www.intensivregister.de/api/public/reporting/laendertabelle
1625869149,717,571,146,16,12,https://www.intensivregister.de/api/public/reporting/laendertabelle
1625879950,717,569,148,16,12,https://www.intensivregister.de/api/public/reporting/laendertabelle
1625883544,717,570,147,16,12,https://www.intensivregister.de/api/public/reporting/laendertabelle
1625887147,716,568,148,14,11,https://www.intensivregister.de/api/public/reporting/laendertabelle
1625890751,714,562,152,14,11,https://www.intensivregister.de/api/public/reporting/laendertabelle
1625894345,714,556,158,14,11,https://www.intensivregister.de/api/public/reporting/laendertabelle
1625897948,714,555,159,14,11,https://www.intensivregister.de/api/public/reporting/laendertabelle
1625901552,714,554,160,14,11,https://www.intensivregister.de/api/public/reporting/laendertabelle
1625959151,714,553,161,14,11,https://www.intensivregister.de/api/public/reporting/laendertabelle
1625966348,714,556,158,14,11,https://www.intensivregister.de/api/public/reporting/laendertabelle
1625969952,714,558,156,14,11,https://www.intensivregister.de/api/public/reporting/laendertabelle
1625973545,714,554,160,14,11,https://www.intensivregister.de/api/public/reporting/laendertabelle
1625977149,714,559,155,13,11,https://www.intensivregister.de/api/public/reporting/laendertabelle
1625980752,714,558,156,13,11,https://www.intensivregister.de/api/public/reporting/laendertabelle
1625984346,711,558,153,13,11,https://www.intensivregister.de/api/public/reporting/laendertabelle
1625991545,711,557,154,13,11,https://www.intensivregister.de/api/public/reporting/laendertabelle
1626034745,711,556,155,13,11,https://www.intensivregister.de/api/public/reporting/laendertabelle
1626052743,711,555,156,13,11,https://www.intensivregister.de/api/public/reporting/laendertabelle
1626056346,714,547,167,14,12,https://www.intensivregister.de/api/public/reporting/laendertabelle
1626059950,720,547,173,14,12,https://www.intensivregister.de/api/public/reporting/laendertabelle
1626063543,722,548,174,14,12,https://www.intensivregister.de/api/public/reporting/laendertabelle
1626067147,723,549,174,14,12,https://www.intensivregister.de/api/public/reporting/laendertabelle
1626074345,723,548,175,14,12,https://www.intensivregister.de/api/public/reporting/laendertabelle
1626121143,723,551,172,14,12,https://www.intensivregister.de/api/public/reporting/laendertabelle
1626139151,723,552,171,14,12,https://www.intensivregister.de/api/public/reporting/laendertabelle
1626142745,724,566,158,15,12,https://www.intensivregister.de/api/public/reporting/laendertabelle
1626146348,724,563,161,15,12,https://www.intensivregister.de/api/public/reporting/laendertabelle
1626149951,723,564,159,15,12,https://www.intensivregister.de/api/public/reporting/laendertabelle
1626160753,723,569,154,15,12,https://www.intensivregister.de/api/public/reporting/laendertabelle
1626164346,723,570,153,15,12,https://www.intensivregister.de/api/public/reporting/laendertabelle
1626171544,722,571,151,15,12,https://www.intensivregister.de/api/public/reporting/laendertabelle
1626211144,722,572,150,15,12,https://www.intensivregister.de/api/public/reporting/laendertabelle
1626214748,722,574,148,15,12,https://www.intensivregister.de/api/public/reporting/laendertabelle
1626225549,722,576,146,15,12,https://www.intensivregister.de/api/public/reporting/laendertabelle
1626229152,724,586,138,12,11,https://www.intensivregister.de/api/public/reporting/laendertabelle
1626232746,724,592,132,13,12,https://www.intensivregister.de/api/public/reporting/laendertabelle
1626236349,724,597,127,13,12,https://www.intensivregister.de/api/public/reporting/laendertabelle
1626239944,724,601,123,13,12,https://www.intensivregister.de/api/public/reporting/laendertabelle
1626243547,722,598,124,13,12,https://www.intensivregister.de/api/public/reporting/laendertabelle
1626247151,722,597,125,13,12,https://www.intensivregister.de/api/public/reporting/laendertabelle
1626293951,722,594,128,13,12,https://www.intensivregister.de/api/public/reporting/laendertabelle
1626311946,723,593,130,13,12,https://www.intensivregister.de/api/public/reporting/laendertabelle
1626315550,722,583,139,13,12,https://www.intensivregister.de/api/public/reporting/laendertabelle
1626319144,722,580,142,13,12,https://www.intensivregister.de/api/public/reporting/laendertabelle
1626322747,722,582,140,12,11,https://www.intensivregister.de/api/public/reporting/laendertabelle
1626329944,722,583,139,12,11,https://www.intensivregister.de/api/public/reporting/laendertabelle
1626333548,722,581,141,12,11,https://www.intensivregister.de/api/public/reporting/laendertabelle
1626391147,722,580,142,12,11,https://www.intensivregister.de/api/public/reporting/laendertabelle
1626398352,722,585,137,12,11,https://www.intensivregister.de/api/public/reporting/laendertabelle
1626401946,719,578,141,12,11,https://www.intensivregister.de/api/public/reporting/laendertabelle
1626405548,723,587,136,13,12,https://www.intensivregister.de/api/public/reporting/laendertabelle
1626412753,724,588,136,13,12,https://www.intensivregister.de/api/public/reporting/laendertabelle
1626416349,724,589,135,13,12,https://www.intensivregister.de/api/public/reporting/laendertabelle
1626419951,724,588,136,13,12,https://www.intensivregister.de/api/public/reporting/laendertabelle
1626434351,725,592,133,14,13,https://www.intensivregister.de/api/public/reporting/laendertabelle
1626473952,725,593,132,14,13,https://www.intensivregister.de/api/public/reporting/laendertabelle
1626488351,720,592,128,13,12,https://www.intensivregister.de/api/public/reporting/laendertabelle
1626491943,719,588,131,13,12,https://www.intensivregister.de/api/public/reporting/laendertabelle
1626495545,719,583,136,13,12,https://www.intensivregister.de/api/public/reporting/laendertabelle
1626499148,718,583,135,13,12,https://www.intensivregister.de/api/public/reporting/laendertabelle
1626502750,718,584,134,12,11,https://www.intensivregister.de/api/public/reporting/laendertabelle
1626553143,718,583,135,12,11,https://www.intensivregister.de/api/public/reporting/laendertabelle
1626567552,718,580,138,12,11,https://www.intensivregister.de/api/public/reporting/laendertabelle
1626578350,716,579,137,12,11,https://www.intensivregister.de/api/public/reporting/laendertabelle
1626581952,716,576,140,12,11,https://www.intensivregister.de/api/public/reporting/laendertabelle
1626589147,716,561,155,12,11,https://www.intensivregister.de/api/public/reporting/laendertabelle
1626592749,714,561,153,12,11,https://www.intensivregister.de/api/public/reporting/laendertabelle
1626657548,714,559,155,12,11,https://www.intensivregister.de/api/public/reporting/laendertabelle
1626661150,722,557,165,12,11,https://www.intensivregister.de/api/public/reporting/laendertabelle
1626664752,722,561,161,12,11,https://www.intensivregister.de/api/public/reporting/laendertabelle
1626668344,722,564,158,12,11,https://www.intensivregister.de/api/public/reporting/laendertabelle
1626671946,722,565,157,12,11,https://www.intensivregister.de/api/public/reporting/laendertabelle
1626743949,722,566,156,12,11,https://www.intensivregister.de/api/public/reporting/laendertabelle
1626747551,724,582,142,11,10,https://www.intensivregister.de/api/public/reporting/laendertabelle
1626751154,724,583,141,11,10,https://www.intensivregister.de/api/public/reporting/laendertabelle
1626754756,724,584,140,11,10,https://www.intensivregister.de/api/public/reporting/laendertabelle
1626758348,724,584,140,10,10,https://www.intensivregister.de/api/public/reporting/laendertabelle
1626761951,724,588,136,10,10,https://www.intensivregister.de/api/public/reporting/laendertabelle
1626765553,724,597,127,10,10,https://www.intensivregister.de/api/public/reporting/laendertabelle
1626815955,724,598,126,10,10,https://www.intensivregister.de/api/public/reporting/laendertabelle
1626819547,724,600,124,10,10,https://www.intensivregister.de/api/public/reporting/laendertabelle
1626833947,726,604,122,10,10,https://www.intensivregister.de/api/public/reporting/laendertabelle
1626837549,726,599,127,10,10,https://www.intensivregister.de/api/public/reporting/laendertabelle
1626841153,726,601,125,10,10,https://www.intensivregister.de/api/public/reporting/laendertabelle
1626844754,726,602,124,10,10,https://www.intensivregister.de/api/public/reporting/laendertabelle
1626848356,726,603,123,10,10,https://www.intensivregister.de/api/public/reporting/laendertabelle
1626851948,726,604,122,10,10,https://www.intensivregister.de/api/public/reporting/laendertabelle
1626898747,726,605,121,10,10,https://www.intensivregister.de/api/public/reporting/laendertabelle
1626913147,728,608,120,10,10,https://www.intensivregister.de/api/public/reporting/laendertabelle
1626920351,724,604,120,10,10,https://www.intensivregister.de/api/public/reporting/laendertabelle
1626923944,724,602,122,10,10,https://www.intensivregister.de/api/public/reporting/laendertabelle
1626927547,724,605,119,10,10,https://www.intensivregister.de/api/public/reporting/laendertabelle
1626931150,724,602,122,10,10,https://www.intensivregister.de/api/public/reporting/laendertabelle
1626934752,724,604,120,10,10,https://www.intensivregister.de/api/public/reporting/laendertabelle
1626999547,724,607,117,10,10,https://www.intensivregister.de/api/public/reporting/laendertabelle
1627006743,722,604,118,10,10,https://www.intensivregister.de/api/public/reporting/laendertabelle
1627010345,722,615,107,10,10,https://www.intensivregister.de/api/public/reporting/laendertabelle
1627013948,722,613,109,10,10,https://www.intensivregister.de/api/public/reporting/laendertabelle
1627017551,722,612,110,10,10,https://www.intensivregister.de/api/public/reporting/laendertabelle
1627028350,722,614,108,10,10,https://www.intensivregister.de/api/public/reporting/laendertabelle
1627075156,722,611,111,10,10,https://www.intensivregister.de/api/public/reporting/laendertabelle
1627093151,724,605,119,10,10,https://www.intensivregister.de/api/public/reporting/laendertabelle
1627096747,724,602,122,10,10,https://www.intensivregister.de/api/public/reporting/laendertabelle
1627100352,724,601,123,11,10,https://www.intensivregister.de/api/public/reporting/laendertabelle
1627103948,727,602,125,11,10,https://www.intensivregister.de/api/public/reporting/laendertabelle
1627107553,728,601,127,11,10,https://www.intensivregister.de/api/public/reporting/laendertabelle
1627111148,726,589,137,11,10,https://www.intensivregister.de/api/public/reporting/laendertabelle
1627168750,726,587,139,11,10,https://www.intensivregister.de/api/public/reporting/laendertabelle
1627179547,726,585,141,11,10,https://www.intensivregister.de/api/public/reporting/laendertabelle
1627183152,726,589,137,12,10,https://www.intensivregister.de/api/public/reporting/laendertabelle
1627186746,726,588,138,12,10,https://www.intensivregister.de/api/public/reporting/laendertabelle
1627190351,728,585,143,12,10,https://www.intensivregister.de/api/public/reporting/laendertabelle
1627193947,724,578,146,12,10,https://www.intensivregister.de/api/public/reporting/laendertabelle
1627197552,724,581,143,12,10,https://www.intensivregister.de/api/public/reporting/laendertabelle
1627262352,724,580,144,12,10,https://www.intensivregister.de/api/public/reporting/laendertabelle
1627265947,724,577,147,12,10,https://www.intensivregister.de/api/public/reporting/laendertabelle
1627269552,724,567,157,12,10,https://www.intensivregister.de/api/public/reporting/laendertabelle
1627273147,724,564,160,12,10,https://www.intensivregister.de/api/public/reporting/laendertabelle
1627276752,727,569,158,12,10,https://www.intensivregister.de/api/public/reporting/laendertabelle
1627283946,727,571,156,12,10,https://www.intensivregister.de/api/public/reporting/laendertabelle
1627330756,727,572,155,12,10,https://www.intensivregister.de/api/public/reporting/laendertabelle
1627345158,727,574,153,12,10,https://www.intensivregister.de/api/public/reporting/laendertabelle
1627352346,737,583,154,12,10,https://www.intensivregister.de/api/public/reporting/laendertabelle
1627355957,735,579,156,12,10,https://www.intensivregister.de/api/public/reporting/laendertabelle
1627359547,735,589,146,12,10,https://www.intensivregister.de/api/public/reporting/laendertabelle
1627363147,735,590,145,12,10,https://www.intensivregister.de/api/public/reporting/laendertabelle
1627366747,731,591,140,12,10,https://www.intensivregister.de/api/public/reporting/laendertabelle
1627370347,731,590,141,12,10,https://www.intensivregister.de/api/public/reporting/laendertabelle
1627431548,731,591,140,12,10,https://www.intensivregister.de/api/public/reporting/laendertabelle
1627435149,731,592,139,12,10,https://www.intensivregister.de/api/public/reporting/laendertabelle
1627438749,733,600,133,11,10,https://www.intensivregister.de/api/public/reporting/laendertabelle
1627442349,733,602,131,11,9,https://www.intensivregister.de/api/public/reporting/laendertabelle
1627445951,732,604,128,13,9,https://www.intensivregister.de/api/public/reporting/laendertabelle
1627449552,732,610,122,13,9,https://www.intensivregister.de/api/public/reporting/laendertabelle
1627463954,732,610,122,12,9,https://www.intensivregister.de/api/public/reporting/laendertabelle
1627507151,732,611,121,12,9,https://www.intensivregister.de/api/public/reporting/laendertabelle
1627510749,732,611,121,11,9,https://www.intensivregister.de/api/public/reporting/laendertabelle
1627525153,733,609,124,11,9,https://www.intensivregister.de/api/public/reporting/laendertabelle
1627528755,734,606,128,11,9,https://www.intensivregister.de/api/public/reporting/laendertabelle
1627532356,733,595,138,10,8,https://www.intensivregister.de/api/public/reporting/laendertabelle
1627539548,733,595,138,11,9,https://www.intensivregister.de/api/public/reporting/laendertabelle
1627543148,733,596,137,11,9,https://www.intensivregister.de/api/public/reporting/laendertabelle
1627597151,733,598,135,11,9,https://www.intensivregister.de/api/public/reporting/laendertabelle
1627611551,733,594,139,11,9,https://www.intensivregister.de/api/public/reporting/laendertabelle
1627615150,727,583,144,11,9,https://www.intensivregister.de/api/public/reporting/laendertabelle
1627618749,727,582,145,11,9,https://www.intensivregister.de/api/public/reporting/laendertabelle
1627629556,728,580,148,11,9,https://www.intensivregister.de/api/public/reporting/laendertabelle
1627633155,728,577,151,11,9,https://www.intensivregister.de/api/public/reporting/laendertabelle
1627690749,728,575,153,11,9,https://www.intensivregister.de/api/public/reporting/laendertabelle
1627694349,728,577,151,11,9,https://www.intensivregister.de/api/public/reporting/laendertabelle
1627697948,729,592,137,11,9,https://www.intensivregister.de/api/public/reporting/laendertabelle
1627701547,727,585,142,11,10,https://www.intensivregister.de/api/public/reporting/laendertabelle
1627705156,728,588,140,11,10,https://www.intensivregister.de/api/public/reporting/laendertabelle
1627708755,728,591,137,11,10,https://www.intensivregister.de/api/public/reporting/laendertabelle
1627712354,728,592,136,11,10,https://www.intensivregister.de/api/public/reporting/laendertabelle
1627766350,728,593,135,11,10,https://www.intensivregister.de/api/public/reporting/laendertabelle
1627780747,728,588,140,11,10,https://www.intensivregister.de/api/public/reporting/laendertabelle
1627784347,728,587,141,11,10,https://www.intensivregister.de/api/public/reporting/laendertabelle
1627791555,728,584,144,11,10,https://www.intensivregister.de/api/public/reporting/laendertabelle
1627795155,728,581,147,11,10,https://www.intensivregister.de/api/public/reporting/laendertabelle
1627798754,728,574,154,11,10,https://www.intensivregister.de/api/public/reporting/laendertabelle
1627802354,718,566,152,11,10,https://www.intensivregister.de/api/public/reporting/laendertabelle
1627827553,718,567,151,11,10,https://www.intensivregister.de/api/public/reporting/laendertabelle
1627852750,718,568,150,11,10,https://www.intensivregister.de/api/public/reporting/laendertabelle
1627867148,718,567,151,11,10,https://www.intensivregister.de/api/public/reporting/laendertabelle
1627870749,716,568,148,11,10,https://www.intensivregister.de/api/public/reporting/laendertabelle
1627874351,720,571,149,11,10,https://www.intensivregister.de/api/public/reporting/laendertabelle
1627877953,718,567,151,11,10,https://www.intensivregister.de/api/public/reporting/laendertabelle
1627885149,718,563,155,11,10,https://www.intensivregister.de/api/public/reporting/laendertabelle
1627888752,718,565,153,11,10,https://www.intensivregister.de/api/public/reporting/laendertabelle
1627892355,718,563,155,11,10,https://www.intensivregister.de/api/public/reporting/laendertabelle
1627939156,718,561,157,10,10,https://www.intensivregister.de/api/public/reporting/laendertabelle
1627953555,718,560,158,10,10,https://www.intensivregister.de/api/public/reporting/laendertabelle
1627957147,723,572,151,10,10,https://www.intensivregister.de/api/public/reporting/laendertabelle
1627960750,720,575,145,10,10,https://www.intensivregister.de/api/public/reporting/laendertabelle
1627964352,720,570,150,10,10,https://www.intensivregister.de/api/public/reporting/laendertabelle
1627967955,720,565,155,10,10,https://www.intensivregister.de/api/public/reporting/laendertabelle
1627971548,720,567,153,10,10,https://www.intensivregister.de/api/public/reporting/laendertabelle
1627996748,720,568,152,10,10,https://www.intensivregister.de/api/public/reporting/laendertabelle
1628025550,720,569,151,10,10,https://www.intensivregister.de/api/public/reporting/laendertabelle
1628043549,719,583,136,10,10,https://www.intensivregister.de/api/public/reporting/laendertabelle
1628047149,719,584,135,10,10,https://www.intensivregister.de/api/public/reporting/laendertabelle
1628050749,721,589,132,10,10,https://www.intensivregister.de/api/public/reporting/laendertabelle
1628054349,724,593,131,10,10,https://www.intensivregister.de/api/public/reporting/laendertabelle
1628057948,724,592,132,10,10,https://www.intensivregister.de/api/public/reporting/laendertabelle
1628108348,724,593,131,10,10,https://www.intensivregister.de/api/public/reporting/laendertabelle
1628115554,724,594,130,10,10,https://www.intensivregister.de/api/public/reporting/laendertabelle
1628129952,726,609,117,9,9,https://www.intensivregister.de/api/public/reporting/laendertabelle
1628133550,726,607,119,9,9,https://www.intensivregister.de/api/public/reporting/laendertabelle
1628137149,726,606,120,9,9,https://www.intensivregister.de/api/public/reporting/laendertabelle
1628140748,722,603,119,9,9,https://www.intensivregister.de/api/public/reporting/laendertabelle
1628147954,722,602,120,9,9,https://www.intensivregister.de/api/public/reporting/laendertabelle
1628194749,722,603,119,9,9,https://www.intensivregister.de/api/public/reporting/laendertabelle
1628198347,722,601,121,9,9,https://www.intensivregister.de/api/public/reporting/laendertabelle
1628216352,721,590,131,9,9,https://www.intensivregister.de/api/public/reporting/laendertabelle
1628219949,721,595,126,9,9,https://www.intensivregister.de/api/public/reporting/laendertabelle
1628223556,721,589,132,9,9,https://www.intensivregister.de/api/public/reporting/laendertabelle
1628227154,721,593,128,9,9,https://www.intensivregister.de/api/public/reporting/laendertabelle
1628234356,721,590,131,9,9,https://www.intensivregister.de/api/public/reporting/laendertabelle
1628288353,721,584,137,9,9,https://www.intensivregister.de/api/public/reporting/laendertabelle
1628302750,721,586,135,8,8,https://www.intensivregister.de/api/public/reporting/laendertabelle
1628306357,721,589,132,8,8,https://www.intensivregister.de/api/public/reporting/laendertabelle
1628309953,718,585,133,8,8,https://www.intensivregister.de/api/public/reporting/laendertabelle
1628313550,718,588,130,8,8,https://www.intensivregister.de/api/public/reporting/laendertabelle
1628317148,718,585,133,8,8,https://www.intensivregister.de/api/public/reporting/laendertabelle
1628320754,719,588,131,8,8,https://www.intensivregister.de/api/public/reporting/laendertabelle
1628367553,719,587,132,8,8,https://www.intensivregister.de/api/public/reporting/laendertabelle
1628389153,712,585,127,8,8,https://www.intensivregister.de/api/public/reporting/laendertabelle
1628392749,708,577,131,8,8,https://www.intensivregister.de/api/public/reporting/laendertabelle
1628396356,708,569,139,8,8,https://www.intensivregister.de/api/public/reporting/laendertabelle
1628399953,707,567,140,8,8,https://www.intensivregister.de/api/public/reporting/laendertabelle
1628403549,707,560,147,8,8,https://www.intensivregister.de/api/public/reporting/laendertabelle
1628464750,707,555,152,8,8,https://www.intensivregister.de/api/public/reporting/laendertabelle
1628471954,707,557,150,8,8,https://www.intensivregister.de/api/public/reporting/laendertabelle
1628475552,706,555,151,8,8,https://www.intensivregister.de/api/public/reporting/laendertabelle
1628479151,706,558,148,9,8,https://www.intensivregister.de/api/public/reporting/laendertabelle
1628482751,708,564,144,9,8,https://www.intensivregister.de/api/public/reporting/laendertabelle
1628486351,708,566,142,9,8,https://www.intensivregister.de/api/public/reporting/laendertabelle
1628489952,708,567,141,9,8,https://www.intensivregister.de/api/public/reporting/laendertabelle
1628493552,711,572,139,9,8,https://www.intensivregister.de/api/public/reporting/laendertabelle
1628507955,711,573,138,9,8,https://www.intensivregister.de/api/public/reporting/laendertabelle
1628554753,711,575,136,9,8,https://www.intensivregister.de/api/public/reporting/laendertabelle
1628558353,711,573,138,9,8,https://www.intensivregister.de/api/public/reporting/laendertabelle
1628561953,721,585,136,9,8,https://www.intensivregister.de/api/public/reporting/laendertabelle
1628565553,721,590,131,9,8,https://www.intensivregister.de/api/public/reporting/laendertabelle
1628569152,721,593,128,9,8,https://www.intensivregister.de/api/public/reporting/laendertabelle
1628576354,721,594,127,9,8,https://www.intensivregister.de/api/public/reporting/laendertabelle
1628579955,721,593,128,9,8,https://www.intensivregister.de/api/public/reporting/laendertabelle
1628583555,721,594,127,9,8,https://www.intensivregister.de/api/public/reporting/laendertabelle
1628644756,721,593,128,9,8,https://www.intensivregister.de/api/public/reporting/laendertabelle
1628648356,721,587,134,9,8,https://www.intensivregister.de/api/public/reporting/laendertabelle
1628651955,717,578,139,9,8,https://www.intensivregister.de/api/public/reporting/laendertabelle
1628655554,719,582,137,9,8,https://www.intensivregister.de/api/public/reporting/laendertabelle
1628659154,719,583,136,9,8,https://www.intensivregister.de/api/public/reporting/laendertabelle
1628662754,719,582,137,9,8,https://www.intensivregister.de/api/public/reporting/laendertabelle
1628666353,719,580,139,9,8,https://www.intensivregister.de/api/public/reporting/laendertabelle
1628734748,718,574,144,9,8,https://www.intensivregister.de/api/public/reporting/laendertabelle
1628738347,722,577,145,9,8,https://www.intensivregister.de/api/public/reporting/laendertabelle
1628741957,722,576,146,9,7,https://www.intensivregister.de/api/public/reporting/laendertabelle
1628752756,722,578,144,9,7,https://www.intensivregister.de/api/public/reporting/laendertabelle
1628756355,722,579,143,9,7,https://www.intensivregister.de/api/public/reporting/laendertabelle
1628759955,722,580,142,9,7,https://www.intensivregister.de/api/public/reporting/laendertabelle
1628806751,722,581,141,9,7,https://www.intensivregister.de/api/public/reporting/laendertabelle
1628810351,722,582,140,9,7,https://www.intensivregister.de/api/public/reporting/laendertabelle
1628813950,722,585,137,9,7,https://www.intensivregister.de/api/public/reporting/laendertabelle
1628821150,722,589,133,9,7,https://www.intensivregister.de/api/public/reporting/laendertabelle
1628824750,725,598,127,10,7,https://www.intensivregister.de/api/public/reporting/laendertabelle
1628828350,725,600,125,10,7,https://www.intensivregister.de/api/public/reporting/laendertabelle
1628831950,725,596,129,9,6,https://www.intensivregister.de/api/public/reporting/laendertabelle
1628903950,725,595,130,9,6,https://www.intensivregister.de/api/public/reporting/laendertabelle
1628907550,725,596,129,10,6,https://www.intensivregister.de/api/public/reporting/laendertabelle
1628911150,725,595,130,11,6,https://www.intensivregister.de/api/public/reporting/laendertabelle
1628914749,726,597,129,11,6,https://www.intensivregister.de/api/public/reporting/laendertabelle
1628918349,726,590,136,11,6,https://www.intensivregister.de/api/public/reporting/laendertabelle
1628921948,726,588,138,11,6,https://www.intensivregister.de/api/public/reporting/laendertabelle
1628929156,728,593,135,11,6,https://www.intensivregister.de/api/public/reporting/laendertabelle
1628993956,728,581,147,11,6,https://www.intensivregister.de/api/public/reporting/laendertabelle
1628997556,728,582,146,11,6,https://www.intensivregister.de/api/public/reporting/laendertabelle
1629001155,727,573,154,9,3,https://www.intensivregister.de/api/public/reporting/laendertabelle
1629004755,725,568,157,9,3,https://www.intensivregister.de/api/public/reporting/laendertabelle
1629008354,725,570,155,9,3,https://www.intensivregister.de/api/public/reporting/laendertabelle
1629040750,725,571,154,9,3,https://www.intensivregister.de/api/public/reporting/laendertabelle
1629080355,723,566,157,8,3,https://www.intensivregister.de/api/public/reporting/laendertabelle
1629083950,719,575,144,8,3,https://www.intensivregister.de/api/public/reporting/laendertabelle
1629087556,719,579,140,8,3,https://www.intensivregister.de/api/public/reporting/laendertabelle
1629091151,719,583,136,8,3,https://www.intensivregister.de/api/public/reporting/laendertabelle
1629094747,719,584,135,8,3,https://www.intensivregister.de/api/public/reporting/laendertabelle
1629105547,719,585,134,8,3,https://www.intensivregister.de/api/public/reporting/laendertabelle
1629137953,719,588,131,9,4,https://www.intensivregister.de/api/public/reporting/laendertabelle
1629145155,719,587,132,9,4,https://www.intensivregister.de/api/public/reporting/laendertabelle
1629152356,717,588,129,9,4,https://www.intensivregister.de/api/public/reporting/laendertabelle
1629166751,717,583,134,9,4,https://www.intensivregister.de/api/public/reporting/laendertabelle
1629170348,715,580,135,9,4,https://www.intensivregister.de/api/public/reporting/laendertabelle
1629173953,715,582,133,8,4,https://www.intensivregister.de/api/public/reporting/laendertabelle
1629177549,715,577,138,8,4,https://www.intensivregister.de/api/public/reporting/laendertabelle
1629181156,716,580,136,8,4,https://www.intensivregister.de/api/public/reporting/laendertabelle
1629184753,716,579,137,8,4,https://www.intensivregister.de/api/public/reporting/laendertabelle
1629245957,716,580,136,8,4,https://www.intensivregister.de/api/public/reporting/laendertabelle
1629253147,715,581,134,8,4,https://www.intensivregister.de/api/public/reporting/laendertabelle
1629256753,715,582,133,8,4,https://www.intensivregister.de/api/public/reporting/laendertabelle
1629260350,715,586,129,8,4,https://www.intensivregister.de/api/public/reporting/laendertabelle
1629263951,715,583,132,8,4,https://www.intensivregister.de/api/public/reporting/laendertabelle
1629267552,714,582,132,8,4,https://www.intensivregister.de/api/public/reporting/laendertabelle
1629271154,714,581,133,8,4,https://www.intensivregister.de/api/public/reporting/laendertabelle
1629317950,714,580,134,8,4,https://www.intensivregister.de/api/public/reporting/laendertabelle
1629339550,717,589,128,7,3,https://www.intensivregister.de/api/public/reporting/laendertabelle
1629343149,721,593,128,7,3,https://www.intensivregister.de/api/public/reporting/laendertabelle
1629346748,719,589,130,7,3,https://www.intensivregister.de/api/public/reporting/laendertabelle
1629350347,719,592,127,8,3,https://www.intensivregister.de/api/public/reporting/laendertabelle
1629357552,719,590,129,8,3,https://www.intensivregister.de/api/public/reporting/laendertabelle
1629422348,719,589,130,8,3,https://www.intensivregister.de/api/public/reporting/laendertabelle
1629425948,719,602,117,9,3,https://www.intensivregister.de/api/public/reporting/laendertabelle
1629429549,719,595,124,8,3,https://www.intensivregister.de/api/public/reporting/laendertabelle
1629433151,717,597,120,8,3,https://www.intensivregister.de/api/public/reporting/laendertabelle
1629436751,717,596,121,8,3,https://www.intensivregister.de/api/public/reporting/laendertabelle
1629440352,717,598,119,8,3,https://www.intensivregister.de/api/public/reporting/laendertabelle
1629443954,717,597,120,8,3,https://www.intensivregister.de/api/public/reporting/laendertabelle
1629512355,717,598,119,8,3,https://www.intensivregister.de/api/public/reporting/laendertabelle
1629515956,717,581,136,7,3,https://www.intensivregister.de/api/public/reporting/laendertabelle
1629519549,718,576,142,7,3,https://www.intensivregister.de/api/public/reporting/laendertabelle
1629523152,717,573,144,6,2,https://www.intensivregister.de/api/public/reporting/laendertabelle
1629595147,717,575,142,6,2,https://www.intensivregister.de/api/public/reporting/laendertabelle
1629598750,710,560,150,6,2,https://www.intensivregister.de/api/public/reporting/laendertabelle
1629605956,710,555,155,6,2,https://www.intensivregister.de/api/public/reporting/laendertabelle
1629609556,710,557,153,6,2,https://www.intensivregister.de/api/public/reporting/laendertabelle
1629613150,710,556,154,6,2,https://www.intensivregister.de/api/public/reporting/laendertabelle
1629616753,710,554,156,6,2,https://www.intensivregister.de/api/public/reporting/laendertabelle
1629620347,710,555,155,6,2,https://www.intensivregister.de/api/public/reporting/laendertabelle
1629638353,710,556,154,6,2,https://www.intensivregister.de/api/public/reporting/laendertabelle
1629652746,710,557,153,6,2,https://www.intensivregister.de/api/public/reporting/laendertabelle
1629670755,710,558,152,6,2,https://www.intensivregister.de/api/public/reporting/laendertabelle
1629685155,707,557,150,6,2,https://www.intensivregister.de/api/public/reporting/laendertabelle
1629688748,707,558,149,6,2,https://www.intensivregister.de/api/public/reporting/laendertabelle
1629692352,707,552,155,6,2,https://www.intensivregister.de/api/public/reporting/laendertabelle
1629695950,707,547,160,6,3,https://www.intensivregister.de/api/public/reporting/laendertabelle
1629699551,707,549,158,6,3,https://www.intensivregister.de/api/public/reporting/laendertabelle
1629749948,709,550,159,6,3,https://www.intensivregister.de/api/public/reporting/laendertabelle
1629767949,709,548,161,6,3,https://www.intensivregister.de/api/public/reporting/laendertabelle
1629771553,714,558,156,6,3,https://www.intensivregister.de/api/public/reporting/laendertabelle
1629775147,714,554,160,6,3,https://www.intensivregister.de/api/public/reporting/laendertabelle
1629778751,714,555,159,6,3,https://www.intensivregister.de/api/public/reporting/laendertabelle
1629782355,714,558,156,6,3,https://www.intensivregister.de/api/public/reporting/laendertabelle
1629785950,714,556,158,6,3,https://www.intensivregister.de/api/public/reporting/laendertabelle
1629793148,714,551,163,6,3,https://www.intensivregister.de/api/public/reporting/laendertabelle
1629854351,714,553,161,6,3,https://www.intensivregister.de/api/public/reporting/laendertabelle
1629857956,711,555,156,5,3,https://www.intensivregister.de/api/public/reporting/laendertabelle
1629861551,712,551,161,5,3,https://www.intensivregister.de/api/public/reporting/laendertabelle
1629868752,712,550,162,5,3,https://www.intensivregister.de/api/public/reporting/laendertabelle
1629872348,714,554,160,5,3,https://www.intensivregister.de/api/public/reporting/laendertabelle
1629922747,714,555,159,5,3,https://www.intensivregister.de/api/public/reporting/laendertabelle
1629944348,714,553,161,5,3,https://www.intensivregister.de/api/public/reporting/laendertabelle
1629947955,719,566,153,6,4,https://www.intensivregister.de/api/public/reporting/laendertabelle
1629951552,719,562,157,6,4,https://www.intensivregister.de/api/public/reporting/laendertabelle
1629955149,721,574,147,6,4,https://www.intensivregister.de/api/public/reporting/laendertabelle
1629962353,721,573,148,6,4,https://www.intensivregister.de/api/public/reporting/laendertabelle
1630023551,721,576,145,6,4,https://www.intensivregister.de/api/public/reporting/laendertabelle
1630030755,721,574,147,7,4,https://www.intensivregister.de/api/public/reporting/laendertabelle
1630034353,716,572,144,8,4,https://www.intensivregister.de/api/public/reporting/laendertabelle
1630041556,716,570,146,7,3,https://www.intensivregister.de/api/public/reporting/laendertabelle
1630048750,716,572,144,7,3,https://www.intensivregister.de/api/public/reporting/laendertabelle
1630095549,712,566,146,7,3,https://www.intensivregister.de/api/public/reporting/laendertabelle
1630117152,712,567,145,7,3,https://www.intensivregister.de/api/public/reporting/laendertabelle
1630120749,712,560,152,7,3,https://www.intensivregister.de/api/public/reporting/laendertabelle
1630127955,712,557,155,7,3,https://www.intensivregister.de/api/public/reporting/laendertabelle
1630131550,710,552,158,7,3,https://www.intensivregister.de/api/public/reporting/laendertabelle
1630135148,706,545,161,8,3,https://www.intensivregister.de/api/public/reporting/laendertabelle
1630138755,706,541,165,8,3,https://www.intensivregister.de/api/public/reporting/laendertabelle
1630181951,706,542,164,8,3,https://www.intensivregister.de/api/public/reporting/laendertabelle
1630199956,706,543,163,8,3,https://www.intensivregister.de/api/public/reporting/laendertabelle
1630203553,708,545,163,8,3,https://www.intensivregister.de/api/public/reporting/laendertabelle
1630207151,708,553,155,8,3,https://www.intensivregister.de/api/public/reporting/laendertabelle
1630210748,708,551,157,8,3,https://www.intensivregister.de/api/public/reporting/laendertabelle
1630214356,708,547,161,8,3,https://www.intensivregister.de/api/public/reporting/laendertabelle
1630217953,708,545,163,7,3,https://www.intensivregister.de/api/public/reporting/laendertabelle
1630289951,710,542,168,7,3,https://www.intensivregister.de/api/public/reporting/laendertabelle
1630297156,710,548,162,7,2,https://www.intensivregister.de/api/public/reporting/laendertabelle
1630300753,708,550,158,8,2,https://www.intensivregister.de/api/public/reporting/laendertabelle
1630304350,708,553,155,8,2,https://www.intensivregister.de/api/public/reporting/laendertabelle
1630307956,708,554,154,9,2,https://www.intensivregister.de/api/public/reporting/laendertabelle
1630322355,708,551,157,9,2,https://www.intensivregister.de/api/public/reporting/laendertabelle
1630365548,708,549,159,9,2,https://www.intensivregister.de/api/public/reporting/laendertabelle
1630372750,708,552,156,9,2,https://www.intensivregister.de/api/public/reporting/laendertabelle
1630376347,706,551,155,9,2,https://www.intensivregister.de/api/public/reporting/laendertabelle
1630379954,704,547,157,9,2,https://www.intensivregister.de/api/public/reporting/laendertabelle
1630383552,708,560,148,10,2,https://www.intensivregister.de/api/public/reporting/laendertabelle
1630387150,708,563,145,9,2,https://www.intensivregister.de/api/public/reporting/laendertabelle
1630390747,708,564,144,9,2,https://www.intensivregister.de/api/public/reporting/laendertabelle
1630459152,708,563,145,9,2,https://www.intensivregister.de/api/public/reporting/laendertabelle
1630466352,714,572,142,10,3,https://www.intensivregister.de/api/public/reporting/laendertabelle
1630469947,716,573,143,10,3,https://www.intensivregister.de/api/public/reporting/laendertabelle
1630473553,714,572,142,10,3,https://www.intensivregister.de/api/public/reporting/laendertabelle
1630477148,714,575,139,10,3,https://www.intensivregister.de/api/public/reporting/laendertabelle
1630484348,714,577,137,10,3,https://www.intensivregister.de/api/public/reporting/laendertabelle
1630487953,714,580,134,10,3,https://www.intensivregister.de/api/public/reporting/laendertabelle
1630531155,714,581,133,10,3,https://www.intensivregister.de/api/public/reporting/laendertabelle
1630549153,717,578,139,11,4,https://www.intensivregister.de/api/public/reporting/laendertabelle
1630552755,713,570,143,13,5,https://www.intensivregister.de/api/public/reporting/laendertabelle
1630559951,713,569,144,13,5,https://www.intensivregister.de/api/public/reporting/laendertabelle
1630563552,713,570,143,13,5,https://www.intensivregister.de/api/public/reporting/laendertabelle
1630567150,713,569,144,11,4,https://www.intensivregister.de/api/public/reporting/laendertabelle
1630574357,713,567,146,11,4,https://www.intensivregister.de/api/public/reporting/laendertabelle
1630617555,715,569,146,11,4,https://www.intensivregister.de/api/public/reporting/laendertabelle
1630631949,715,570,145,11,4,https://www.intensivregister.de/api/public/reporting/laendertabelle
1630635552,715,569,146,11,5,https://www.intensivregister.de/api/public/reporting/laendertabelle
1630639154,713,560,153,12,5,https://www.intensivregister.de/api/public/reporting/laendertabelle
1630642756,713,559,154,13,6,https://www.intensivregister.de/api/public/reporting/laendertabelle
1630646349,713,561,152,13,7,https://www.intensivregister.de/api/public/reporting/laendertabelle
1630649951,713,562,151,13,7,https://www.intensivregister.de/api/public/reporting/laendertabelle
1630657147,713,563,150,14,8,https://www.intensivregister.de/api/public/reporting/laendertabelle
1630718348,713,557,156,14,8,https://www.intensivregister.de/api/public/reporting/laendertabelle
1630725553,713,562,151,14,9,https://www.intensivregister.de/api/public/reporting/laendertabelle
1630729155,713,554,159,14,9,https://www.intensivregister.de/api/public/reporting/laendertabelle
1630732747,708,546,162,12,8,https://www.intensivregister.de/api/public/reporting/laendertabelle
1630736350,708,545,163,12,8,https://www.intensivregister.de/api/public/reporting/laendertabelle
1630739952,708,546,162,12,8,https://www.intensivregister.de/api/public/reporting/laendertabelle
1630793953,708,542,166,12,8,https://www.intensivregister.de/api/public/reporting/laendertabelle
1630801148,708,543,165,12,8,https://www.intensivregister.de/api/public/reporting/laendertabelle
1630811953,708,541,167,12,8,https://www.intensivregister.de/api/public/reporting/laendertabelle
1630815555,708,534,174,12,8,https://www.intensivregister.de/api/public/reporting/laendertabelle
1630819148,708,532,176,12,8,https://www.intensivregister.de/api/public/reporting/laendertabelle
1630822750,708,531,177,11,7,https://www.intensivregister.de/api/public/reporting/laendertabelle
1630826352,708,531,177,12,8,https://www.intensivregister.de/api/public/reporting/laendertabelle
1630891150,708,533,175,12,8,https://www.intensivregister.de/api/public/reporting/laendertabelle
1630894751,710,531,179,12,8,https://www.intensivregister.de/api/public/reporting/laendertabelle
1630898353,711,529,182,12,8,https://www.intensivregister.de/api/public/reporting/laendertabelle
1630901956,712,524,188,12,8,https://www.intensivregister.de/api/public/reporting/laendertabelle
1630905549,712,525,187,12,8,https://www.intensivregister.de/api/public/reporting/laendertabelle
1630909152,712,523,189,11,8,https://www.intensivregister.de/api/public/reporting/laendertabelle
1630912755,712,524,188,11,8,https://www.intensivregister.de/api/public/reporting/laendertabelle
1630937953,712,529,183,11,8,https://www.intensivregister.de/api/public/reporting/laendertabelle
1630959548,712,530,182,11,8,https://www.intensivregister.de/api/public/reporting/laendertabelle
1630977549,712,529,183,11,8,https://www.intensivregister.de/api/public/reporting/laendertabelle
1630981152,718,537,181,12,8,https://www.intensivregister.de/api/public/reporting/laendertabelle
1630984754,718,541,177,12,8,https://www.intensivregister.de/api/public/reporting/laendertabelle
1630991949,716,541,175,13,9,https://www.intensivregister.de/api/public/reporting/laendertabelle
1630995552,716,544,172,13,9,https://www.intensivregister.de/api/public/reporting/laendertabelle
1631013556,716,543,173,13,9,https://www.intensivregister.de/api/public/reporting/laendertabelle
1631045950,716,542,174,13,9,https://www.intensivregister.de/api/public/reporting/laendertabelle
1631067555,716,548,168,14,9,https://www.intensivregister.de/api/public/reporting/laendertabelle
1631071147,715,548,167,15,9,https://www.intensivregister.de/api/public/reporting/laendertabelle
1631074750,713,550,163,15,9,https://www.intensivregister.de/api/public/reporting/laendertabelle
1631078353,713,545,168,15,9,https://www.intensivregister.de/api/public/reporting/laendertabelle
1631081957,713,546,167,15,9,https://www.intensivregister.de/api/public/reporting/laendertabelle
1631092755,713,548,165,15,9,https://www.intensivregister.de/api/public/reporting/laendertabelle
1631135948,713,549,164,15,9,https://www.intensivregister.de/api/public/reporting/laendertabelle
1631146754,713,550,163,15,9,https://www.intensivregister.de/api/public/reporting/laendertabelle
1631150347,713,549,164,15,9,https://www.intensivregister.de/api/public/reporting/laendertabelle
1631153947,713,563,150,14,9,https://www.intensivregister.de/api/public/reporting/laendertabelle
1631157549,713,564,149,14,9,https://www.intensivregister.de/api/public/reporting/laendertabelle
1631164753,713,570,143,13,8,https://www.intensivregister.de/api/public/reporting/laendertabelle
1631168355,713,571,142,13,8,https://www.intensivregister.de/api/public/reporting/laendertabelle
1631186354,713,572,141,13,9,https://www.intensivregister.de/api/public/reporting/laendertabelle
1631225948,713,573,140,13,9,https://www.intensivregister.de/api/public/reporting/laendertabelle
1631240350,715,575,140,15,9,https://www.intensivregister.de/api/public/reporting/laendertabelle
1631243950,715,577,138,15,9,https://www.intensivregister.de/api/public/reporting/laendertabelle
1631247553,715,574,141,15,9,https://www.intensivregister.de/api/public/reporting/laendertabelle
1631251155,715,580,135,15,9,https://www.intensivregister.de/api/public/reporting/laendertabelle
1631254748,717,577,140,15,9,https://www.intensivregister.de/api/public/reporting/laendertabelle
1631258351,717,576,141,15,9,https://www.intensivregister.de/api/public/reporting/laendertabelle
1631326757,717,575,142,15,9,https://www.intensivregister.de/api/public/reporting/laendertabelle
1631330348,717,561,156,14,9,https://www.intensivregister.de/api/public/reporting/laendertabelle
1631333951,717,564,153,14,9,https://www.intensivregister.de/api/public/reporting/laendertabelle
1631337553,719,566,153,14,9,https://www.intensivregister.de/api/public/reporting/laendertabelle
1631341156,719,562,157,14,9,https://www.intensivregister.de/api/public/reporting/laendertabelle
1631395152,719,561,158,14,9,https://www.intensivregister.de/api/public/reporting/laendertabelle
1631413151,707,551,156,12,8,https://www.intensivregister.de/api/public/reporting/laendertabelle
1631416753,707,547,160,12,8,https://www.intensivregister.de/api/public/reporting/laendertabelle
1631420355,701,545,156,12,8,https://www.intensivregister.de/api/public/reporting/laendertabelle
1631423947,701,549,152,12,8,https://www.intensivregister.de/api/public/reporting/laendertabelle
1631477952,701,550,151,12,8,https://www.intensivregister.de/api/public/reporting/laendertabelle
1631499555,704,557,147,12,8,https://www.intensivregister.de/api/public/reporting/laendertabelle
1631506755,703,555,148,12,8,https://www.intensivregister.de/api/public/reporting/laendertabelle
1631510350,705,553,152,12,8,https://www.intensivregister.de/api/public/reporting/laendertabelle
1631513956,705,554,151,12,8,https://www.intensivregister.de/api/public/reporting/laendertabelle
1631517551,705,551,154,12,8,https://www.intensivregister.de/api/public/reporting/laendertabelle
1631567951,705,550,155,12,8,https://www.intensivregister.de/api/public/reporting/laendertabelle
1631571547,707,552,155,12,8,https://www.intensivregister.de/api/public/reporting/laendertabelle
1631582348,707,551,156,12,8,https://www.intensivregister.de/api/public/reporting/laendertabelle
1631585954,710,555,155,11,7,https://www.intensivregister.de/api/public/reporting/laendertabelle
1631589550,710,554,156,12,8,https://www.intensivregister.de/api/public/reporting/laendertabelle
1631593156,710,551,159,12,8,https://www.intensivregister.de/api/public/reporting/laendertabelle
1631596753,710,554,156,12,7,https://www.intensivregister.de/api/public/reporting/laendertabelle
1631600349,710,552,158,12,7,https://www.intensivregister.de/api/public/reporting/laendertabelle
1631603955,710,548,162,12,7,https://www.intensivregister.de/api/public/reporting/laendertabelle
1631614755,712,551,161,13,8,https://www.intensivregister.de/api/public/reporting/laendertabelle
1631672348,712,543,169,12,7,https://www.intensivregister.de/api/public/reporting/laendertabelle
1631675953,718,554,164,11,7,https://www.intensivregister.de/api/public/reporting/laendertabelle
1631679550,718,559,159,11,7,https://www.intensivregister.de/api/public/reporting/laendertabelle
1631683156,716,561,155,11,7,https://www.intensivregister.de/api/public/reporting/laendertabelle
1631686752,716,562,154,11,7,https://www.intensivregister.de/api/public/reporting/laendertabelle
1631690350,716,559,157,11,7,https://www.intensivregister.de/api/public/reporting/laendertabelle
1631737150,716,561,155,11,7,https://www.intensivregister.de/api/public/reporting/laendertabelle
1631747952,716,559,157,11,7,https://www.intensivregister.de/api/public/reporting/laendertabelle
1631755152,716,560,156,11,7,https://www.intensivregister.de/api/public/reporting/laendertabelle
1631758753,716,557,159,13,7,https://www.intensivregister.de/api/public/reporting/laendertabelle
1631762354,715,556,159,13,7,https://www.intensivregister.de/api/public/reporting/laendertabelle
1631765957,715,557,158,13,7,https://www.intensivregister.de/api/public/reporting/laendertabelle
1631769547,715,556,159,13,7,https://www.intensivregister.de/api/public/reporting/laendertabelle
1631773148,717,555,162,14,7,https://www.intensivregister.de/api/public/reporting/laendertabelle
1631776749,717,554,163,14,7,https://www.intensivregister.de/api/public/reporting/laendertabelle
1631830754,716,552,164,14,7,https://www.intensivregister.de/api/public/reporting/laendertabelle
1631845149,716,547,169,13,7,https://www.intensivregister.de/api/public/reporting/laendertabelle
1631848749,716,549,167,12,7,https://www.intensivregister.de/api/public/reporting/laendertabelle
1631852351,716,551,165,12,7,https://www.intensivregister.de/api/public/reporting/laendertabelle
1631855952,716,550,166,13,7,https://www.intensivregister.de/api/public/reporting/laendertabelle
1631859553,714,551,163,12,7,https://www.intensivregister.de/api/public/reporting/laendertabelle
1631863155,714,556,158,12,7,https://www.intensivregister.de/api/public/reporting/laendertabelle
1631870349,714,559,155,12,7,https://www.intensivregister.de/api/public/reporting/laendertabelle
1631935149,714,558,156,12,7,https://www.intensivregister.de/api/public/reporting/laendertabelle
1631938749,712,549,163,11,8,https://www.intensivregister.de/api/public/reporting/laendertabelle
1631942351,712,550,162,11,8,https://www.intensivregister.de/api/public/reporting/laendertabelle
1631945951,713,551,162,13,8,https://www.intensivregister.de/api/public/reporting/laendertabelle
1631949552,713,551,162,14,8,https://www.intensivregister.de/api/public/reporting/laendertabelle
1631953153,713,553,160,14,8,https://www.intensivregister.de/api/public/reporting/laendertabelle
1631956753,713,555,158,14,8,https://www.intensivregister.de/api/public/reporting/laendertabelle
1632017956,713,554,159,15,8,https://www.intensivregister.de/api/public/reporting/laendertabelle
1632021548,713,548,165,16,8,https://www.intensivregister.de/api/public/reporting/laendertabelle
1632025148,713,549,164,14,6,https://www.intensivregister.de/api/public/reporting/laendertabelle
1632028751,713,545,168,14,6,https://www.intensivregister.de/api/public/reporting/laendertabelle
1632032352,715,539,176,15,6,https://www.intensivregister.de/api/public/reporting/laendertabelle
1632035952,715,533,182,15,6,https://www.intensivregister.de/api/public/reporting/laendertabelle
1632050349,715,531,184,15,6,https://www.intensivregister.de/api/public/reporting/laendertabelle
1632104350,715,529,186,15,6,https://www.intensivregister.de/api/public/reporting/laendertabelle
1632107952,715,534,181,15,6,https://www.intensivregister.de/api/public/reporting/laendertabelle
1632111554,711,538,173,15,6,https://www.intensivregister.de/api/public/reporting/laendertabelle
1632115156,711,534,177,14,7,https://www.intensivregister.de/api/public/reporting/laendertabelle
1632118748,711,537,174,14,7,https://www.intensivregister.de/api/public/reporting/laendertabelle
1632122350,705,539,166,15,7,https://www.intensivregister.de/api/public/reporting/laendertabelle
1632133148,705,538,167,15,7,https://www.intensivregister.de/api/public/reporting/laendertabelle
1632169152,705,539,166,15,7,https://www.intensivregister.de/api/public/reporting/laendertabelle
1632190755,705,531,174,18,8,https://www.intensivregister.de/api/public/reporting/laendertabelle
1632194347,706,527,179,18,8,https://www.intensivregister.de/api/public/reporting/laendertabelle
1632201549,706,532,174,19,8,https://www.intensivregister.de/api/public/reporting/laendertabelle
1632205150,704,529,175,19,8,https://www.intensivregister.de/api/public/reporting/laendertabelle
1632259154,704,530,174,19,8,https://www.intensivregister.de/api/public/reporting/laendertabelle
1632273552,704,529,175,19,8,https://www.intensivregister.de/api/public/reporting/laendertabelle
1632277150,711,535,176,18,7,https://www.intensivregister.de/api/public/reporting/laendertabelle
1632280747,709,529,180,19,7,https://www.intensivregister.de/api/public/reporting/laendertabelle
1632284354,707,538,169,19,7,https://www.intensivregister.de/api/public/reporting/laendertabelle
1632291549,707,544,163,19,7,https://www.intensivregister.de/api/public/reporting/laendertabelle
1632295147,707,547,160,19,7,https://www.intensivregister.de/api/public/reporting/laendertabelle
1632309548,707,548,159,19,7,https://www.intensivregister.de/api/public/reporting/laendertabelle
1632345551,707,547,160,19,7,https://www.intensivregister.de/api/public/reporting/laendertabelle
1632363548,709,557,152,17,6,https://www.intensivregister.de/api/public/reporting/laendertabelle
1632367155,709,562,147,15,6,https://www.intensivregister.de/api/public/reporting/laendertabelle
1632370752,709,561,148,15,6,https://www.intensivregister.de/api/public/reporting/laendertabelle
1632374349,709,563,146,15,6,https://www.intensivregister.de/api/public/reporting/laendertabelle
1632377947,709,563,146,16,6,https://www.intensivregister.de/api/public/reporting/laendertabelle
1632446353,709,564,145,16,6,https://www.intensivregister.de/api/public/reporting/laendertabelle
1632449953,711,561,150,14,4,https://www.intensivregister.de/api/public/reporting/laendertabelle
1632453554,711,557,154,16,4,https://www.intensivregister.de/api/public/reporting/laendertabelle
1632457154,710,555,155,17,5,https://www.intensivregister.de/api/public/reporting/laendertabelle
1632460755,710,556,154,17,5,https://www.intensivregister.de/api/public/reporting/laendertabelle
1632464347,710,557,153,17,5,https://www.intensivregister.de/api/public/reporting/laendertabelle
1632467947,710,558,152,17,5,https://www.intensivregister.de/api/public/reporting/laendertabelle
1632521956,710,560,150,17,5,https://www.intensivregister.de/api/public/reporting/laendertabelle
1632536349,708,555,153,15,5,https://www.intensivregister.de/api/public/reporting/laendertabelle
1632539947,708,550,158,14,5,https://www.intensivregister.de/api/public/reporting/laendertabelle
1632543555,708,561,147,17,6,https://www.intensivregister.de/api/public/reporting/laendertabelle
1632547153,708,560,148,17,6,https://www.intensivregister.de/api/public/reporting/laendertabelle
1632550752,705,558,147,15,5,https://www.intensivregister.de/api/public/reporting/laendertabelle
1632554350,705,560,145,15,5,https://www.intensivregister.de/api/public/reporting/laendertabelle
1632557949,705,558,147,15,5,https://www.intensivregister.de/api/public/reporting/laendertabelle
1632601147,705,557,148,15,5,https://www.intensivregister.de/api/public/reporting/laendertabelle
1632615549,705,549,156,16,5,https://www.intensivregister.de/api/public/reporting/laendertabelle
1632622755,704,546,158,16,5,https://www.intensivregister.de/api/public/reporting/laendertabelle
1632626353,704,539,165,16,5,https://www.intensivregister.de/api/public/reporting/laendertabelle
1632629951,702,538,164,17,6,https://www.intensivregister.de/api/public/reporting/laendertabelle
1632633549,703,539,164,18,7,https://www.intensivregister.de/api/public/reporting/laendertabelle
1632637147,703,537,166,17,6,https://www.intensivregister.de/api/public/reporting/laendertabelle
1632640755,703,535,168,17,6,https://www.intensivregister.de/api/public/reporting/laendertabelle
1632698356,703,537,166,17,6,https://www.intensivregister.de/api/public/reporting/laendertabelle
1632709151,703,535,168,14,3,https://www.intensivregister.de/api/public/reporting/laendertabelle
1632712750,703,527,176,14,3,https://www.intensivregister.de/api/public/reporting/laendertabelle
1632716349,705,545,160,14,5,https://www.intensivregister.de/api/public/reporting/laendertabelle
1632723548,705,540,165,14,5,https://www.intensivregister.de/api/public/reporting/laendertabelle
1632727147,705,542,163,14,5,https://www.intensivregister.de/api/public/reporting/laendertabelle
1632784753,705,543,162,14,5,https://www.intensivregister.de/api/public/reporting/laendertabelle
1632791950,705,542,163,14,5,https://www.intensivregister.de/api/public/reporting/laendertabelle
1632795548,705,545,160,14,5,https://www.intensivregister.de/api/public/reporting/laendertabelle
1632799155,706,545,161,14,5,https://www.intensivregister.de/api/public/reporting/laendertabelle
1632802753,703,542,161,14,5,https://www.intensivregister.de/api/public/reporting/laendertabelle
1632809947,701,544,157,14,5,https://www.intensivregister.de/api/public/reporting/laendertabelle
1632813554,701,547,154,14,5,https://www.intensivregister.de/api/public/reporting/laendertabelle
1632871156,701,549,152,14,5,https://www.intensivregister.de/api/public/reporting/laendertabelle
1632881955,706,568,138,15,5,https://www.intensivregister.de/api/public/reporting/laendertabelle
1632885555,706,563,143,17,5,https://www.intensivregister.de/api/public/reporting/laendertabelle
1632889155,708,558,150,17,5,https://www.intensivregister.de/api/public/reporting/laendertabelle
1632899948,708,561,147,17,5,https://www.intensivregister.de/api/public/reporting/laendertabelle
1632903549,708,563,145,17,5,https://www.intensivregister.de/api/public/reporting/laendertabelle
1632977916,714,574,140,16,5,https://www.intensivregister.de/api/public/reporting/laendertabelle
1632986349,714,575,139,16,5,https://www.intensivregister.de/api/public/reporting/laendertabelle
1633000756,714,574,140,16,5,https://www.intensivregister.de/api/public/reporting/laendertabelle
1633000756,714,572,142,16,5,https://www.intensivregister.de/api/public/reporting/laendertabelle
1633000756,714,575,139,16,5,https://www.intensivregister.de/api/public/reporting/laendertabelle
1633000756,712,569,143,16,5,https://www.intensivregister.de/api/public/reporting/laendertabelle
1633062783,710,576,134,16,5,https://www.intensivregister.de/api/public/reporting/laendertabelle
1633119316,710,575,135,16,5,https://www.intensivregister.de/api/public/reporting/laendertabelle
1633144513,710,560,150,17,6,https://www.intensivregister.de/api/public/reporting/laendertabelle
1633148110,710,563,147,16,6,https://www.intensivregister.de/api/public/reporting/laendertabelle
1633148110,706,561,145,16,6,https://www.intensivregister.de/api/public/reporting/laendertabelle
1633155309,702,557,145,16,6,https://www.intensivregister.de/api/public/reporting/laendertabelle
1633158911,702,560,142,16,6,https://www.intensivregister.de/api/public/reporting/laendertabelle
1633191312,702,559,143,16,6,https://www.intensivregister.de/api/public/reporting/laendertabelle
1633227316,700,553,147,16,6,https://www.intensivregister.de/api/public/reporting/laendertabelle
1633230908,701,550,151,16,6,https://www.intensivregister.de/api/public/reporting/laendertabelle
1633238114,696,540,156,16,6,https://www.intensivregister.de/api/public/reporting/laendertabelle
1633241714,696,530,166,16,6,https://www.intensivregister.de/api/public/reporting/laendertabelle
1633245313,696,527,169,16,6,https://www.intensivregister.de/api/public/reporting/laendertabelle
1633292108,696,526,170,16,6,https://www.intensivregister.de/api/public/reporting/laendertabelle
1633310113,697,529,168,16,6,https://www.intensivregister.de/api/public/reporting/laendertabelle
1633313709,697,531,166,17,6,https://www.intensivregister.de/api/public/reporting/laendertabelle
1633317313,696,529,167,21,6,https://www.intensivregister.de/api/public/reporting/laendertabelle
1633320911,694,528,166,22,7,https://www.intensivregister.de/api/public/reporting/laendertabelle
1633324514,694,530,164,22,7,https://www.intensivregister.de/api/public/reporting/laendertabelle
1633328110,693,527,166,22,7,https://www.intensivregister.de/api/public/reporting/laendertabelle
1633328110,697,538,159,22,7,https://www.intensivregister.de/api/public/reporting/laendertabelle
1633338911,697,533,164,22,7,https://www.intensivregister.de/api/public/reporting/laendertabelle
1633396515,696,532,164,23,7,https://www.intensivregister.de/api/public/reporting/laendertabelle
1633400109,700,550,150,26,8,https://www.intensivregister.de/api/public/reporting/laendertabelle
1633403714,701,553,148,26,8,https://www.intensivregister.de/api/public/reporting/laendertabelle
1633407313,703,560,143,27,8,https://www.intensivregister.de/api/public/reporting/laendertabelle
1633414513,703,561,142,27,8,https://www.intensivregister.de/api/public/reporting/laendertabelle
1633414513,703,564,139,27,8,https://www.intensivregister.de/api/public/reporting/laendertabelle
1633472114,703,567,136,28,8,https://www.intensivregister.de/api/public/reporting/laendertabelle
1633486511,705,571,134,27,8,https://www.intensivregister.de/api/public/reporting/laendertabelle
1633490109,704,580,124,29,10,https://www.intensivregister.de/api/public/reporting/laendertabelle
1633493718,704,578,126,28,10,https://www.intensivregister.de/api/public/reporting/laendertabelle
1633497310,704,577,127,28,10,https://www.intensivregister.de/api/public/reporting/laendertabelle
1633558508,704,576,128,28,10,https://www.intensivregister.de/api/public/reporting/laendertabelle
1633569315,704,575,129,28,10,https://www.intensivregister.de/api/public/reporting/laendertabelle
1633572912,704,573,131,28,10,https://www.intensivregister.de/api/public/reporting/laendertabelle
1633576508,710,567,143,25,11,https://www.intensivregister.de/api/public/reporting/laendertabelle
1633580117,710,564,146,26,11,https://www.intensivregister.de/api/public/reporting/laendertabelle
1633583712,712,572,140,26,11,https://www.intensivregister.de/api/public/reporting/laendertabelle
1633587309,712,571,141,26,11,https://www.intensivregister.de/api/public/reporting/laendertabelle
1633590915,712,575,137,26,11,https://www.intensivregister.de/api/public/reporting/laendertabelle
1633641308,712,573,139,26,11,https://www.intensivregister.de/api/public/reporting/laendertabelle
1633655717,712,575,137,26,11,https://www.intensivregister.de/api/public/reporting/laendertabelle
1633659314,712,574,138,25,11,https://www.intensivregister.de/api/public/reporting/laendertabelle
1633662911,715,574,141,26,12,https://www.intensivregister.de/api/public/reporting/laendertabelle
1633666511,714,578,136,26,11,https://www.intensivregister.de/api/public/reporting/laendertabelle
1633666511,714,581,133,26,11,https://www.intensivregister.de/api/public/reporting/laendertabelle
1633673715,714,583,131,27,11,https://www.intensivregister.de/api/public/reporting/laendertabelle
1633677313,714,582,132,27,11,https://www.intensivregister.de/api/public/reporting/laendertabelle
1633724115,714,583,131,27,11,https://www.intensivregister.de/api/public/reporting/laendertabelle
1633731311,714,582,132,27,11,https://www.intensivregister.de/api/public/reporting/laendertabelle
1633745710,714,578,136,26,11,https://www.intensivregister.de/api/public/reporting/laendertabelle
1633745710,714,575,139,25,11,https://www.intensivregister.de/api/public/reporting/laendertabelle
1633752918,711,569,142,26,12,https://www.intensivregister.de/api/public/reporting/laendertabelle
1633756512,711,569,142,25,11,https://www.intensivregister.de/api/public/reporting/laendertabelle
1633760110,711,567,144,25,11,https://www.intensivregister.de/api/public/reporting/laendertabelle
1633763708,705,567,138,27,12,https://www.intensivregister.de/api/public/reporting/laendertabelle
1633821312,705,566,139,27,12,https://www.intensivregister.de/api/public/reporting/laendertabelle
1633828514,705,568,137,27,12,https://www.intensivregister.de/api/public/reporting/laendertabelle
1633832111,705,564,141,28,13,https://www.intensivregister.de/api/public/reporting/laendertabelle
1633835708,705,563,142,28,13,https://www.intensivregister.de/api/public/reporting/laendertabelle
1633839321,700,555,145,28,13,https://www.intensivregister.de/api/public/reporting/laendertabelle
1633842911,700,556,144,30,15,https://www.intensivregister.de/api/public/reporting/laendertabelle
1633846508,699,556,143,30,15,https://www.intensivregister.de/api/public/reporting/laendertabelle
1633896909,698,557,141,30,15,https://www.intensivregister.de/api/public/reporting/laendertabelle
1633914910,698,558,140,31,15,https://www.intensivregister.de/api/public/reporting/laendertabelle
1633914910,698,558,140,30,14,https://www.intensivregister.de/api/public/reporting/laendertabelle
1633922114,700,558,142,31,14,https://www.intensivregister.de/api/public/reporting/laendertabelle
1633925713,700,556,144,31,14,https://www.intensivregister.de/api/public/reporting/laendertabelle
1633929308,701,556,145,31,14,https://www.intensivregister.de/api/public/reporting/laendertabelle
1633932915,702,555,147,31,14,https://www.intensivregister.de/api/public/reporting/laendertabelle
1633936513,702,560,142,30,14,https://www.intensivregister.de/api/public/reporting/laendertabelle
1633983309,702,562,140,31,14,https://www.intensivregister.de/api/public/reporting/laendertabelle
1633986916,703,567,136,31,14,https://www.intensivregister.de/api/public/reporting/laendertabelle
1634004915,703,573,130,32,14,https://www.intensivregister.de/api/public/reporting/laendertabelle
1634008511,706,580,126,33,14,https://www.intensivregister.de/api/public/reporting/laendertabelle
1634012114,708,588,120,34,15,https://www.intensivregister.de/api/public/reporting/laendertabelle
1634015715,704,583,121,36,16,https://www.intensivregister.de/api/public/reporting/laendertabelle
1634019312,704,582,122,36,16,https://www.intensivregister.de/api/public/reporting/laendertabelle
1634087738,704,579,125,36,16,https://www.intensivregister.de/api/public/reporting/laendertabelle
1634091310,709,583,126,36,17,https://www.intensivregister.de/api/public/reporting/laendertabelle
1634094916,709,586,123,38,18,https://www.intensivregister.de/api/public/reporting/laendertabelle
1634098515,709,579,130,36,14,https://www.intensivregister.de/api/public/reporting/laendertabelle
1634102114,709,579,130,37,14,https://www.intensivregister.de/api/public/reporting/laendertabelle
1634105713,709,578,131,38,14,https://www.intensivregister.de/api/public/reporting/laendertabelle
1634105713,709,573,136,37,14,https://www.intensivregister.de/api/public/reporting/laendertabelle
1634177708,709,569,140,38,15,https://www.intensivregister.de/api/public/reporting/laendertabelle
1634181313,706,569,137,37,14,https://www.intensivregister.de/api/public/reporting/laendertabelle
1634184912,709,572,137,37,15,https://www.intensivregister.de/api/public/reporting/laendertabelle
1634184912,709,570,139,37,15,https://www.intensivregister.de/api/public/reporting/laendertabelle
1634192113,709,576,133,38,15,https://www.intensivregister.de/api/public/reporting/laendertabelle
1634199314,709,577,132,38,15,https://www.intensivregister.de/api/public/reporting/laendertabelle
1634206516,709,576,133,38,15,https://www.intensivregister.de/api/public/reporting/laendertabelle
1634260515,709,575,134,38,14,https://www.intensivregister.de/api/public/reporting/laendertabelle
1634267716,706,570,136,36,14,https://www.intensivregister.de/api/public/reporting/laendertabelle
1634271315,708,577,131,36,14,https://www.intensivregister.de/api/public/reporting/laendertabelle
1634274908,708,577,131,35,14,https://www.intensivregister.de/api/public/reporting/laendertabelle
1634278513,708,575,133,35,14,https://www.intensivregister.de/api/public/reporting/laendertabelle
1634282110,708,577,131,35,14,https://www.intensivregister.de/api/public/reporting/laendertabelle
1634300114,708,580,128,35,14,https://www.intensivregister.de/api/public/reporting/laendertabelle
1634328913,708,584,124,36,16,https://www.intensivregister.de/api/public/reporting/laendertabelle
1634332512,708,583,125,36,16,https://www.intensivregister.de/api/public/reporting/laendertabelle
1634350513,708,585,123,36,16,https://www.intensivregister.de/api/public/reporting/laendertabelle
1634354113,709,585,124,36,16,https://www.intensivregister.de/api/public/reporting/laendertabelle
1634357716,708,579,129,36,16,https://www.intensivregister.de/api/public/reporting/laendertabelle
1634361312,708,578,130,37,16,https://www.intensivregister.de/api/public/reporting/laendertabelle
1634364912,708,576,132,38,16,https://www.intensivregister.de/api/public/reporting/laendertabelle
1634368512,703,571,132,39,17,https://www.intensivregister.de/api/public/reporting/laendertabelle
1634386509,703,572,131,39,17,https://www.intensivregister.de/api/public/reporting/laendertabelle
1634436914,703,571,132,40,17,https://www.intensivregister.de/api/public/reporting/laendertabelle
1634440513,703,572,131,39,17,https://www.intensivregister.de/api/public/reporting/laendertabelle
1634444117,699,566,133,39,17,https://www.intensivregister.de/api/public/reporting/laendertabelle
1634447714,699,569,130,39,18,https://www.intensivregister.de/api/public/reporting/laendertabelle
1634451314,693,560,133,38,17,https://www.intensivregister.de/api/public/reporting/laendertabelle
1634454914,692,562,130,38,17,https://www.intensivregister.de/api/public/reporting/laendertabelle
1634462113,692,563,129,38,17,https://www.intensivregister.de/api/public/reporting/laendertabelle
1634476513,692,561,131,37,17,https://www.intensivregister.de/api/public/reporting/laendertabelle
1634501714,692,563,129,37,17,https://www.intensivregister.de/api/public/reporting/laendertabelle
1634516114,692,562,130,37,17,https://www.intensivregister.de/api/public/reporting/laendertabelle
1634519713,692,564,128,37,17,https://www.intensivregister.de/api/public/reporting/laendertabelle
1634523312,692,558,134,36,15,https://www.intensivregister.de/api/public/reporting/laendertabelle
1634526911,692,555,137,36,15,https://www.intensivregister.de/api/public/reporting/laendertabelle
1634530515,693,557,136,37,15,https://www.intensivregister.de/api/public/reporting/laendertabelle
1634534112,693,555,138,37,15,https://www.intensivregister.de/api/public/reporting/laendertabelle
1634541310,693,557,136,37,15,https://www.intensivregister.de/api/public/reporting/laendertabelle
1634591714,693,556,137,37,15,https://www.intensivregister.de/api/public/reporting/laendertabelle
1634606114,701,563,138,38,15,https://www.intensivregister.de/api/public/reporting/laendertabelle
1634609713,707,576,131,39,16,https://www.intensivregister.de/api/public/reporting/laendertabelle
1634613312,709,570,139,39,16,https://www.intensivregister.de/api/public/reporting/laendertabelle
1634616915,709,569,140,39,15,https://www.intensivregister.de/api/public/reporting/laendertabelle
1634620512,709,571,138,39,15,https://www.intensivregister.de/api/public/reporting/laendertabelle
1634627714,709,570,139,39,15,https://www.intensivregister.de/api/public/reporting/laendertabelle
1634638516,709,571,138,39,15,https://www.intensivregister.de/api/public/reporting/laendertabelle
1634656508,709,571,138,38,15,https://www.intensivregister.de/api/public/reporting/laendertabelle
1634670907,709,571,138,39,15,https://www.intensivregister.de/api/public/reporting/laendertabelle
1634670907,709,572,137,39,15,https://www.intensivregister.de/api/public/reporting/laendertabelle
1634692508,709,570,139,38,15,https://www.intensivregister.de/api/public/reporting/laendertabelle
1634696114,709,575,134,39,16,https://www.intensivregister.de/api/public/reporting/laendertabelle
1634699711,709,579,130,41,16,https://www.intensivregister.de/api/public/reporting/laendertabelle
1634703311,707,578,129,41,16,https://www.intensivregister.de/api/public/reporting/laendertabelle
1634706915,706,580,126,41,16,https://www.intensivregister.de/api/public/reporting/laendertabelle
1634710513,706,579,127,41,16,https://www.intensivregister.de/api/public/reporting/laendertabelle
1634717708,706,579,127,40,15,https://www.intensivregister.de/api/public/reporting/laendertabelle
1634735715,706,578,128,40,15,https://www.intensivregister.de/api/public/reporting/laendertabelle
1634760908,706,579,127,40,15,https://www.intensivregister.de/api/public/reporting/laendertabelle
1634775309,706,578,128,40,15,https://www.intensivregister.de/api/public/reporting/laendertabelle
1634782511,705,571,134,42,16,https://www.intensivregister.de/api/public/reporting/laendertabelle
1634786113,705,573,132,40,16,https://www.intensivregister.de/api/public/reporting/laendertabelle
1634789719,705,574,131,40,16,https://www.intensivregister.de/api/public/reporting/laendertabelle
1634793308,705,572,133,40,16,https://www.intensivregister.de/api/public/reporting/laendertabelle
1634796911,706,573,133,41,16,https://www.intensivregister.de/api/public/reporting/laendertabelle
1634800514,706,577,129,43,17,https://www.intensivregister.de/api/public/reporting/laendertabelle
1634818511,706,576,130,42,17,https://www.intensivregister.de/api/public/reporting/laendertabelle
1634858116,706,575,131,42,17,https://www.intensivregister.de/api/public/reporting/laendertabelle
1634868914,710,589,121,44,16,https://www.intensivregister.de/api/public/reporting/laendertabelle
1634868914,710,593,117,44,16,https://www.intensivregister.de/api/public/reporting/laendertabelle
1634876112,707,589,118,46,16,https://www.intensivregister.de/api/public/reporting/laendertabelle
1634876112,707,593,114,46,16,https://www.intensivregister.de/api/public/reporting/laendertabelle
1634894116,707,593,114,47,16,https://www.intensivregister.de/api/public/reporting/laendertabelle
1634930113,707,594,113,47,16,https://www.intensivregister.de/api/public/reporting/laendertabelle
1634940916,707,595,112,47,16,https://www.intensivregister.de/api/public/reporting/laendertabelle
1634948114,706,594,112,49,16,https://www.intensivregister.de/api/public/reporting/laendertabelle
1634955312,706,593,113,49,16,https://www.intensivregister.de/api/public/reporting/laendertabelle
1634958916,700,577,123,49,18,https://www.intensivregister.de/api/public/reporting/laendertabelle
1634962513,703,572,131,50,16,https://www.intensivregister.de/api/public/reporting/laendertabelle
1634966115,703,573,130,50,17,https://www.intensivregister.de/api/public/reporting/laendertabelle
1634969708,705,572,133,50,17,https://www.intensivregister.de/api/public/reporting/laendertabelle
1634973313,705,572,133,51,18,https://www.intensivregister.de/api/public/reporting/laendertabelle
1634980512,705,567,138,51,18,https://www.intensivregister.de/api/public/reporting/laendertabelle
1635038112,706,564,142,51,18,https://www.intensivregister.de/api/public/reporting/laendertabelle
1635045312,703,563,140,52,19,https://www.intensivregister.de/api/public/reporting/laendertabelle
1635052512,702,561,141,50,18,https://www.intensivregister.de/api/public/reporting/laendertabelle
1635056108,702,565,137,50,18,https://www.intensivregister.de/api/public/reporting/laendertabelle
1635124516,702,568,134,50,18,https://www.intensivregister.de/api/public/reporting/laendertabelle
1635128111,702,573,129,51,19,https://www.intensivregister.de/api/public/reporting/laendertabelle
1635131716,703,578,125,53,18,https://www.intensivregister.de/api/public/reporting/laendertabelle
1635135314,699,573,126,53,18,https://www.intensivregister.de/api/public/reporting/laendertabelle
1635135314,699,575,124,53,18,https://www.intensivregister.de/api/public/reporting/laendertabelle
1635142512,699,574,125,52,18,https://www.intensivregister.de/api/public/reporting/laendertabelle
1635142512,699,577,122,51,18,https://www.intensivregister.de/api/public/reporting/laendertabelle
1635149714,699,579,120,51,18,https://www.intensivregister.de/api/public/reporting/laendertabelle
1635153310,699,579,120,52,17,https://www.intensivregister.de/api/public/reporting/laendertabelle
1635156915,699,578,121,53,18,https://www.intensivregister.de/api/public/reporting/laendertabelle
1635203715,699,579,120,53,18,https://www.intensivregister.de/api/public/reporting/laendertabelle
1635214510,700,587,113,49,17,https://www.intensivregister.de/api/public/reporting/laendertabelle
1635218115,697,589,108,49,16,https://www.intensivregister.de/api/public/reporting/laendertabelle
1635221713,697,591,106,51,16,https://www.intensivregister.de/api/public/reporting/laendertabelle
1635225315,697,592,105,50,16,https://www.intensivregister.de/api/public/reporting/laendertabelle
1635228912,697,591,106,49,16,https://www.intensivregister.de/api/public/reporting/laendertabelle
1635232516,697,590,107,49,16,https://www.intensivregister.de/api/public/reporting/laendertabelle
1635236112,697,587,110,49,16,https://www.intensivregister.de/api/public/reporting/laendertabelle
1635264915,697,585,112,49,16,https://www.intensivregister.de/api/public/reporting/laendertabelle
1635279316,697,586,111,49,16,https://www.intensivregister.de/api/public/reporting/laendertabelle
1635300911,694,589,105,50,17,https://www.intensivregister.de/api/public/reporting/laendertabelle
1635304513,690,585,105,50,17,https://www.intensivregister.de/api/public/reporting/laendertabelle
1635308119,694,587,107,51,17,https://www.intensivregister.de/api/public/reporting/laendertabelle
1635311716,691,584,107,52,19,https://www.intensivregister.de/api/public/reporting/laendertabelle
1635315309,695,587,108,53,20,https://www.intensivregister.de/api/public/reporting/laendertabelle
1635318910,695,588,107,53,20,https://www.intensivregister.de/api/public/reporting/laendertabelle
1635322512,695,587,108,54,20,https://www.intensivregister.de/api/public/reporting/laendertabelle
1635336909,697,589,108,56,21,https://www.intensivregister.de/api/public/reporting/laendertabelle
1635354917,693,592,101,57,21,https://www.intensivregister.de/api/public/reporting/laendertabelle
1635376513,693,593,100,57,21,https://www.intensivregister.de/api/public/reporting/laendertabelle
1635383716,693,592,101,57,21,https://www.intensivregister.de/api/public/reporting/laendertabelle
1635390908,694,587,107,59,20,https://www.intensivregister.de/api/public/reporting/laendertabelle
1635394513,694,586,108,60,20,https://www.intensivregister.de/api/public/reporting/laendertabelle
1635398111,695,588,107,64,21,https://www.intensivregister.de/api/public/reporting/laendertabelle
1635401713,695,592,103,65,22,https://www.intensivregister.de/api/public/reporting/laendertabelle
1635405313,694,594,100,66,22,https://www.intensivregister.de/api/public/reporting/laendertabelle
1635488112,694,601,93,69,22,https://www.intensivregister.de/api/public/reporting/laendertabelle
1635512412,694,602,92,69,22,https://www.intensivregister.de/api/public/reporting/laendertabelle
1635526809,694,600,94,69,22,https://www.intensivregister.de/api/public/reporting/laendertabelle
1635559210,694,593,101,68,22,https://www.intensivregister.de/api/public/reporting/laendertabelle
1635562809,694,590,104,67,22,https://www.intensivregister.de/api/public/reporting/laendertabelle
1635566114,694,588,106,68,21,https://www.intensivregister.de/api/public/reporting/laendertabelle
1635569714,696,586,110,72,24,https://www.intensivregister.de/api/public/reporting/laendertabelle
1635573615,697,589,108,72,27,https://www.intensivregister.de/api/public/reporting/laendertabelle
1635577215,697,588,109,71,28,https://www.intensivregister.de/api/public/reporting/laendertabelle
1635613213,695,588,107,72,28,https://www.intensivregister.de/api/public/reporting/laendertabelle
1635627615,695,587,108,72,28,https://www.intensivregister.de/api/public/reporting/laendertabelle
1635656410,695,589,106,73,29,https://www.intensivregister.de/api/public/reporting/laendertabelle
1635660012,693,587,106,73,29,https://www.intensivregister.de/api/public/reporting/laendertabelle
1635663615,693,583,110,75,31,https://www.intensivregister.de/api/public/reporting/laendertabelle
1635667216,692,580,112,76,31,https://www.intensivregister.de/api/public/reporting/laendertabelle
1635670809,695,580,115,75,32,https://www.intensivregister.de/api/public/reporting/laendertabelle
1635674411,695,579,116,75,32,https://www.intensivregister.de/api/public/reporting/laendertabelle
1635677710,695,577,118,75,32,https://www.intensivregister.de/api/public/reporting/laendertabelle
1635738910,693,572,121,75,31,https://www.intensivregister.de/api/public/reporting/laendertabelle
1635742815,693,574,119,78,32,https://www.intensivregister.de/api/public/reporting/laendertabelle
1635746408,695,576,119,78,33,https://www.intensivregister.de/api/public/reporting/laendertabelle
1635750012,692,575,117,78,34,https://www.intensivregister.de/api/public/reporting/laendertabelle
1635753608,692,579,113,79,34,https://www.intensivregister.de/api/public/reporting/laendertabelle
1635757212,692,580,112,79,34,https://www.intensivregister.de/api/public/reporting/laendertabelle
1635814810,692,579,113,79,34,https://www.intensivregister.de/api/public/reporting/laendertabelle
1635829210,694,581,113,78,36,https://www.intensivregister.de/api/public/reporting/laendertabelle
1635832812,698,589,109,80,36,https://www.intensivregister.de/api/public/reporting/laendertabelle
1635836414,701,595,106,80,36,https://www.intensivregister.de/api/public/reporting/laendertabelle
1635839715,701,591,110,80,36,https://www.intensivregister.de/api/public/reporting/laendertabelle
1635890410,701,592,109,80,36,https://www.intensivregister.de/api/public/reporting/laendertabelle
1635894015,703,596,107,82,36,https://www.intensivregister.de/api/public/reporting/laendertabelle
1635897608,702,595,107,82,36,https://www.intensivregister.de/api/public/reporting/laendertabelle
1635911711,702,594,108,83,35,https://www.intensivregister.de/api/public/reporting/laendertabelle
1635915609,708,603,105,87,37,https://www.intensivregister.de/api/public/reporting/laendertabelle
1635919213,705,604,101,91,38,https://www.intensivregister.de/api/public/reporting/laendertabelle
1635926109,705,606,99,91,38,https://www.intensivregister.de/api/public/reporting/laendertabelle
1635930011,705,606,99,92,38,https://www.intensivregister.de/api/public/reporting/laendertabelle
1635933612,704,603,101,91,38,https://www.intensivregister.de/api/public/reporting/laendertabelle
1635944415,704,605,99,92,37,https://www.intensivregister.de/api/public/reporting/laendertabelle
1635991213,704,602,102,92,37,https://www.intensivregister.de/api/public/reporting/laendertabelle
1635998412,704,602,102,91,37,https://www.intensivregister.de/api/public/reporting/laendertabelle
1636001714,707,605,102,95,39,https://www.intensivregister.de/api/public/reporting/laendertabelle
1636005612,707,607,100,95,39,https://www.intensivregister.de/api/public/reporting/laendertabelle
1636009217,706,610,96,96,41,https://www.intensivregister.de/api/public/reporting/laendertabelle
1636012812,706,612,94,99,42,https://www.intensivregister.de/api/public/reporting/laendertabelle
1636016115,706,610,96,99,41,https://www.intensivregister.de/api/public/reporting/laendertabelle
1636077615,703,607,96,99,42,https://www.intensivregister.de/api/public/reporting/laendertabelle
1636084813,703,605,98,99,42,https://www.intensivregister.de/api/public/reporting/laendertabelle
1636088408,701,601,100,104,43,https://www.intensivregister.de/api/public/reporting/laendertabelle
1636092014,701,596,105,103,45,https://www.intensivregister.de/api/public/reporting/laendertabelle
1636095608,701,592,109,106,46,https://www.intensivregister.de/api/public/reporting/laendertabelle
1636098910,701,593,108,107,46,https://www.intensivregister.de/api/public/reporting/laendertabelle
1636113614,701,593,108,108,47,https://www.intensivregister.de/api/public/reporting/laendertabelle
1636152914,701,595,106,109,48,https://www.intensivregister.de/api/public/reporting/laendertabelle
1636167314,701,596,105,109,48,https://www.intensivregister.de/api/public/reporting/laendertabelle
1636171212,701,594,107,110,49,https://www.intensivregister.de/api/public/reporting/laendertabelle
1636174816,701,595,106,108,48,https://www.intensivregister.de/api/public/reporting/laendertabelle
1636178412,702,588,114,101,47,https://www.intensivregister.de/api/public/reporting/laendertabelle
1636182016,696,593,103,108,50,https://www.intensivregister.de/api/public/reporting/laendertabelle
1636185308,696,594,102,108,51,https://www.intensivregister.de/api/public/reporting/laendertabelle
1636189216,696,592,104,109,53,https://www.intensivregister.de/api/public/reporting/laendertabelle
1636192810,694,589,105,109,53,https://www.intensivregister.de/api/public/reporting/laendertabelle
1636239613,695,590,105,109,54,https://www.intensivregister.de/api/public/reporting/laendertabelle
1636260912,694,589,105,111,54,https://www.intensivregister.de/api/public/reporting/laendertabelle
1636264810,693,590,103,111,56,https://www.intensivregister.de/api/public/reporting/laendertabelle
1636268414,694,595,99,110,57,https://www.intensivregister.de/api/public/reporting/laendertabelle
1636272008,691,588,103,114,58,https://www.intensivregister.de/api/public/reporting/laendertabelle
1636275613,693,593,100,116,60,https://www.intensivregister.de/api/public/reporting/laendertabelle
1636278914,693,594,99,116,60,https://www.intensivregister.de/api/public/reporting/laendertabelle
1636326011,693,591,102,116,60,https://www.intensivregister.de/api/public/reporting/laendertabelle
1636344012,693,593,100,117,60,https://www.intensivregister.de/api/public/reporting/laendertabelle
1636347315,695,591,104,128,64,https://www.intensivregister.de/api/public/reporting/laendertabelle
1636351212,692,586,106,129,66,https://www.intensivregister.de/api/public/reporting/laendertabelle
1636354808,691,584,107,129,65,https://www.intensivregister.de/api/public/reporting/laendertabelle
1636358413,691,583,108,132,68,https://www.intensivregister.de/api/public/reporting/laendertabelle
1636361716,691,584,107,133,69,https://www.intensivregister.de/api/public/reporting/laendertabelle
1636369209,691,583,108,133,69,https://www.intensivregister.de/api/public/reporting/laendertabelle
1636376409,691,590,101,132,69,https://www.intensivregister.de/api/public/reporting/laendertabelle
1636387214,691,590,101,133,70,https://www.intensivregister.de/api/public/reporting/laendertabelle
1636405209,691,590,101,134,71,https://www.intensivregister.de/api/public/reporting/laendertabelle
1636416012,691,589,102,134,71,https://www.intensivregister.de/api/public/reporting/laendertabelle
1636430412,691,589,102,133,71,https://www.intensivregister.de/api/public/reporting/laendertabelle
1636434016,702,611,91,136,72,https://www.intensivregister.de/api/public/reporting/laendertabelle
1636437309,709,622,87,132,72,https://www.intensivregister.de/api/public/reporting/laendertabelle
1636441217,709,620,89,131,72,https://www.intensivregister.de/api/public/reporting/laendertabelle
1636444812,709,619,90,131,72,https://www.intensivregister.de/api/public/reporting/laendertabelle
1636448116,709,619,90,133,73,https://www.intensivregister.de/api/public/reporting/laendertabelle
1636452014,709,617,92,133,73,https://www.intensivregister.de/api/public/reporting/laendertabelle
1636498812,710,618,92,133,73,https://www.intensivregister.de/api/public/reporting/laendertabelle
1636516811,710,615,95,133,68,https://www.intensivregister.de/api/public/reporting/laendertabelle
1636520416,714,612,102,135,71,https://www.intensivregister.de/api/public/reporting/laendertabelle
1636524011,714,612,102,138,71,https://www.intensivregister.de/api/public/reporting/laendertabelle
1636527315,714,611,103,141,71,https://www.intensivregister.de/api/public/reporting/laendertabelle
1636531212,714,612,102,141,71,https://www.intensivregister.de/api/public/reporting/laendertabelle
1636534515,714,611,103,141,71,https://www.intensivregister.de/api/public/reporting/laendertabelle
1636552508,714,611,103,140,71,https://www.intensivregister.de/api/public/reporting/laendertabelle
1636584913,714,610,104,140,71,https://www.intensivregister.de/api/public/reporting/laendertabelle
1636596009,714,609,105,140,71,https://www.intensivregister.de/api/public/reporting/laendertabelle
1636603210,714,611,103,139,72,https://www.intensivregister.de/api/public/reporting/laendertabelle
1636606513,710,611,99,142,75,https://www.intensivregister.de/api/public/reporting/laendertabelle
1636610108,711,606,105,140,74,https://www.intensivregister.de/api/public/reporting/laendertabelle
1636614015,711,607,104,143,76,https://www.intensivregister.de/api/public/reporting/laendertabelle
1636617610,712,608,104,144,76,https://www.intensivregister.de/api/public/reporting/laendertabelle
1636624811,709,608,101,144,76,https://www.intensivregister.de/api/public/reporting/laendertabelle
1636653612,709,607,102,143,75,https://www.intensivregister.de/api/public/reporting/laendertabelle
1636678515,709,611,98,143,75,https://www.intensivregister.de/api/public/reporting/laendertabelle
1636689614,709,609,100,143,74,https://www.intensivregister.de/api/public/reporting/laendertabelle
1636693209,702,595,107,144,73,https://www.intensivregister.de/api/public/reporting/laendertabelle
1636696814,702,595,107,145,73,https://www.intensivregister.de/api/public/reporting/laendertabelle
1636700409,702,594,108,147,73,https://www.intensivregister.de/api/public/reporting/laendertabelle
1636703711,706,597,109,154,74,https://www.intensivregister.de/api/public/reporting/laendertabelle
1636711213,705,596,109,153,73,https://www.intensivregister.de/api/public/reporting/laendertabelle
1636714808,704,596,108,153,73,https://www.intensivregister.de/api/public/reporting/laendertabelle
1636725315,702,594,108,153,74,https://www.intensivregister.de/api/public/reporting/laendertabelle
1636758009,701,591,110,153,74,https://www.intensivregister.de/api/public/reporting/laendertabelle
1636779610,701,591,110,149,73,https://www.intensivregister.de/api/public/reporting/laendertabelle
1636783216,700,591,109,151,72,https://www.intensivregister.de/api/public/reporting/laendertabelle
1636786811,702,596,106,152,77,https://www.intensivregister.de/api/public/reporting/laendertabelle
1636790113,694,591,103,157,81,https://www.intensivregister.de/api/public/reporting/laendertabelle
1636794011,696,594,102,157,80,https://www.intensivregister.de/api/public/reporting/laendertabelle
1636797617,696,594,102,160,83,https://www.intensivregister.de/api/public/reporting/laendertabelle
1636815611,694,592,102,162,84,https://www.intensivregister.de/api/public/reporting/laendertabelle
1636830011,694,593,101,162,84,https://www.intensivregister.de/api/public/reporting/laendertabelle
1636847714,695,594,101,162,84,https://www.intensivregister.de/api/public/reporting/laendertabelle
1636866012,694,593,101,164,86,https://www.intensivregister.de/api/public/reporting/laendertabelle
1636869617,696,595,101,165,86,https://www.intensivregister.de/api/public/reporting/laendertabelle
1636873212,697,596,101,166,86,https://www.intensivregister.de/api/public/reporting/laendertabelle
1636876817,696,601,95,170,92,https://www.intensivregister.de/api/public/reporting/laendertabelle
1636880411,696,600,96,171,93,https://www.intensivregister.de/api/public/reporting/laendertabelle
1636884016,696,602,94,171,92,https://www.intensivregister.de/api/public/reporting/laendertabelle
1636891217,696,604,92,171,92,https://www.intensivregister.de/api/public/reporting/laendertabelle
1636937711,696,602,94,171,92,https://www.intensivregister.de/api/public/reporting/laendertabelle
1636948810,698,606,92,173,93,https://www.intensivregister.de/api/public/reporting/laendertabelle
1636952415,698,600,98,171,92,https://www.intensivregister.de/api/public/reporting/laendertabelle
1636956010,700,599,101,169,95,https://www.intensivregister.de/api/public/reporting/laendertabelle
1636959016,694,592,102,170,93,https://www.intensivregister.de/api/public/reporting/laendertabelle
1636970417,692,590,102,173,94,https://www.intensivregister.de/api/public/reporting/laendertabelle
1637031610,692,591,101,173,94,https://www.intensivregister.de/api/public/reporting/laendertabelle
1637034911,694,592,102,174,94,https://www.intensivregister.de/api/public/reporting/laendertabelle
1637038808,694,587,107,170,93,https://www.intensivregister.de/api/public/reporting/laendertabelle
1637042414,700,593,107,174,95,https://www.intensivregister.de/api/public/reporting/laendertabelle
1637046010,700,594,106,180,95,https://www.intensivregister.de/api/public/reporting/laendertabelle
1637049615,700,594,106,181,95,https://www.intensivregister.de/api/public/reporting/laendertabelle
1637053211,700,594,106,180,94,https://www.intensivregister.de/api/public/reporting/laendertabelle
1637056514,700,593,107,180,94,https://www.intensivregister.de/api/public/reporting/laendertabelle
1637060412,698,591,107,181,96,https://www.intensivregister.de/api/public/reporting/laendertabelle
1637074813,699,594,105,182,96,https://www.intensivregister.de/api/public/reporting/laendertabelle
1637103615,699,593,106,184,97,https://www.intensivregister.de/api/public/reporting/laendertabelle
1637121613,699,594,105,183,97,https://www.intensivregister.de/api/public/reporting/laendertabelle
1637124916,699,590,109,188,101,https://www.intensivregister.de/api/public/reporting/laendertabelle
1637128513,706,592,114,190,97,https://www.intensivregister.de/api/public/reporting/laendertabelle
1637132410,710,593,117,190,99,https://www.intensivregister.de/api/public/reporting/laendertabelle
1637136014,714,604,110,193,100,https://www.intensivregister.de/api/public/reporting/laendertabelle
1637139608,712,604,108,192,99,https://www.intensivregister.de/api/public/reporting/laendertabelle
1637142613,712,604,108,193,99,https://www.intensivregister.de/api/public/reporting/laendertabelle
1637157615,712,603,109,194,98,https://www.intensivregister.de/api/public/reporting/laendertabelle
1637164812,712,605,107,194,98,https://www.intensivregister.de/api/public/reporting/laendertabelle
1637204414,712,604,108,194,98,https://www.intensivregister.de/api/public/reporting/laendertabelle
1637211609,713,608,105,195,98,https://www.intensivregister.de/api/public/reporting/laendertabelle
1637215212,716,612,104,198,100,https://www.intensivregister.de/api/public/reporting/laendertabelle
1637218815,716,606,110,189,101,https://www.intensivregister.de/api/public/reporting/laendertabelle
1637226009,716,602,114,187,101,https://www.intensivregister.de/api/public/reporting/laendertabelle
1637229611,717,604,113,188,101,https://www.intensivregister.de/api/public/reporting/laendertabelle
1637251500,717,604,113,189,102,https://www.intensivregister.de/api/public/reporting/laendertabelle
1637276700,717,603,114,189,102,https://www.intensivregister.de/api/public/reporting/laendertabelle
1637294700,714,602,112,189,99,https://www.intensivregister.de/api/public/reporting/laendertabelle
1637298300,713,602,111,183,98,https://www.intensivregister.de/api/public/reporting/laendertabelle
1637301900,710,598,112,181,97,https://www.intensivregister.de/api/public/reporting/laendertabelle
1637305500,710,597,113,182,99,https://www.intensivregister.de/api/public/reporting/laendertabelle
1637309100,710,596,114,182,98,https://www.intensivregister.de/api/public/reporting/laendertabelle
1637316300,710,595,115,181,97,https://www.intensivregister.de/api/public/reporting/laendertabelle
1637323500,710,595,115,179,96,https://www.intensivregister.de/api/public/reporting/laendertabelle
1637330700,710,595,115,180,96,https://www.intensivregister.de/api/public/reporting/laendertabelle
1637363100,710,596,114,180,96,https://www.intensivregister.de/api/public/reporting/laendertabelle
1637384700,710,592,118,179,96,https://www.intensivregister.de/api/public/reporting/laendertabelle
1637388300,710,591,119,181,93,https://www.intensivregister.de/api/public/reporting/laendertabelle
1637391900,707,585,122,177,96,https://www.intensivregister.de/api/public/reporting/laendertabelle
1637395500,703,575,128,177,100,https://www.intensivregister.de/api/public/reporting/laendertabelle
1637409900,703,573,130,177,100,https://www.intensivregister.de/api/public/reporting/laendertabelle
1637438700,703,575,128,177,100,https://www.intensivregister.de/api/public/reporting/laendertabelle
1637471100,703,576,127,178,99,https://www.intensivregister.de/api/public/reporting/laendertabelle
1637474700,702,576,126,179,100,https://www.intensivregister.de/api/public/reporting/laendertabelle
1637478300,700,570,130,181,97,https://www.intensivregister.de/api/public/reporting/laendertabelle
1637481900,701,575,126,181,100,https://www.intensivregister.de/api/public/reporting/laendertabelle
1637503500,701,578,123,184,102,https://www.intensivregister.de/api/public/reporting/laendertabelle
1637507100,701,577,124,183,102,https://www.intensivregister.de/api/public/reporting/laendertabelle
1637525100,701,579,122,185,104,https://www.intensivregister.de/api/public/reporting/laendertabelle
1637535900,701,579,122,187,103,https://www.intensivregister.de/api/public/reporting/laendertabelle
1637553900,701,580,121,187,103,https://www.intensivregister.de/api/public/reporting/laendertabelle
1637557500,701,577,124,188,105,https://www.intensivregister.de/api/public/reporting/laendertabelle
1637561100,703,578,125,191,107,https://www.intensivregister.de/api/public/reporting/laendertabelle
1637564700,703,576,127,193,107,https://www.intensivregister.de/api/public/reporting/laendertabelle
1637568300,703,576,127,194,107,https://www.intensivregister.de/api/public/reporting/laendertabelle
1637575500,703,578,125,195,109,https://www.intensivregister.de/api/public/reporting/laendertabelle
1637579100,703,578,125,197,109,https://www.intensivregister.de/api/public/reporting/laendertabelle
1637586300,703,579,124,197,109,https://www.intensivregister.de/api/public/reporting/laendertabelle
1637625900,703,582,121,197,109,https://www.intensivregister.de/api/public/reporting/laendertabelle
1637636700,703,581,122,197,109,https://www.intensivregister.de/api/public/reporting/laendertabelle
1637640300,703,583,120,197,110,https://www.intensivregister.de/api/public/reporting/laendertabelle
1637643900,708,596,112,203,109,https://www.intensivregister.de/api/public/reporting/laendertabelle
1637647500,704,600,104,208,112,https://www.intensivregister.de/api/public/reporting/laendertabelle
1637651100,704,598,106,208,112,https://www.intensivregister.de/api/public/reporting/laendertabelle
1637654700,704,603,101,207,111,https://www.intensivregister.de/api/public/reporting/laendertabelle
1637658300,704,606,98,208,111,https://www.intensivregister.de/api/public/reporting/laendertabelle
1637661900,704,608,96,211,111,https://www.intensivregister.de/api/public/reporting/laendertabelle
1637712300,704,607,97,212,112,https://www.intensivregister.de/api/public/reporting/laendertabelle
1637726700,704,609,95,211,112,https://www.intensivregister.de/api/public/reporting/laendertabelle
1637730300,704,607,97,203,110,https://www.intensivregister.de/api/public/reporting/laendertabelle
1637733900,704,606,98,203,110,https://www.intensivregister.de/api/public/reporting/laendertabelle
1637737500,704,603,101,199,108,https://www.intensivregister.de/api/public/reporting/laendertabelle
1637741100,702,604,98,199,109,https://www.intensivregister.de/api/public/reporting/laendertabelle
1637762700,702,600,102,197,110,https://www.intensivregister.de/api/public/reporting/laendertabelle
1637784300,702,599,103,196,109,https://www.intensivregister.de/api/public/reporting/laendertabelle
1637795100,700,599,101,195,108,https://www.intensivregister.de/api/public/reporting/laendertabelle
1637802300,700,602,98,195,110,https://www.intensivregister.de/api/public/reporting/laendertabelle
1637813100,700,602,98,194,110,https://www.intensivregister.de/api/public/reporting/laendertabelle
1637816700,700,604,96,194,108,https://www.intensivregister.de/api/public/reporting/laendertabelle
1637820300,702,607,95,204,110,https://www.intensivregister.de/api/public/reporting/laendertabelle
1637823900,702,616,86,210,110,https://www.intensivregister.de/api/public/reporting/laendertabelle
1637827500,706,620,86,211,110,https://www.intensivregister.de/api/public/reporting/laendertabelle
1637831100,706,617,89,209,107,https://www.intensivregister.de/api/public/reporting/laendertabelle
1637838635,706,617,89,210,108,https://www.intensivregister.de/api/public/reporting/laendertabelle
1637841900,705,616,89,210,108,https://www.intensivregister.de/api/public/reporting/laendertabelle
1637856300,705,616,89,208,106,https://www.intensivregister.de/api/public/reporting/laendertabelle
1637877900,705,617,88,208,106,https://www.intensivregister.de/api/public/reporting/laendertabelle
1637881500,705,614,91,208,106,https://www.intensivregister.de/api/public/reporting/laendertabelle
1637899500,705,614,91,209,106,https://www.intensivregister.de/api/public/reporting/laendertabelle
1637903100,705,611,94,205,103,https://www.intensivregister.de/api/public/reporting/laendertabelle
1637906700,705,607,98,205,104,https://www.intensivregister.de/api/public/reporting/laendertabelle
1637910300,701,599,102,198,103,https://www.intensivregister.de/api/public/reporting/laendertabelle
1637917500,701,600,101,198,103,https://www.intensivregister.de/api/public/reporting/laendertabelle
1637931900,701,601,100,198,103,https://www.intensivregister.de/api/public/reporting/laendertabelle
1637935500,701,602,99,198,103,https://www.intensivregister.de/api/public/reporting/laendertabelle
1637971500,701,601,100,199,103,https://www.intensivregister.de/api/public/reporting/laendertabelle
1637978700,700,602,98,199,103,https://www.intensivregister.de/api/public/reporting/laendertabelle
1637989500,699,602,97,198,107,https://www.intensivregister.de/api/public/reporting/laendertabelle
1637993100,700,603,97,203,107,https://www.intensivregister.de/api/public/reporting/laendertabelle
1637996700,700,592,108,197,107,https://www.intensivregister.de/api/public/reporting/laendertabelle
1638000300,700,589,111,195,106,https://www.intensivregister.de/api/public/reporting/laendertabelle
1638003900,700,584,116,194,106,https://www.intensivregister.de/api/public/reporting/laendertabelle
1638007500,700,584,116,197,109,https://www.intensivregister.de/api/public/reporting/laendertabelle
1638011100,700,585,115,197,109,https://www.intensivregister.de/api/public/reporting/laendertabelle
1638021900,698,585,113,197,109,https://www.intensivregister.de/api/public/reporting/laendertabelle
1638054300,698,584,114,197,109,https://www.intensivregister.de/api/public/reporting/laendertabelle
1638061500,698,586,112,199,110,https://www.intensivregister.de/api/public/reporting/laendertabelle
1638075900,697,588,109,198,111,https://www.intensivregister.de/api/public/reporting/laendertabelle
1638079500,698,591,107,199,111,https://www.intensivregister.de/api/public/reporting/laendertabelle
1638083100,698,593,105,200,113,https://www.intensivregister.de/api/public/reporting/laendertabelle
1638086700,698,589,109,194,109,https://www.intensivregister.de/api/public/reporting/laendertabelle
1638090300,698,589,109,195,112,https://www.intensivregister.de/api/public/reporting/laendertabelle
1638101100,698,589,109,196,113,https://www.intensivregister.de/api/public/reporting/laendertabelle
1638119100,698,588,110,197,114,https://www.intensivregister.de/api/public/reporting/laendertabelle
1638144300,698,589,109,197,114,https://www.intensivregister.de/api/public/reporting/laendertabelle
1638155100,698,590,108,198,114,https://www.intensivregister.de/api/public/reporting/laendertabelle
1638158700,698,591,107,198,114,https://www.intensivregister.de/api/public/reporting/laendertabelle
1638162300,692,592,100,197,112,https://www.intensivregister.de/api/public/reporting/laendertabelle
1638165900,692,594,98,200,113,https://www.intensivregister.de/api/public/reporting/laendertabelle
1638169500,692,588,104,199,112,https://www.intensivregister.de/api/public/reporting/laendertabelle
1638173100,692,585,107,198,112,https://www.intensivregister.de/api/public/reporting/laendertabelle
1638176700,692,586,106,198,112,https://www.intensivregister.de/api/public/reporting/laendertabelle
1638180300,692,587,105,199,114,https://www.intensivregister.de/api/public/reporting/laendertabelle
1638183900,692,589,103,202,116,https://www.intensivregister.de/api/public/reporting/laendertabelle
1638227100,692,588,104,203,116,https://www.intensivregister.de/api/public/reporting/laendertabelle
1638245100,692,590,102,202,116,https://www.intensivregister.de/api/public/reporting/laendertabelle
1638248700,699,596,103,206,122,https://www.intensivregister.de/api/public/reporting/laendertabelle
1638252300,699,605,94,209,122,https://www.intensivregister.de/api/public/reporting/laendertabelle
1638255900,699,607,92,214,124,https://www.intensivregister.de/api/public/reporting/laendertabelle
1638263100,699,609,90,215,126,https://www.intensivregister.de/api/public/reporting/laendertabelle
1638299100,699,610,89,217,126,https://www.intensivregister.de/api/public/reporting/laendertabelle
1638306300,699,609,90,217,126,https://www.intensivregister.de/api/public/reporting/laendertabelle
1638335100,692,605,87,211,129,https://www.intensivregister.de/api/public/reporting/laendertabelle
1638338700,696,602,94,211,129,https://www.intensivregister.de/api/public/reporting/laendertabelle
1638342300,696,601,95,209,130,https://www.intensivregister.de/api/public/reporting/laendertabelle
1638345900,697,602,95,206,125,https://www.intensivregister.de/api/public/reporting/laendertabelle
1638349500,694,604,90,208,126,https://www.intensivregister.de/api/public/reporting/laendertabelle
1638353100,694,604,90,207,126,https://www.intensivregister.de/api/public/reporting/laendertabelle
1638378300,694,606,88,209,127,https://www.intensivregister.de/api/public/reporting/laendertabelle
1638381900,694,609,85,209,127,https://www.intensivregister.de/api/public/reporting/laendertabelle
1638399900,694,609,85,208,127,https://www.intensivregister.de/api/public/reporting/laendertabelle
1638410700,694,609,85,207,128,https://www.intensivregister.de/api/public/reporting/laendertabelle
1638417900,694,609,85,209,129,https://www.intensivregister.de/api/public/reporting/laendertabelle
1638421500,696,615,81,215,132,https://www.intensivregister.de/api/public/reporting/laendertabelle
1638425100,700,625,75,220,129,https://www.intensivregister.de/api/public/reporting/laendertabelle
1638428700,700,626,74,222,129,https://www.intensivregister.de/api/public/reporting/laendertabelle
1638432300,700,628,72,222,129,https://www.intensivregister.de/api/public/reporting/laendertabelle
1638435900,700,630,70,222,129,https://www.intensivregister.de/api/public/reporting/laendertabelle
1638439500,700,632,68,223,129,https://www.intensivregister.de/api/public/reporting/laendertabelle
1638475500,702,632,70,222,128,https://www.intensivregister.de/api/public/reporting/laendertabelle
1638504300,702,631,71,224,128,https://www.intensivregister.de/api/public/reporting/laendertabelle
1638507900,703,626,77,225,128,https://www.intensivregister.de/api/public/reporting/laendertabelle
1638511500,703,627,76,223,129,https://www.intensivregister.de/api/public/reporting/laendertabelle
1638515100,703,637,66,226,131,https://www.intensivregister.de/api/public/reporting/laendertabelle
1638518700,700,640,60,228,133,https://www.intensivregister.de/api/public/reporting/laendertabelle
1638522300,700,639,61,229,134,https://www.intensivregister.de/api/public/reporting/laendertabelle
1638525900,700,637,63,229,134,https://www.intensivregister.de/api/public/reporting/laendertabelle
1638533100,700,638,62,230,134,https://www.intensivregister.de/api/public/reporting/laendertabelle
1638554700,700,640,60,230,133,https://www.intensivregister.de/api/public/reporting/laendertabelle
1638558300,700,639,61,229,132,https://www.intensivregister.de/api/public/reporting/laendertabelle
1638572700,699,638,61,229,132,https://www.intensivregister.de/api/public/reporting/laendertabelle
1638590700,699,636,63,229,132,https://www.intensivregister.de/api/public/reporting/laendertabelle
1638594300,699,631,68,228,132,https://www.intensivregister.de/api/public/reporting/laendertabelle
1638597900,699,623,76,229,127,https://www.intensivregister.de/api/public/reporting/laendertabelle
1638601500,700,624,76,233,129,https://www.intensivregister.de/api/public/reporting/laendertabelle
1638605100,700,625,75,231,129,https://www.intensivregister.de/api/public/reporting/laendertabelle
1638608700,698,626,72,231,127,https://www.intensivregister.de/api/public/reporting/laendertabelle
1638612300,698,624,74,229,127,https://www.intensivregister.de/api/public/reporting/laendertabelle
1638615900,698,623,75,228,127,https://www.intensivregister.de/api/public/reporting/laendertabelle
1638619500,698,624,74,228,127,https://www.intensivregister.de/api/public/reporting/laendertabelle
1638659100,699,626,73,228,127,https://www.intensivregister.de/api/public/reporting/laendertabelle
1638684300,698,624,74,227,127,https://www.intensivregister.de/api/public/reporting/laendertabelle
1638687900,695,620,75,230,132,https://www.intensivregister.de/api/public/reporting/laendertabelle
1638691500,693,610,83,227,130,https://www.intensivregister.de/api/public/reporting/laendertabelle
1638695100,694,608,86,226,130,https://www.intensivregister.de/api/public/reporting/laendertabelle
1638745500,694,607,87,226,130,https://www.intensivregister.de/api/public/reporting/laendertabelle
1638763500,694,607,87,224,130,https://www.intensivregister.de/api/public/reporting/laendertabelle
1638767100,694,606,88,223,130,https://www.intensivregister.de/api/public/reporting/laendertabelle
1638770700,694,608,86,224,130,https://www.intensivregister.de/api/public/reporting/laendertabelle
1638787139,698,607,91,229,137,https://www.intensivregister.de/api/public/reporting/laendertabelle
1638852152,697,616,81,226,133,https://www.intensivregister.de/api/public/reporting/laendertabelle
1638853500,697,624,73,228,134,https://www.intensivregister.de/api/public/reporting/laendertabelle
1638857100,700,623,77,221,130,https://www.intensivregister.de/api/public/reporting/laendertabelle
1638860700,700,622,78,219,128,https://www.intensivregister.de/api/public/reporting/laendertabelle
1638864300,698,626,72,215,123,https://www.intensivregister.de/api/public/reporting/laendertabelle
1638867900,698,627,71,214,123,https://www.intensivregister.de/api/public/reporting/laendertabelle
1638875100,698,626,72,214,123,https://www.intensivregister.de/api/public/reporting/laendertabelle
1638918300,698,625,73,213,123,https://www.intensivregister.de/api/public/reporting/laendertabelle
1638939900,697,619,78,215,121,https://www.intensivregister.de/api/public/reporting/laendertabelle
1638943500,697,622,75,214,117,https://www.intensivregister.de/api/public/reporting/laendertabelle
1638947100,697,621,76,211,117,https://www.intensivregister.de/api/public/reporting/laendertabelle
1638950700,697,619,78,212,114,https://www.intensivregister.de/api/public/reporting/laendertabelle
1638954300,697,617,80,212,114,https://www.intensivregister.de/api/public/reporting/laendertabelle
1638957900,697,619,78,213,115,https://www.intensivregister.de/api/public/reporting/laendertabelle
1638968700,697,620,77,214,115,https://www.intensivregister.de/api/public/reporting/laendertabelle
1638972300,697,621,76,217,118,https://www.intensivregister.de/api/public/reporting/laendertabelle
1639004700,698,622,76,218,117,https://www.intensivregister.de/api/public/reporting/laendertabelle
1639019100,698,623,75,218,117,https://www.intensivregister.de/api/public/reporting/laendertabelle
1639022700,698,622,76,218,118,https://www.intensivregister.de/api/public/reporting/laendertabelle
1639026300,695,611,84,219,123,https://www.intensivregister.de/api/public/reporting/laendertabelle
1639029900,695,606,89,219,121,https://www.intensivregister.de/api/public/reporting/laendertabelle
1639033500,695,615,80,220,125,https://www.intensivregister.de/api/public/reporting/laendertabelle
1639037100,695,614,81,219,124,https://www.intensivregister.de/api/public/reporting/laendertabelle
1639040700,697,616,81,220,124,https://www.intensivregister.de/api/public/reporting/laendertabelle
1639044300,697,616,81,222,124,https://www.intensivregister.de/api/public/reporting/laendertabelle
1639055100,697,615,82,222,123,https://www.intensivregister.de/api/public/reporting/laendertabelle
1639073100,697,614,83,221,123,https://www.intensivregister.de/api/public/reporting/laendertabelle
1639083900,697,612,85,220,123,https://www.intensivregister.de/api/public/reporting/laendertabelle
1639098300,698,613,85,220,123,https://www.intensivregister.de/api/public/reporting/laendertabelle
1639109100,698,614,84,220,122,https://www.intensivregister.de/api/public/reporting/laendertabelle
1639112700,701,610,91,219,121,https://www.intensivregister.de/api/public/reporting/laendertabelle
1639116300,702,605,97,215,118,https://www.intensivregister.de/api/public/reporting/laendertabelle
1639119900,702,600,102,210,116,https://www.intensivregister.de/api/public/reporting/laendertabelle
1639123500,702,600,102,212,117,https://www.intensivregister.de/api/public/reporting/laendertabelle
1639127100,700,597,103,210,116,https://www.intensivregister.de/api/public/reporting/laendertabelle
1639130700,700,598,102,211,116,https://www.intensivregister.de/api/public/reporting/laendertabelle
1639177500,700,600,100,211,116,https://www.intensivregister.de/api/public/reporting/laendertabelle
1639199100,700,599,101,210,116,https://www.intensivregister.de/api/public/reporting/laendertabelle
1639202700,700,597,103,209,119,https://www.intensivregister.de/api/public/reporting/laendertabelle
1639206300,697,593,104,205,116,https://www.intensivregister.de/api/public/reporting/laendertabelle
1639209900,700,598,102,204,115,https://www.intensivregister.de/api/public/reporting/laendertabelle
1639213500,699,597,102,205,120,https://www.intensivregister.de/api/public/reporting/laendertabelle
1639217100,699,598,101,205,120,https://www.intensivregister.de/api/public/reporting/laendertabelle
1639285500,699,594,105,205,123,https://www.intensivregister.de/api/public/reporting/laendertabelle
1639289100,699,595,104,200,124,https://www.intensivregister.de/api/public/reporting/laendertabelle
1639292700,695,593,102,201,124,https://www.intensivregister.de/api/public/reporting/laendertabelle
1639296300,689,585,104,200,122,https://www.intensivregister.de/api/public/reporting/laendertabelle
1639299900,693,583,110,203,122,https://www.intensivregister.de/api/public/reporting/laendertabelle
1639303500,693,582,111,205,124,https://www.intensivregister.de/api/public/reporting/laendertabelle
1639335900,693,582,111,206,125,https://www.intensivregister.de/api/public/reporting/laendertabelle
1639350300,693,581,112,206,125,https://www.intensivregister.de/api/public/reporting/laendertabelle
1639368300,693,580,113,206,122,https://www.intensivregister.de/api/public/reporting/laendertabelle
1639371900,693,579,114,206,118,https://www.intensivregister.de/api/public/reporting/laendertabelle
1639375500,693,574,119,205,116,https://www.intensivregister.de/api/public/reporting/laendertabelle
1639379100,694,566,128,203,119,https://www.intensivregister.de/api/public/reporting/laendertabelle
1639382700,694,571,123,202,117,https://www.intensivregister.de/api/public/reporting/laendertabelle
1639407900,694,572,122,202,117,https://www.intensivregister.de/api/public/reporting/laendertabelle
1639418700,694,575,119,203,117,https://www.intensivregister.de/api/public/reporting/laendertabelle
1639443900,694,579,115,203,118,https://www.intensivregister.de/api/public/reporting/laendertabelle
1639454700,694,581,113,204,118,https://www.intensivregister.de/api/public/reporting/laendertabelle
1639458300,694,585,109,201,117,https://www.intensivregister.de/api/public/reporting/laendertabelle
1639461900,693,588,105,204,118,https://www.intensivregister.de/api/public/reporting/laendertabelle
1639465500,695,594,101,209,118,https://www.intensivregister.de/api/public/reporting/laendertabelle
1639469100,695,606,89,212,118,https://www.intensivregister.de/api/public/reporting/laendertabelle
1639476300,695,605,90,211,119,https://www.intensivregister.de/api/public/reporting/laendertabelle
1639483500,695,606,89,212,120,https://www.intensivregister.de/api/public/reporting/laendertabelle
1639497900,695,606,89,213,122,https://www.intensivregister.de/api/public/reporting/laendertabelle
1639530300,695,604,91,213,122,https://www.intensivregister.de/api/public/reporting/laendertabelle
1639541100,695,605,90,214,122,https://www.intensivregister.de/api/public/reporting/laendertabelle
1639544700,695,603,92,216,124,https://www.intensivregister.de/api/public/reporting/laendertabelle
1639548300,692,594,98,213,121,https://www.intensivregister.de/api/public/reporting/laendertabelle
1639551900,692,598,94,215,120,https://www.intensivregister.de/api/public/reporting/laendertabelle
1639555500,694,600,94,218,119,https://www.intensivregister.de/api/public/reporting/laendertabelle
1639559100,694,604,90,220,121,https://www.intensivregister.de/api/public/reporting/laendertabelle
1639562700,694,600,94,219,120,https://www.intensivregister.de/api/public/reporting/laendertabelle
1639580700,694,600,94,220,121,https://www.intensivregister.de/api/public/reporting/laendertabelle
1639609500,694,601,93,220,121,https://www.intensivregister.de/api/public/reporting/laendertabelle
1639613100,694,604,90,220,121,https://www.intensivregister.de/api/public/reporting/laendertabelle
1639627500,694,605,89,221,121,https://www.intensivregister.de/api/public/reporting/laendertabelle
1639631100,694,600,94,216,119,https://www.intensivregister.de/api/public/reporting/laendertabelle
1639634700,693,599,94,222,122,https://www.intensivregister.de/api/public/reporting/laendertabelle
1639638300,693,600,93,223,123,https://www.intensivregister.de/api/public/reporting/laendertabelle
1639641900,690,592,98,216,121,https://www.intensivregister.de/api/public/reporting/laendertabelle
1639645500,690,593,97,216,121,https://www.intensivregister.de/api/public/reporting/laendertabelle
1639649100,690,594,96,216,121,https://www.intensivregister.de/api/public/reporting/laendertabelle
1639659900,686,593,93,216,121,https://www.intensivregister.de/api/public/reporting/laendertabelle
1639695900,686,594,92,216,121,https://www.intensivregister.de/api/public/reporting/laendertabelle
1639713900,686,594,92,214,119,https://www.intensivregister.de/api/public/reporting/laendertabelle
1639717500,688,598,90,220,118,https://www.intensivregister.de/api/public/reporting/laendertabelle
1639721100,691,603,88,220,121,https://www.intensivregister.de/api/public/reporting/laendertabelle
1639724700,693,609,84,215,121,https://www.intensivregister.de/api/public/reporting/laendertabelle
1639728300,695,615,80,217,123,https://www.intensivregister.de/api/public/reporting/laendertabelle
1639742700,698,617,81,218,124,https://www.intensivregister.de/api/public/reporting/laendertabelle
1639746300,700,620,80,220,126,https://www.intensivregister.de/api/public/reporting/laendertabelle
1639767900,700,615,85,221,126,https://www.intensivregister.de/api/public/reporting/laendertabelle
1639803900,700,606,94,220,125,https://www.intensivregister.de/api/public/reporting/laendertabelle
1639807500,700,595,105,213,124,https://www.intensivregister.de/api/public/reporting/laendertabelle
1639811100,697,599,98,212,126,https://www.intensivregister.de/api/public/reporting/laendertabelle
1639814700,697,598,99,212,126,https://www.intensivregister.de/api/public/reporting/laendertabelle
1639818300,700,603,97,213,126,https://www.intensivregister.de/api/public/reporting/laendertabelle
1639821900,700,603,97,214,127,https://www.intensivregister.de/api/public/reporting/laendertabelle
1639868700,700,604,96,214,127,https://www.intensivregister.de/api/public/reporting/laendertabelle
1639890300,700,601,99,213,127,https://www.intensivregister.de/api/public/reporting/laendertabelle
1639893900,700,598,102,212,125,https://www.intensivregister.de/api/public/reporting/laendertabelle
1639897500,696,596,100,214,124,https://www.intensivregister.de/api/public/reporting/laendertabelle
1639901100,696,598,98,218,125,https://www.intensivregister.de/api/public/reporting/laendertabelle
1639904700,691,590,101,218,121,https://www.intensivregister.de/api/public/reporting/laendertabelle
1639908300,691,594,97,219,120,https://www.intensivregister.de/api/public/reporting/laendertabelle
1639973100,691,593,98,219,121,https://www.intensivregister.de/api/public/reporting/laendertabelle
1639976700,682,588,94,221,123,https://www.intensivregister.de/api/public/reporting/laendertabelle
1639980300,679,593,86,223,121,https://www.intensivregister.de/api/public/reporting/laendertabelle
1639983900,676,592,84,225,123,https://www.intensivregister.de/api/public/reporting/laendertabelle
1639987500,679,597,82,226,124,https://www.intensivregister.de/api/public/reporting/laendertabelle
1639991100,679,596,83,226,126,https://www.intensivregister.de/api/public/reporting/laendertabelle
1640009100,679,597,82,226,126,https://www.intensivregister.de/api/public/reporting/laendertabelle
1640016300,679,597,82,227,126,https://www.intensivregister.de/api/public/reporting/laendertabelle
1640041500,678,594,84,226,126,https://www.intensivregister.de/api/public/reporting/laendertabelle
1640059500,678,596,82,226,126,https://www.intensivregister.de/api/public/reporting/laendertabelle
1640063100,684,600,84,229,128,https://www.intensivregister.de/api/public/reporting/laendertabelle
1640066700,689,608,81,230,121,https://www.intensivregister.de/api/public/reporting/laendertabelle
1640070300,689,603,86,231,122,https://www.intensivregister.de/api/public/reporting/laendertabelle
1640077500,689,603,86,232,122,https://www.intensivregister.de/api/public/reporting/laendertabelle
1640084700,690,605,85,232,122,https://www.intensivregister.de/api/public/reporting/laendertabelle
1640131500,690,604,86,232,122,https://www.intensivregister.de/api/public/reporting/laendertabelle
1640135100,690,603,87,231,121,https://www.intensivregister.de/api/public/reporting/laendertabelle
1640149500,688,598,90,230,127,https://www.intensivregister.de/api/public/reporting/laendertabelle
1640153100,688,597,91,231,130,https://www.intensivregister.de/api/public/reporting/laendertabelle
1640156700,690,602,88,229,130,https://www.intensivregister.de/api/public/reporting/laendertabelle
1640160300,690,601,89,227,130,https://www.intensivregister.de/api/public/reporting/laendertabelle
1640163900,690,601,89,226,130,https://www.intensivregister.de/api/public/reporting/laendertabelle
1640167500,690,600,90,225,129,https://www.intensivregister.de/api/public/reporting/laendertabelle
1640171100,690,602,88,228,134,https://www.intensivregister.de/api/public/reporting/laendertabelle
1640178300,690,604,86,228,134,https://www.intensivregister.de/api/public/reporting/laendertabelle
1640228700,690,603,87,228,134,https://www.intensivregister.de/api/public/reporting/laendertabelle
1640232300,690,597,93,223,130,https://www.intensivregister.de/api/public/reporting/laendertabelle
1640235900,689,599,90,219,131,https://www.intensivregister.de/api/public/reporting/laendertabelle
1640239500,689,598,91,218,133,https://www.intensivregister.de/api/public/reporting/laendertabelle
1640243100,690,598,92,217,133,https://www.intensivregister.de/api/public/reporting/laendertabelle
1640246700,692,595,97,217,133,https://www.intensivregister.de/api/public/reporting/laendertabelle
1640250300,692,597,95,217,132,https://www.intensivregister.de/api/public/reporting/laendertabelle
1640253900,692,597,95,218,131,https://www.intensivregister.de/api/public/reporting/laendertabelle
1640268300,692,598,94,218,131,https://www.intensivregister.de/api/public/reporting/laendertabelle
1640300700,692,600,92,220,129,https://www.intensivregister.de/api/public/reporting/laendertabelle
1640322300,693,601,92,220,129,https://www.intensivregister.de/api/public/reporting/laendertabelle
1640325900,695,592,103,218,130,https://www.intensivregister.de/api/public/reporting/laendertabelle
1640329500,695,579,116,215,126,https://www.intensivregister.de/api/public/reporting/laendertabelle
1640333100,695,573,122,209,124,https://www.intensivregister.de/api/public/reporting/laendertabelle
1640336700,694,574,120,209,123,https://www.intensivregister.de/api/public/reporting/laendertabelle
1640340300,694,573,121,208,123,https://www.intensivregister.de/api/public/reporting/laendertabelle
1640408700,694,573,121,210,124,https://www.intensivregister.de/api/public/reporting/laendertabelle
1640412300,699,570,129,212,123,https://www.intensivregister.de/api/public/reporting/laendertabelle
1640415900,698,564,134,214,125,https://www.intensivregister.de/api/public/reporting/laendertabelle
1640419500,698,556,142,211,127,https://www.intensivregister.de/api/public/reporting/laendertabelle
1640423100,696,548,148,212,127,https://www.intensivregister.de/api/public/reporting/laendertabelle
1640466300,696,549,147,211,125,https://www.intensivregister.de/api/public/reporting/laendertabelle
1640487900,696,550,146,211,125,https://www.intensivregister.de/api/public/reporting/laendertabelle
1640495100,692,552,140,211,123,https://www.intensivregister.de/api/public/reporting/laendertabelle
1640498700,692,552,140,214,124,https://www.intensivregister.de/api/public/reporting/laendertabelle
1640502300,692,562,130,218,125,https://www.intensivregister.de/api/public/reporting/laendertabelle
1640505900,692,560,132,220,125,https://www.intensivregister.de/api/public/reporting/laendertabelle
1640509500,692,561,131,222,127,https://www.intensivregister.de/api/public/reporting/laendertabelle
1640513100,692,560,132,221,126,https://www.intensivregister.de/api/public/reporting/laendertabelle
1640516700,692,559,133,221,126,https://www.intensivregister.de/api/public/reporting/laendertabelle
1640559900,692,557,135,221,123,https://www.intensivregister.de/api/public/reporting/laendertabelle
1640577900,692,555,137,219,123,https://www.intensivregister.de/api/public/reporting/laendertabelle
1640581500,691,553,138,216,121,https://www.intensivregister.de/api/public/reporting/laendertabelle
1640585100,690,555,135,218,126,https://www.intensivregister.de/api/public/reporting/laendertabelle
1640588700,690,552,138,216,125,https://www.intensivregister.de/api/public/reporting/laendertabelle
1640592300,690,550,140,214,125,https://www.intensivregister.de/api/public/reporting/laendertabelle
1640595900,690,551,139,214,126,https://www.intensivregister.de/api/public/reporting/laendertabelle
1640599500,690,551,139,217,130,https://www.intensivregister.de/api/public/reporting/laendertabelle
1640649900,690,551,139,216,130,https://www.intensivregister.de/api/public/reporting/laendertabelle
1640664300,690,550,140,216,130,https://www.intensivregister.de/api/public/reporting/laendertabelle
1640667900,689,563,126,214,127,https://www.intensivregister.de/api/public/reporting/laendertabelle
1640671500,688,566,122,215,126,https://www.intensivregister.de/api/public/reporting/laendertabelle
1640675100,688,567,121,217,127,https://www.intensivregister.de/api/public/reporting/laendertabelle
1640678700,688,566,122,213,123,https://www.intensivregister.de/api/public/reporting/laendertabelle
1640682300,688,567,121,213,123,https://www.intensivregister.de/api/public/reporting/laendertabelle
1640685900,691,579,112,213,122,https://www.intensivregister.de/api/public/reporting/laendertabelle
1640689500,692,577,115,209,124,https://www.intensivregister.de/api/public/reporting/laendertabelle
1640714700,692,574,118,210,125,https://www.intensivregister.de/api/public/reporting/laendertabelle
1640750700,692,573,119,210,125,https://www.intensivregister.de/api/public/reporting/laendertabelle
1640754300,693,575,118,212,129,https://www.intensivregister.de/api/public/reporting/laendertabelle
1640757900,693,575,118,211,128,https://www.intensivregister.de/api/public/reporting/laendertabelle
1640761500,693,573,120,209,126,https://www.intensivregister.de/api/public/reporting/laendertabelle
1640765100,693,574,119,214,130,https://www.intensivregister.de/api/public/reporting/laendertabelle
1640768700,689,570,119,214,130,https://www.intensivregister.de/api/public/reporting/laendertabelle
1640772300,685,578,107,214,129,https://www.intensivregister.de/api/public/reporting/laendertabelle
1640815500,685,573,112,214,129,https://www.intensivregister.de/api/public/reporting/laendertabelle
1640837100,683,571,112,215,130,https://www.intensivregister.de/api/public/reporting/laendertabelle
1640840700,688,568,120,210,132,https://www.intensivregister.de/api/public/reporting/laendertabelle
1640844300,688,566,122,209,128,https://www.intensivregister.de/api/public/reporting/laendertabelle
1640847900,688,563,125,207,129,https://www.intensivregister.de/api/public/reporting/laendertabelle
1640851500,688,563,125,210,129,https://www.intensivregister.de/api/public/reporting/laendertabelle
1640855100,688,561,127,210,131,https://www.intensivregister.de/api/public/reporting/laendertabelle
1640858700,688,561,127,209,129,https://www.intensivregister.de/api/public/reporting/laendertabelle
1640905500,688,560,128,209,129,https://www.intensivregister.de/api/public/reporting/laendertabelle
1640927100,688,556,132,208,127,https://www.intensivregister.de/api/public/reporting/laendertabelle
1640930700,688,557,131,208,126,https://www.intensivregister.de/api/public/reporting/laendertabelle
1640934300,685,556,129,207,128,https://www.intensivregister.de/api/public/reporting/laendertabelle
1640937900,690,558,132,206,127,https://www.intensivregister.de/api/public/reporting/laendertabelle
1640941500,690,560,130,207,125,https://www.intensivregister.de/api/public/reporting/laendertabelle
1640945100,690,561,129,209,125,https://www.intensivregister.de/api/public/reporting/laendertabelle
1640991900,690,562,128,210,125,https://www.intensivregister.de/api/public/reporting/laendertabelle
1641013500,690,561,129,209,125,https://www.intensivregister.de/api/public/reporting/laendertabelle
1641017100,690,559,131,206,122,https://www.intensivregister.de/api/public/reporting/laendertabelle
1641020700,689,565,124,208,122,https://www.intensivregister.de/api/public/reporting/laendertabelle
1641024300,688,563,125,210,122,https://www.intensivregister.de/api/public/reporting/laendertabelle
1641027900,689,559,130,210,122,https://www.intensivregister.de/api/public/reporting/laendertabelle
1641031500,689,557,132,210,121,https://www.intensivregister.de/api/public/reporting/laendertabelle
1641035100,689,557,132,211,122,https://www.intensivregister.de/api/public/reporting/laendertabelle
1641078300,689,556,133,213,122,https://www.intensivregister.de/api/public/reporting/laendertabelle
1641089100,689,559,130,213,122,https://www.intensivregister.de/api/public/reporting/laendertabelle
1641099900,689,560,129,214,122,https://www.intensivregister.de/api/public/reporting/laendertabelle
1641103500,690,558,132,213,121,https://www.intensivregister.de/api/public/reporting/laendertabelle
1641107100,688,557,131,214,121,https://www.intensivregister.de/api/public/reporting/laendertabelle
1641110700,686,558,128,213,121,https://www.intensivregister.de/api/public/reporting/laendertabelle
1641114300,685,557,128,213,118,https://www.intensivregister.de/api/public/reporting/laendertabelle
1641182700,686,557,129,212,119,https://www.intensivregister.de/api/public/reporting/laendertabelle
1641186300,685,551,134,212,115,https://www.intensivregister.de/api/public/reporting/laendertabelle
1641189900,686,549,137,215,115,https://www.intensivregister.de/api/public/reporting/laendertabelle
1641193500,687,555,132,219,117,https://www.intensivregister.de/api/public/reporting/laendertabelle
1641197100,685,561,124,221,119,https://www.intensivregister.de/api/public/reporting/laendertabelle
1641200700,685,561,124,223,119,https://www.intensivregister.de/api/public/reporting/laendertabelle
1641207900,685,561,124,221,120,https://www.intensivregister.de/api/public/reporting/laendertabelle
1641218700,685,560,125,221,120,https://www.intensivregister.de/api/public/reporting/laendertabelle
1641251100,685,558,127,220,120,https://www.intensivregister.de/api/public/reporting/laendertabelle
1641272700,690,568,122,214,119,https://www.intensivregister.de/api/public/reporting/laendertabelle
1641276300,697,573,124,213,116,https://www.intensivregister.de/api/public/reporting/laendertabelle
1641279900,697,571,126,209,114,https://www.intensivregister.de/api/public/reporting/laendertabelle
1641283500,697,567,130,211,117,https://www.intensivregister.de/api/public/reporting/laendertabelle
1641337500,697,567,130,212,117,https://www.intensivregister.de/api/public/reporting/laendertabelle
1641355500,698,570,128,212,117,https://www.intensivregister.de/api/public/reporting/laendertabelle
1641359100,700,573,127,211,114,https://www.intensivregister.de/api/public/reporting/laendertabelle
1641362700,700,569,131,207,115,https://www.intensivregister.de/api/public/reporting/laendertabelle
1641366300,696,566,130,206,116,https://www.intensivregister.de/api/public/reporting/laendertabelle
1641369900,701,568,133,205,116,https://www.intensivregister.de/api/public/reporting/laendertabelle
1641373500,702,569,133,204,114,https://www.intensivregister.de/api/public/reporting/laendertabelle
1641380700,698,569,129,204,113,https://www.intensivregister.de/api/public/reporting/laendertabelle
1641431100,698,571,127,204,113,https://www.intensivregister.de/api/public/reporting/laendertabelle
1641441900,697,570,127,203,113,https://www.intensivregister.de/api/public/reporting/laendertabelle
1641445500,696,570,126,203,116,https://www.intensivregister.de/api/public/reporting/laendertabelle
1641449100,701,572,129,198,114,https://www.intensivregister.de/api/public/reporting/laendertabelle
1641452700,701,571,130,194,113,https://www.intensivregister.de/api/public/reporting/laendertabelle
1641456300,701,569,132,195,113,https://www.intensivregister.de/api/public/reporting/laendertabelle
1641459900,701,567,134,197,115,https://www.intensivregister.de/api/public/reporting/laendertabelle
1641463500,701,569,132,198,115,https://www.intensivregister.de/api/public/reporting/laendertabelle
1641495900,701,569,132,199,115,https://www.intensivregister.de/api/public/reporting/laendertabelle
1641506700,701,568,133,199,115,https://www.intensivregister.de/api/public/reporting/laendertabelle
1641528300,702,569,133,200,114,https://www.intensivregister.de/api/public/reporting/laendertabelle
1641531900,696,565,131,200,113,https://www.intensivregister.de/api/public/reporting/laendertabelle
1641535500,697,567,130,204,112,https://www.intensivregister.de/api/public/reporting/laendertabelle
1641539100,697,570,127,200,107,https://www.intensivregister.de/api/public/reporting/laendertabelle
1641542700,697,571,126,200,107,https://www.intensivregister.de/api/public/reporting/laendertabelle
1641546300,697,573,124,200,107,https://www.intensivregister.de/api/public/reporting/laendertabelle
1641600300,697,576,121,200,107,https://www.intensivregister.de/api/public/reporting/laendertabelle
1641618300,697,574,123,198,107,https://www.intensivregister.de/api/public/reporting/laendertabelle
1641621900,696,566,130,190,108,https://www.intensivregister.de/api/public/reporting/laendertabelle
1641625500,697,565,132,188,95,https://www.intensivregister.de/api/public/reporting/laendertabelle
1641629100,697,564,133,185,96,https://www.intensivregister.de/api/public/reporting/laendertabelle
1641632700,698,563,135,184,94,https://www.intensivregister.de/api/public/reporting/laendertabelle
1641683100,698,562,136,184,94,https://www.intensivregister.de/api/public/reporting/laendertabelle
1641686700,698,561,137,184,94,https://www.intensivregister.de/api/public/reporting/laendertabelle
1641697500,698,560,138,184,94,https://www.intensivregister.de/api/public/reporting/laendertabelle
1641704700,698,557,141,184,103,https://www.intensivregister.de/api/public/reporting/laendertabelle
1641708300,697,554,143,184,103,https://www.intensivregister.de/api/public/reporting/laendertabelle
1641719100,698,546,152,180,100,https://www.intensivregister.de/api/public/reporting/laendertabelle
1641722700,695,543,152,179,100,https://www.intensivregister.de/api/public/reporting/laendertabelle
1641762300,695,542,153,178,99,https://www.intensivregister.de/api/public/reporting/laendertabelle
1641787500,694,541,153,178,99,https://www.intensivregister.de/api/public/reporting/laendertabelle
1641791100,694,535,159,170,96,https://www.intensivregister.de/api/public/reporting/laendertabelle
1641794700,694,541,153,171,96,https://www.intensivregister.de/api/public/reporting/laendertabelle
1641798300,694,560,134,175,92,https://www.intensivregister.de/api/public/reporting/laendertabelle
1641805500,694,560,134,174,92,https://www.intensivregister.de/api/public/reporting/laendertabelle
1641866700,694,558,136,174,92,https://www.intensivregister.de/api/public/reporting/laendertabelle
1641877500,700,556,144,168,88,https://www.intensivregister.de/api/public/reporting/laendertabelle
1641881100,700,552,148,168,88,https://www.intensivregister.de/api/public/reporting/laendertabelle
1641884700,700,550,150,163,89,https://www.intensivregister.de/api/public/reporting/laendertabelle
1641888300,700,553,147,162,89,https://www.intensivregister.de/api/public/reporting/laendertabelle
1641891900,700,550,150,161,89,https://www.intensivregister.de/api/public/reporting/laendertabelle
1641913500,700,553,147,162,90,https://www.intensivregister.de/api/public/reporting/laendertabelle
1641942300,700,554,146,162,90,https://www.intensivregister.de/api/public/reporting/laendertabelle
1641956700,700,559,141,162,90,https://www.intensivregister.de/api/public/reporting/laendertabelle
1641963900,700,555,145,157,86,https://www.intensivregister.de/api/public/reporting/laendertabelle
1641967500,701,556,145,155,83,https://www.intensivregister.de/api/public/reporting/laendertabelle
1641971100,701,560,141,156,83,https://www.intensivregister.de/api/public/reporting/laendertabelle
1641978300,701,556,145,157,83,https://www.intensivregister.de/api/public/reporting/laendertabelle
1641981900,701,555,146,157,83,https://www.intensivregister.de/api/public/reporting/laendertabelle
1642028700,701,558,143,158,83,https://www.intensivregister.de/api/public/reporting/laendertabelle
1642032300,701,556,145,159,83,https://www.intensivregister.de/api/public/reporting/laendertabelle
1642046700,701,556,145,160,83,https://www.intensivregister.de/api/public/reporting/laendertabelle
1642050300,703,565,138,156,82,https://www.intensivregister.de/api/public/reporting/laendertabelle
1642053900,703,565,138,152,83,https://www.intensivregister.de/api/public/reporting/laendertabelle
1642057500,703,569,134,151,85,https://www.intensivregister.de/api/public/reporting/laendertabelle
1642061100,703,571,132,151,84,https://www.intensivregister.de/api/public/reporting/laendertabelle
1642064700,703,569,134,151,84,https://www.intensivregister.de/api/public/reporting/laendertabelle
1642079100,703,567,136,149,83,https://www.intensivregister.de/api/public/reporting/laendertabelle
1642115100,703,568,135,149,83,https://www.intensivregister.de/api/public/reporting/laendertabelle
1642122300,703,569,134,150,83,https://www.intensivregister.de/api/public/reporting/laendertabelle
1642129500,703,569,134,149,83,https://www.intensivregister.de/api/public/reporting/laendertabelle
1642133100,703,567,136,145,83,https://www.intensivregister.de/api/public/reporting/laendertabelle
1642136700,704,571,133,148,84,https://www.intensivregister.de/api/public/reporting/laendertabelle
1642140300,704,567,137,145,82,https://www.intensivregister.de/api/public/reporting/laendertabelle
1642143900,704,572,132,142,82,https://www.intensivregister.de/api/public/reporting/laendertabelle
1642147500,704,568,136,142,82,https://www.intensivregister.de/api/public/reporting/laendertabelle
1642151100,704,571,133,142,82,https://www.intensivregister.de/api/public/reporting/laendertabelle
1642154700,704,571,133,143,82,https://www.intensivregister.de/api/public/reporting/laendertabelle
1642172700,704,573,131,144,82,https://www.intensivregister.de/api/public/reporting/laendertabelle
1642205100,710,572,138,143,81,https://www.intensivregister.de/api/public/reporting/laendertabelle
1642219500,710,571,139,142,81,https://www.intensivregister.de/api/public/reporting/laendertabelle
1642223100,710,570,140,142,81,https://www.intensivregister.de/api/public/reporting/laendertabelle
1642226700,710,565,145,143,81,https://www.intensivregister.de/api/public/reporting/laendertabelle
1642230300,710,568,142,142,82,https://www.intensivregister.de/api/public/reporting/laendertabelle
1642233900,708,566,142,140,80,https://www.intensivregister.de/api/public/reporting/laendertabelle
1642237500,709,569,140,140,80,https://www.intensivregister.de/api/public/reporting/laendertabelle
1642295100,709,572,137,140,80,https://www.intensivregister.de/api/public/reporting/laendertabelle
1642313100,709,569,140,140,79,https://www.intensivregister.de/api/public/reporting/laendertabelle
1642316700,706,563,143,140,78,https://www.intensivregister.de/api/public/reporting/laendertabelle
1642320300,704,554,150,138,80,https://www.intensivregister.de/api/public/reporting/laendertabelle
1642323900,703,553,150,136,79,https://www.intensivregister.de/api/public/reporting/laendertabelle
1642327500,701,548,153,135,78,https://www.intensivregister.de/api/public/reporting/laendertabelle
1642370700,701,547,154,135,78,https://www.intensivregister.de/api/public/reporting/laendertabelle
1642381500,701,549,152,135,78,https://www.intensivregister.de/api/public/reporting/laendertabelle
1642392300,700,548,152,135,78,https://www.intensivregister.de/api/public/reporting/laendertabelle
1642395900,701,557,144,137,79,https://www.intensivregister.de/api/public/reporting/laendertabelle
1642399500,701,564,137,139,80,https://www.intensivregister.de/api/public/reporting/laendertabelle
1642403100,701,562,139,137,77,https://www.intensivregister.de/api/public/reporting/laendertabelle
1642406700,701,561,140,136,77,https://www.intensivregister.de/api/public/reporting/laendertabelle
1642410300,702,563,139,137,77,https://www.intensivregister.de/api/public/reporting/laendertabelle
1642413900,702,564,138,137,77,https://www.intensivregister.de/api/public/reporting/laendertabelle
1642460700,702,563,139,137,77,https://www.intensivregister.de/api/public/reporting/laendertabelle
1642467900,702,560,142,137,77,https://www.intensivregister.de/api/public/reporting/laendertabelle
1642478701,703,561,142,137,77,https://www.intensivregister.de/api/public/reporting/laendertabelle
1642482300,707,569,138,137,79,https://www.intensivregister.de/api/public/reporting/laendertabelle
1642485900,707,573,134,135,80,https://www.intensivregister.de/api/public/reporting/laendertabelle
1642489500,708,575,133,135,80,https://www.intensivregister.de/api/public/reporting/laendertabelle
1642493100,708,574,134,133,79,https://www.intensivregister.de/api/public/reporting/laendertabelle
1642496700,707,575,132,133,80,https://www.intensivregister.de/api/public/reporting/laendertabelle
1642500300,707,574,133,133,80,https://www.intensivregister.de/api/public/reporting/laendertabelle
1642521900,707,574,133,135,80,https://www.intensivregister.de/api/public/reporting/laendertabelle
1642554300,707,575,132,135,80,https://www.intensivregister.de/api/public/reporting/laendertabelle
1642565100,705,573,132,134,79,https://www.intensivregister.de/api/public/reporting/laendertabelle
1642568700,707,577,130,131,77,https://www.intensivregister.de/api/public/reporting/laendertabelle
1642572300,707,572,135,129,76,https://www.intensivregister.de/api/public/reporting/laendertabelle
1642575900,707,571,136,126,75,https://www.intensivregister.de/api/public/reporting/laendertabelle
1642579500,706,569,137,123,75,https://www.intensivregister.de/api/public/reporting/laendertabelle
1642586700,706,568,138,122,74,https://www.intensivregister.de/api/public/reporting/laendertabelle
1642608300,706,570,136,122,74,https://www.intensivregister.de/api/public/reporting/laendertabelle
1642633500,706,567,139,122,74,https://www.intensivregister.de/api/public/reporting/laendertabelle
1642651500,707,568,139,121,74,https://www.intensivregister.de/api/public/reporting/laendertabelle
1642655100,707,567,140,121,73,https://www.intensivregister.de/api/public/reporting/laendertabelle
1642658700,709,557,152,119,70,https://www.intensivregister.de/api/public/reporting/laendertabelle
1642662300,709,556,153,117,69,https://www.intensivregister.de/api/public/reporting/laendertabelle
1642665900,706,552,154,116,69,https://www.intensivregister.de/api/public/reporting/laendertabelle
1642669500,706,553,153,116,69,https://www.intensivregister.de/api/public/reporting/laendertabelle
1642673100,706,551,155,115,68,https://www.intensivregister.de/api/public/reporting/laendertabelle
1642691100,703,551,152,115,68,https://www.intensivregister.de/api/public/reporting/laendertabelle
1642719900,703,549,154,115,68,https://www.intensivregister.de/api/public/reporting/laendertabelle
1642737900,704,550,154,115,68,https://www.intensivregister.de/api/public/reporting/laendertabelle
1642741500,703,549,154,104,58,https://www.intensivregister.de/api/public/reporting/laendertabelle
1642745100,705,548,157,105,57,https://www.intensivregister.de/api/public/reporting/laendertabelle
1642748700,705,548,157,106,59,https://www.intensivregister.de/api/public/reporting/laendertabelle
1642752300,711,551,160,106,59,https://www.intensivregister.de/api/public/reporting/laendertabelle
1642755900,711,554,157,105,59,https://www.intensivregister.de/api/public/reporting/laendertabelle
1642759500,711,552,159,105,55,https://www.intensivregister.de/api/public/reporting/laendertabelle
1642806300,711,551,160,105,55,https://www.intensivregister.de/api/public/reporting/laendertabelle
1642831500,712,542,170,104,56,https://www.intensivregister.de/api/public/reporting/laendertabelle
1642835100,712,544,168,105,57,https://www.intensivregister.de/api/public/reporting/laendertabelle
1642838700,706,546,160,100,57,https://www.intensivregister.de/api/public/reporting/laendertabelle
1642842300,706,542,164,99,56,https://www.intensivregister.de/api/public/reporting/laendertabelle
1642845900,701,546,155,99,56,https://www.intensivregister.de/api/public/reporting/laendertabelle
1642892700,701,547,154,99,56,https://www.intensivregister.de/api/public/reporting/laendertabelle
1642899900,701,548,153,99,56,https://www.intensivregister.de/api/public/reporting/laendertabelle
1642914300,701,551,150,100,56,https://www.intensivregister.de/api/public/reporting/laendertabelle
1642917900,701,551,150,99,56,https://www.intensivregister.de/api/public/reporting/laendertabelle
1642921500,699,545,154,98,55,https://www.intensivregister.de/api/public/reporting/laendertabelle
1642925100,699,541,158,95,56,https://www.intensivregister.de/api/public/reporting/laendertabelle
1642928700,700,544,156,96,55,https://www.intensivregister.de/api/public/reporting/laendertabelle
1642932300,703,535,168,95,55,https://www.intensivregister.de/api/public/reporting/laendertabelle
1642989900,703,536,167,95,55,https://www.intensivregister.de/api/public/reporting/laendertabelle
1642997100,702,535,167,95,55,https://www.intensivregister.de/api/public/reporting/laendertabelle
1643000700,704,533,171,96,55,https://www.intensivregister.de/api/public/reporting/laendertabelle
1643004300,704,534,170,96,54,https://www.intensivregister.de/api/public/reporting/laendertabelle
1643007900,701,530,171,97,52,https://www.intensivregister.de/api/public/reporting/laendertabelle
1643011500,698,534,164,97,52,https://www.intensivregister.de/api/public/reporting/laendertabelle
1643015100,702,536,166,97,52,https://www.intensivregister.de/api/public/reporting/laendertabelle
1643018700,702,537,165,97,52,https://www.intensivregister.de/api/public/reporting/laendertabelle
1643072700,702,538,164,97,52,https://www.intensivregister.de/api/public/reporting/laendertabelle
1643083500,704,540,164,96,51,https://www.intensivregister.de/api/public/reporting/laendertabelle
1643087100,704,535,169,92,51,https://www.intensivregister.de/api/public/reporting/laendertabelle
1643090700,704,541,163,91,51,https://www.intensivregister.de/api/public/reporting/laendertabelle
1643094300,707,548,159,90,49,https://www.intensivregister.de/api/public/reporting/laendertabelle
1643097900,707,549,158,91,49,https://www.intensivregister.de/api/public/reporting/laendertabelle
1643101500,705,550,155,89,48,https://www.intensivregister.de/api/public/reporting/laendertabelle
1643105100,705,552,153,86,48,https://www.intensivregister.de/api/public/reporting/laendertabelle
1643155500,705,553,152,86,48,https://www.intensivregister.de/api/public/reporting/laendertabelle
1643169900,705,553,152,85,48,https://www.intensivregister.de/api/public/reporting/laendertabelle
1643173500,705,553,152,89,48,https://www.intensivregister.de/api/public/reporting/laendertabelle
1643177100,705,552,153,81,44,https://www.intensivregister.de/api/public/reporting/laendertabelle
1643180700,705,552,153,79,44,https://www.intensivregister.de/api/public/reporting/laendertabelle
1643186865,705,553,152,78,43,https://www.intensivregister.de/api/public/reporting/laendertabelle
1643187900,705,550,155,78,43,https://www.intensivregister.de/api/public/reporting/laendertabelle
1643193692,705,551,154,78,43,https://www.intensivregister.de/api/public/reporting/laendertabelle
1643202300,705,553,152,79,43,https://www.intensivregister.de/api/public/reporting/laendertabelle
1643238300,705,557,148,79,43,https://www.intensivregister.de/api/public/reporting/laendertabelle
1643245500,705,558,147,79,43,https://www.intensivregister.de/api/public/reporting/laendertabelle
1643256300,704,556,148,79,43,https://www.intensivregister.de/api/public/reporting/laendertabelle
1643259900,700,563,137,77,43,https://www.intensivregister.de/api/public/reporting/laendertabelle
1643264654,700,564,136,73,42,https://www.intensivregister.de/api/public/reporting/laendertabelle
1643270700,700,564,136,69,38,https://www.intensivregister.de/api/public/reporting/laendertabelle
1643274300,700,567,133,69,39,https://www.intensivregister.de/api/public/reporting/laendertabelle
1643277900,700,565,135,69,41,https://www.intensivregister.de/api/public/reporting/laendertabelle
1643339100,700,563,137,69,41,https://www.intensivregister.de/api/public/reporting/laendertabelle
1643342700,700,557,143,69,41,https://www.intensivregister.de/api/public/reporting/laendertabelle
1643346300,704,555,149,66,39,https://www.intensivregister.de/api/public/reporting/laendertabelle
1643349900,704,551,153,65,38,https://www.intensivregister.de/api/public/reporting/laendertabelle
1643353500,704,549,155,62,38,https://www.intensivregister.de/api/public/reporting/laendertabelle
1643357100,703,551,152,62,38,https://www.intensivregister.de/api/public/reporting/laendertabelle
1643360700,703,549,154,62,36,https://www.intensivregister.de/api/public/reporting/laendertabelle
1643364300,703,547,156,63,35,https://www.intensivregister.de/api/public/reporting/laendertabelle
1643389500,703,548,155,63,35,https://www.intensivregister.de/api/public/reporting/laendertabelle
1643411100,703,547,156,63,35,https://www.intensivregister.de/api/public/reporting/laendertabelle
1643429100,703,544,159,63,34,https://www.intensivregister.de/api/public/reporting/laendertabelle
1643432700,703,546,157,63,34,https://www.intensivregister.de/api/public/reporting/laendertabelle
1643436300,701,550,151,64,35,https://www.intensivregister.de/api/public/reporting/laendertabelle
1643439900,701,548,153,66,34,https://www.intensivregister.de/api/public/reporting/laendertabelle
1643443500,700,548,152,65,34,https://www.intensivregister.de/api/public/reporting/laendertabelle
1643447100,700,550,150,64,33,https://www.intensivregister.de/api/public/reporting/laendertabelle
1643497500,700,552,148,64,33,https://www.intensivregister.de/api/public/reporting/laendertabelle
1643501100,700,553,147,64,33,https://www.intensivregister.de/api/public/reporting/laendertabelle
1643519100,700,551,149,64,33,https://www.intensivregister.de/api/public/reporting/laendertabelle
1643522700,701,546,155,64,34,https://www.intensivregister.de/api/public/reporting/laendertabelle
1643526300,699,532,167,62,31,https://www.intensivregister.de/api/public/reporting/laendertabelle
1643529900,699,526,173,60,29,https://www.intensivregister.de/api/public/reporting/laendertabelle
1643537100,697,521,176,60,29,https://www.intensivregister.de/api/public/reporting/laendertabelle
1643583900,696,519,177,60,29,https://www.intensivregister.de/api/public/reporting/laendertabelle
1643587500,696,522,174,60,29,https://www.intensivregister.de/api/public/reporting/laendertabelle
1643601900,694,524,170,60,30,https://www.intensivregister.de/api/public/reporting/laendertabelle
1643605500,691,519,172,59,30,https://www.intensivregister.de/api/public/reporting/laendertabelle
1643609100,693,520,173,59,30,https://www.intensivregister.de/api/public/reporting/laendertabelle
1643612700,693,517,176,59,30,https://www.intensivregister.de/api/public/reporting/laendertabelle
1643616300,693,515,178,59,30,https://www.intensivregister.de/api/public/reporting/laendertabelle
1643619900,693,512,181,59,29,https://www.intensivregister.de/api/public/reporting/laendertabelle
1643623500,693,514,179,59,29,https://www.intensivregister.de/api/public/reporting/laendertabelle
1643673900,693,515,178,59,29,https://www.intensivregister.de/api/public/reporting/laendertabelle
1643688300,693,512,181,59,29,https://www.intensivregister.de/api/public/reporting/laendertabelle
1643691900,695,518,177,58,27,https://www.intensivregister.de/api/public/reporting/laendertabelle
1643695500,694,537,157,61,29,https://www.intensivregister.de/api/public/reporting/laendertabelle
1643699100,694,535,159,63,27,https://www.intensivregister.de/api/public/reporting/laendertabelle
1643756700,694,538,156,63,28,https://www.intensivregister.de/api/public/reporting/laendertabelle
1643760300,694,537,157,63,28,https://www.intensivregister.de/api/public/reporting/laendertabelle
1643774700,694,538,156,63,28,https://www.intensivregister.de/api/public/reporting/laendertabelle
1643778300,699,549,150,59,25,https://www.intensivregister.de/api/public/reporting/laendertabelle
1643781900,699,543,156,63,27,https://www.intensivregister.de/api/public/reporting/laendertabelle
1643785500,699,554,145,64,28,https://www.intensivregister.de/api/public/reporting/laendertabelle
1643789100,699,555,144,65,28,https://www.intensivregister.de/api/public/reporting/laendertabelle
1643792700,699,553,146,66,28,https://www.intensivregister.de/api/public/reporting/laendertabelle
1643796300,699,554,145,66,28,https://www.intensivregister.de/api/public/reporting/laendertabelle
1643799900,699,553,146,65,27,https://www.intensivregister.de/api/public/reporting/laendertabelle
1643810700,699,552,147,65,27,https://www.intensivregister.de/api/public/reporting/laendertabelle
1643828700,699,551,148,65,27,https://www.intensivregister.de/api/public/reporting/laendertabelle
1643853900,699,552,147,65,27,https://www.intensivregister.de/api/public/reporting/laendertabelle
1643864700,700,553,147,57,26,https://www.intensivregister.de/api/public/reporting/laendertabelle
1643868300,700,553,147,58,26,https://www.intensivregister.de/api/public/reporting/laendertabelle
1643871900,700,553,147,57,26,https://www.intensivregister.de/api/public/reporting/laendertabelle
1643875500,700,552,148,56,25,https://www.intensivregister.de/api/public/reporting/laendertabelle
1643879100,700,553,147,55,25,https://www.intensivregister.de/api/public/reporting/laendertabelle
1643940300,700,555,145,55,25,https://www.intensivregister.de/api/public/reporting/laendertabelle
1643947500,700,556,144,55,25,https://www.intensivregister.de/api/public/reporting/laendertabelle
1643951100,698,544,154,55,26,https://www.intensivregister.de/api/public/reporting/laendertabelle
1643954700,698,539,159,54,26,https://www.intensivregister.de/api/public/reporting/laendertabelle
1643958300,698,534,164,55,26,https://www.intensivregister.de/api/public/reporting/laendertabelle
1643961900,699,539,160,55,27,https://www.intensivregister.de/api/public/reporting/laendertabelle
1643969100,700,542,158,55,27,https://www.intensivregister.de/api/public/reporting/laendertabelle
1644023100,697,542,155,55,27,https://www.intensivregister.de/api/public/reporting/laendertabelle
1644030300,697,544,153,55,27,https://www.intensivregister.de/api/public/reporting/laendertabelle
1644037500,697,545,152,55,27,https://www.intensivregister.de/api/public/reporting/laendertabelle
1644041100,691,541,150,55,27,https://www.intensivregister.de/api/public/reporting/laendertabelle
1644044700,691,540,151,57,27,https://www.intensivregister.de/api/public/reporting/laendertabelle
1644048300,694,544,150,55,28,https://www.intensivregister.de/api/public/reporting/laendertabelle
1644051900,695,538,157,53,27,https://www.intensivregister.de/api/public/reporting/laendertabelle
1644055500,695,543,152,54,27,https://www.intensivregister.de/api/public/reporting/laendertabelle
1644102300,695,544,151,55,28,https://www.intensivregister.de/api/public/reporting/laendertabelle
1644109500,695,545,150,55,28,https://www.intensivregister.de/api/public/reporting/laendertabelle
1644127500,696,550,146,55,28,https://www.intensivregister.de/api/public/reporting/laendertabelle
1644131100,696,540,156,55,27,https://www.intensivregister.de/api/public/reporting/laendertabelle
1644134700,696,547,149,54,26,https://www.intensivregister.de/api/public/reporting/laendertabelle
1644138300,695,547,148,54,27,https://www.intensivregister.de/api/public/reporting/laendertabelle
1644206700,694,542,152,54,27,https://www.intensivregister.de/api/public/reporting/laendertabelle
1644210300,695,547,148,54,28,https://www.intensivregister.de/api/public/reporting/laendertabelle
1644213900,695,545,150,56,27,https://www.intensivregister.de/api/public/reporting/laendertabelle
1644217500,695,540,155,53,27,https://www.intensivregister.de/api/public/reporting/laendertabelle
1644221100,695,543,152,53,27,https://www.intensivregister.de/api/public/reporting/laendertabelle
1644224700,695,539,156,53,27,https://www.intensivregister.de/api/public/reporting/laendertabelle
1644285900,694,538,156,53,27,https://www.intensivregister.de/api/public/reporting/laendertabelle
1644289500,694,537,157,53,27,https://www.intensivregister.de/api/public/reporting/laendertabelle
1644293100,694,536,158,52,27,https://www.intensivregister.de/api/public/reporting/laendertabelle
1644296700,696,544,152,55,26,https://www.intensivregister.de/api/public/reporting/laendertabelle
1644300300,698,553,145,57,25,https://www.intensivregister.de/api/public/reporting/laendertabelle
1644303900,697,558,139,57,25,https://www.intensivregister.de/api/public/reporting/laendertabelle
1644307500,697,554,143,57,25,https://www.intensivregister.de/api/public/reporting/laendertabelle
1644311100,697,555,142,56,26,https://www.intensivregister.de/api/public/reporting/laendertabelle
1644361500,697,548,149,56,26,https://www.intensivregister.de/api/public/reporting/laendertabelle
1644368700,697,547,150,56,26,https://www.intensivregister.de/api/public/reporting/laendertabelle
1644383100,695,542,153,53,24,https://www.intensivregister.de/api/public/reporting/laendertabelle
1644386700,695,548,147,53,25,https://www.intensivregister.de/api/public/reporting/laendertabelle
1644390300,695,550,145,51,25,https://www.intensivregister.de/api/public/reporting/laendertabelle
1644393900,695,552,143,52,25,https://www.intensivregister.de/api/public/reporting/laendertabelle
1644401100,695,556,139,52,25,https://www.intensivregister.de/api/public/reporting/laendertabelle
1644408300,695,555,140,52,25,https://www.intensivregister.de/api/public/reporting/laendertabelle
1644465900,695,554,141,52,25,https://www.intensivregister.de/api/public/reporting/laendertabelle
1644473100,695,559,136,54,25,https://www.intensivregister.de/api/public/reporting/laendertabelle
1644476700,694,558,136,55,25,https://www.intensivregister.de/api/public/reporting/laendertabelle
1644480300,694,559,135,55,25,https://www.intensivregister.de/api/public/reporting/laendertabelle
1644541500,694,560,134,55,25,https://www.intensivregister.de/api/public/reporting/laendertabelle
1644552300,694,559,135,56,25,https://www.intensivregister.de/api/public/reporting/laendertabelle
1644555900,695,561,134,58,24,https://www.intensivregister.de/api/public/reporting/laendertabelle
1644559500,695,556,139,60,27,https://www.intensivregister.de/api/public/reporting/laendertabelle
1644563100,697,564,133,57,25,https://www.intensivregister.de/api/public/reporting/laendertabelle
1644566700,700,566,134,56,25,https://www.intensivregister.de/api/public/reporting/laendertabelle
1644570300,701,569,132,56,25,https://www.intensivregister.de/api/public/reporting/laendertabelle
1644642300,698,564,134,56,25,https://www.intensivregister.de/api/public/reporting/laendertabelle
1644645900,703,556,147,53,23,https://www.intensivregister.de/api/public/reporting/laendertabelle
1644649500,703,556,147,52,22,https://www.intensivregister.de/api/public/reporting/laendertabelle
1644653100,697,548,149,53,24,https://www.intensivregister.de/api/public/reporting/laendertabelle
1644656700,697,546,151,53,24,https://www.intensivregister.de/api/public/reporting/laendertabelle
1644710700,697,544,153,53,24,https://www.intensivregister.de/api/public/reporting/laendertabelle
1644721500,697,546,151,53,24,https://www.intensivregister.de/api/public/reporting/laendertabelle
1644728700,695,543,152,53,24,https://www.intensivregister.de/api/public/reporting/laendertabelle
1644732300,696,542,154,53,24,https://www.intensivregister.de/api/public/reporting/laendertabelle
1644735900,696,536,160,55,24,https://www.intensivregister.de/api/public/reporting/laendertabelle
1644739500,696,533,163,55,24,https://www.intensivregister.de/api/public/reporting/laendertabelle
1644743100,694,528,166,54,23,https://www.intensivregister.de/api/public/reporting/laendertabelle
1644746700,694,528,166,55,23,https://www.intensivregister.de/api/public/reporting/laendertabelle
1644811500,694,526,168,55,23,https://www.intensivregister.de/api/public/reporting/laendertabelle
1644815100,693,531,162,52,23,https://www.intensivregister.de/api/public/reporting/laendertabelle
1644818700,691,532,159,55,23,https://www.intensivregister.de/api/public/reporting/laendertabelle
1644822300,691,534,157,56,23,https://www.intensivregister.de/api/public/reporting/laendertabelle
1644825900,691,533,158,55,22,https://www.intensivregister.de/api/public/reporting/laendertabelle
1644836700,691,533,158,53,21,https://www.intensivregister.de/api/public/reporting/laendertabelle
1644876300,691,531,160,53,21,https://www.intensivregister.de/api/public/reporting/laendertabelle
1644887100,691,533,158,53,21,https://www.intensivregister.de/api/public/reporting/laendertabelle
1644901500,688,524,164,56,29,https://www.intensivregister.de/api/public/reporting/laendertabelle
1644905100,688,527,161,57,29,https://www.intensivregister.de/api/public/reporting/laendertabelle
1644908700,688,520,168,53,28,https://www.intensivregister.de/api/public/reporting/laendertabelle
1644912300,688,520,168,55,28,https://www.intensivregister.de/api/public/reporting/laendertabelle
1644919500,688,521,167,55,27,https://www.intensivregister.de/api/public/reporting/laendertabelle
1644923103,688,522,166,55,27,https://www.intensivregister.de/api/public/reporting/laendertabelle
1644966300,688,525,163,55,27,https://www.intensivregister.de/api/public/reporting/laendertabelle
1644987900,688,530,158,51,24,https://www.intensivregister.de/api/public/reporting/laendertabelle
1644991500,688,530,158,52,25,https://www.intensivregister.de/api/public/reporting/laendertabelle
1644995100,690,528,162,50,23,https://www.intensivregister.de/api/public/reporting/laendertabelle
1644998700,690,533,157,49,23,https://www.intensivregister.de/api/public/reporting/laendertabelle
1645002300,690,531,159,49,23,https://www.intensivregister.de/api/public/reporting/laendertabelle
1645005900,690,532,158,49,23,https://www.intensivregister.de/api/public/reporting/laendertabelle
1645052700,690,529,161,49,23,https://www.intensivregister.de/api/public/reporting/laendertabelle
1645063500,690,531,159,49,23,https://www.intensivregister.de/api/public/reporting/laendertabelle
1645074300,692,530,162,49,24,https://www.intensivregister.de/api/public/reporting/laendertabelle
1645077900,690,532,158,45,23,https://www.intensivregister.de/api/public/reporting/laendertabelle
1645081500,690,535,155,45,23,https://www.intensivregister.de/api/public/reporting/laendertabelle
1645085100,688,533,155,45,23,https://www.intensivregister.de/api/public/reporting/laendertabelle
1645088700,688,531,157,44,23,https://www.intensivregister.de/api/public/reporting/laendertabelle
1645139100,688,530,158,44,23,https://www.intensivregister.de/api/public/reporting/laendertabelle
1645157100,690,533,157,44,23,https://www.intensivregister.de/api/public/reporting/laendertabelle
1645160700,688,525,163,41,21,https://www.intensivregister.de/api/public/reporting/laendertabelle
1645164300,688,524,164,41,21,https://www.intensivregister.de/api/public/reporting/laendertabelle
1645167900,688,525,163,41,21,https://www.intensivregister.de/api/public/reporting/laendertabelle
1645171500,688,523,165,41,21,https://www.intensivregister.de/api/public/reporting/laendertabelle
1645175100,688,524,164,41,21,https://www.intensivregister.de/api/public/reporting/laendertabelle
1645178700,688,525,163,41,21,https://www.intensivregister.de/api/public/reporting/laendertabelle
1645229100,688,527,161,41,21,https://www.intensivregister.de/api/public/reporting/laendertabelle
1645243500,688,524,164,41,21,https://www.intensivregister.de/api/public/reporting/laendertabelle
1645247100,688,527,161,41,21,https://www.intensivregister.de/api/public/reporting/laendertabelle
1645250700,687,528,159,42,19,https://www.intensivregister.de/api/public/reporting/laendertabelle
1645254300,688,534,154,43,19,https://www.intensivregister.de/api/public/reporting/laendertabelle
1645257900,688,529,159,43,18,https://www.intensivregister.de/api/public/reporting/laendertabelle
1645261500,688,532,156,44,18,https://www.intensivregister.de/api/public/reporting/laendertabelle
1645279500,688,531,157,44,19,https://www.intensivregister.de/api/public/reporting/laendertabelle
1645311900,688,532,156,44,19,https://www.intensivregister.de/api/public/reporting/laendertabelle
1645315500,688,531,157,44,19,https://www.intensivregister.de/api/public/reporting/laendertabelle
1645319100,688,532,156,44,19,https://www.intensivregister.de/api/public/reporting/laendertabelle
1645333500,687,529,158,45,19,https://www.intensivregister.de/api/public/reporting/laendertabelle
1645337100,688,525,163,45,19,https://www.intensivregister.de/api/public/reporting/laendertabelle
1645340700,688,520,168,45,19,https://www.intensivregister.de/api/public/reporting/laendertabelle
1645344300,689,518,171,45,20,https://www.intensivregister.de/api/public/reporting/laendertabelle
1645347900,686,514,172,43,19,https://www.intensivregister.de/api/public/reporting/laendertabelle
1645398300,686,513,173,43,19,https://www.intensivregister.de/api/public/reporting/laendertabelle
1645416300,686,512,174,43,19,https://www.intensivregister.de/api/public/reporting/laendertabelle
1645419900,684,518,166,42,18,https://www.intensivregister.de/api/public/reporting/laendertabelle
1645423500,686,515,171,40,17,https://www.intensivregister.de/api/public/reporting/laendertabelle
1645427100,686,521,165,42,17,https://www.intensivregister.de/api/public/reporting/laendertabelle
1645430700,686,522,164,42,17,https://www.intensivregister.de/api/public/reporting/laendertabelle
1645434300,685,520,165,43,18,https://www.intensivregister.de/api/public/reporting/laendertabelle
1645491900,685,519,166,43,18,https://www.intensivregister.de/api/public/reporting/laendertabelle
1645502700,685,521,164,43,18,https://www.intensivregister.de/api/public/reporting/laendertabelle
1645506300,687,527,160,44,22,https://www.intensivregister.de/api/public/reporting/laendertabelle
1645509900,687,526,161,43,21,https://www.intensivregister.de/api/public/reporting/laendertabelle
1645513500,690,532,158,44,21,https://www.intensivregister.de/api/public/reporting/laendertabelle
1645571100,690,531,159,44,21,https://www.intensivregister.de/api/public/reporting/laendertabelle
1645574700,690,531,159,45,22,https://www.intensivregister.de/api/public/reporting/laendertabelle
1645592700,693,539,154,48,20,https://www.intensivregister.de/api/public/reporting/laendertabelle
1645596300,694,542,152,46,22,https://www.intensivregister.de/api/public/reporting/laendertabelle
1645599900,693,540,153,47,22,https://www.intensivregister.de/api/public/reporting/laendertabelle
1645607100,693,537,156,46,22,https://www.intensivregister.de/api/public/reporting/laendertabelle
1645610700,693,535,158,46,22,https://www.intensivregister.de/api/public/reporting/laendertabelle
1645617900,693,538,155,46,22,https://www.intensivregister.de/api/public/reporting/laendertabelle
1645657500,693,541,152,46,22,https://www.intensivregister.de/api/public/reporting/laendertabelle
1645661100,693,540,153,46,21,https://www.intensivregister.de/api/public/reporting/laendertabelle
1645675500,693,538,155,46,21,https://www.intensivregister.de/api/public/reporting/laendertabelle
1645679100,692,541,151,41,17,https://www.intensivregister.de/api/public/reporting/laendertabelle
1645682700,694,542,152,46,19,https://www.intensivregister.de/api/public/reporting/laendertabelle
1645686300,692,543,149,45,19,https://www.intensivregister.de/api/public/reporting/laendertabelle
1645693500,693,550,143,46,21,https://www.intensivregister.de/api/public/reporting/laendertabelle
1645701409,693,549,144,46,21,https://www.intensivregister.de/api/public/reporting/laendertabelle
1645740300,693,550,143,46,21,https://www.intensivregister.de/api/public/reporting/laendertabelle
1645761900,691,550,141,46,21,https://www.intensivregister.de/api/public/reporting/laendertabelle
1645765500,690,560,130,46,19,https://www.intensivregister.de/api/public/reporting/laendertabelle
1645769100,690,559,131,47,19,https://www.intensivregister.de/api/public/reporting/laendertabelle
1645772700,685,558,127,47,18,https://www.intensivregister.de/api/public/reporting/laendertabelle
1645776300,685,561,124,47,18,https://www.intensivregister.de/api/public/reporting/laendertabelle
1645779900,685,559,126,46,18,https://www.intensivregister.de/api/public/reporting/laendertabelle
1645783500,685,560,125,46,18,https://www.intensivregister.de/api/public/reporting/laendertabelle
1645830300,686,561,125,46,18,https://www.intensivregister.de/api/public/reporting/laendertabelle
1645848300,686,559,127,48,18,https://www.intensivregister.de/api/public/reporting/laendertabelle
1645851900,686,562,124,49,18,https://www.intensivregister.de/api/public/reporting/laendertabelle
1645855500,688,562,126,49,20,https://www.intensivregister.de/api/public/reporting/laendertabelle
1645859100,687,568,119,53,19,https://www.intensivregister.de/api/public/reporting/laendertabelle
1645862700,686,564,122,51,21,https://www.intensivregister.de/api/public/reporting/laendertabelle
1645866300,685,559,126,52,21,https://www.intensivregister.de/api/public/reporting/laendertabelle
1645923900,685,559,126,53,21,https://www.intensivregister.de/api/public/reporting/laendertabelle
1645934700,685,557,128,53,21,https://www.intensivregister.de/api/public/reporting/laendertabelle
1645938300,685,550,135,51,21,https://www.intensivregister.de/api/public/reporting/laendertabelle
1645941900,685,551,134,53,22,https://www.intensivregister.de/api/public/reporting/laendertabelle
1645945500,679,547,132,52,18,https://www.intensivregister.de/api/public/reporting/laendertabelle
1645949100,674,533,141,51,20,https://www.intensivregister.de/api/public/reporting/laendertabelle
1645959900,674,533,141,52,22,https://www.intensivregister.de/api/public/reporting/laendertabelle
1646017500,673,531,142,52,22,https://www.intensivregister.de/api/public/reporting/laendertabelle
1646021100,673,533,140,52,22,https://www.intensivregister.de/api/public/reporting/laendertabelle
1646024700,677,535,142,47,20,https://www.intensivregister.de/api/public/reporting/laendertabelle
1646028300,679,527,152,44,19,https://www.intensivregister.de/api/public/reporting/laendertabelle
1646031900,679,526,153,44,19,https://www.intensivregister.de/api/public/reporting/laendertabelle
1646035500,679,521,158,47,19,https://www.intensivregister.de/api/public/reporting/laendertabelle
1646039100,681,519,162,48,19,https://www.intensivregister.de/api/public/reporting/laendertabelle
1646089500,681,520,161,48,19,https://www.intensivregister.de/api/public/reporting/laendertabelle
1646093100,681,521,160,48,19,https://www.intensivregister.de/api/public/reporting/laendertabelle
1646107500,681,524,157,47,19,https://www.intensivregister.de/api/public/reporting/laendertabelle
1646111100,681,528,153,53,20,https://www.intensivregister.de/api/public/reporting/laendertabelle
1646114700,685,547,138,52,20,https://www.intensivregister.de/api/public/reporting/laendertabelle
1646121900,685,548,137,52,19,https://www.intensivregister.de/api/public/reporting/laendertabelle
1646125500,685,549,136,52,19,https://www.intensivregister.de/api/public/reporting/laendertabelle
1646129100,685,547,138,53,19,https://www.intensivregister.de/api/public/reporting/laendertabelle
1646157900,685,549,136,53,19,https://www.intensivregister.de/api/public/reporting/laendertabelle
1646165100,685,551,134,53,19,https://www.intensivregister.de/api/public/reporting/laendertabelle
1646175900,685,548,137,53,19,https://www.intensivregister.de/api/public/reporting/laendertabelle
1646183100,685,551,134,54,20,https://www.intensivregister.de/api/public/reporting/laendertabelle
1646197500,681,556,125,50,20,https://www.intensivregister.de/api/public/reporting/laendertabelle
1646201100,681,554,127,49,20,https://www.intensivregister.de/api/public/reporting/laendertabelle
1646204700,681,559,122,49,20,https://www.intensivregister.de/api/public/reporting/laendertabelle
1646208300,683,559,124,49,20,https://www.intensivregister.de/api/public/reporting/laendertabelle
1646211900,686,562,124,50,20,https://www.intensivregister.de/api/public/reporting/laendertabelle
1646280300,686,560,126,50,20,https://www.intensivregister.de/api/public/reporting/laendertabelle
1646283900,688,561,127,50,22,https://www.intensivregister.de/api/public/reporting/laendertabelle
1646287500,691,560,131,53,23,https://www.intensivregister.de/api/public/reporting/laendertabelle
1646291100,690,565,125,50,24,https://www.intensivregister.de/api/public/reporting/laendertabelle
1646298300,690,569,121,50,24,https://www.intensivregister.de/api/public/reporting/laendertabelle
1646301900,690,568,122,48,24,https://www.intensivregister.de/api/public/reporting/laendertabelle
1646305500,680,564,116,48,24,https://www.intensivregister.de/api/public/reporting/laendertabelle
1646348700,680,565,115,48,24,https://www.intensivregister.de/api/public/reporting/laendertabelle
1646352300,680,564,116,48,24,https://www.intensivregister.de/api/public/reporting/laendertabelle
1646366700,680,566,114,48,24,https://www.intensivregister.de/api/public/reporting/laendertabelle
1646370300,680,563,117,46,22,https://www.intensivregister.de/api/public/reporting/laendertabelle
1646373900,680,560,120,52,21,https://www.intensivregister.de/api/public/reporting/laendertabelle
1646377500,682,561,121,52,19,https://www.intensivregister.de/api/public/reporting/laendertabelle
1646381100,682,561,121,51,19,https://www.intensivregister.de/api/public/reporting/laendertabelle
1646438700,682,558,124,51,19,https://www.intensivregister.de/api/public/reporting/laendertabelle
1646442300,682,557,125,51,19,https://www.intensivregister.de/api/public/reporting/laendertabelle
1646456700,682,561,121,53,21,https://www.intensivregister.de/api/public/reporting/laendertabelle
1646460300,682,563,119,55,21,https://www.intensivregister.de/api/public/reporting/laendertabelle
1646463900,682,558,124,52,20,https://www.intensivregister.de/api/public/reporting/laendertabelle
1646467500,682,559,123,53,20,https://www.intensivregister.de/api/public/reporting/laendertabelle
1646471100,680,554,126,52,20,https://www.intensivregister.de/api/public/reporting/laendertabelle
1646474700,680,555,125,52,20,https://www.intensivregister.de/api/public/reporting/laendertabelle
1646503500,680,554,126,52,20,https://www.intensivregister.de/api/public/reporting/laendertabelle
1646543100,676,543,133,50,20,https://www.intensivregister.de/api/public/reporting/laendertabelle
1646546700,675,543,132,50,20,https://www.intensivregister.de/api/public/reporting/laendertabelle
1646550300,675,537,138,52,20,https://www.intensivregister.de/api/public/reporting/laendertabelle
1646553900,675,530,145,54,22,https://www.intensivregister.de/api/public/reporting/laendertabelle
1646557500,673,524,149,54,21,https://www.intensivregister.de/api/public/reporting/laendertabelle
1646607900,673,525,148,54,21,https://www.intensivregister.de/api/public/reporting/laendertabelle
1646615100,673,526,147,54,21,https://www.intensivregister.de/api/public/reporting/laendertabelle
1646629500,671,533,138,52,21,https://www.intensivregister.de/api/public/reporting/laendertabelle
1646633100,671,529,142,52,21,https://www.intensivregister.de/api/public/reporting/laendertabelle
1646636700,673,534,139,51,22,https://www.intensivregister.de/api/public/reporting/laendertabelle
1646640300,684,545,139,52,22,https://www.intensivregister.de/api/public/reporting/laendertabelle
1646701500,684,544,140,52,22,https://www.intensivregister.de/api/public/reporting/laendertabelle
1646712300,684,546,138,52,22,https://www.intensivregister.de/api/public/reporting/laendertabelle
1646715900,685,545,140,51,21,https://www.intensivregister.de/api/public/reporting/laendertabelle
1646719500,691,558,133,45,18,https://www.intensivregister.de/api/public/reporting/laendertabelle
1646723100,695,561,134,49,19,https://www.intensivregister.de/api/public/reporting/laendertabelle
1646726700,695,560,135,50,19,https://www.intensivregister.de/api/public/reporting/laendertabelle
1646730300,695,556,139,50,19,https://www.intensivregister.de/api/public/reporting/laendertabelle
1646780700,695,557,138,50,19,https://www.intensivregister.de/api/public/reporting/laendertabelle
1646791500,695,556,139,50,19,https://www.intensivregister.de/api/public/reporting/laendertabelle
1646798700,695,558,137,51,19,https://www.intensivregister.de/api/public/reporting/laendertabelle
1646802300,692,549,143,52,19,https://www.intensivregister.de/api/public/reporting/laendertabelle
1646805900,695,552,143,54,19,https://www.intensivregister.de/api/public/reporting/laendertabelle
1646809500,695,550,145,52,19,https://www.intensivregister.de/api/public/reporting/laendertabelle
1646816700,695,551,144,52,19,https://www.intensivregister.de/api/public/reporting/laendertabelle
1646820300,694,552,142,51,19,https://www.intensivregister.de/api/public/reporting/laendertabelle
1646867100,694,553,141,51,19,https://www.intensivregister.de/api/public/reporting/laendertabelle
1646888700,690,544,146,49,18,https://www.intensivregister.de/api/public/reporting/laendertabelle
1646892300,688,546,142,48,18,https://www.intensivregister.de/api/public/reporting/laendertabelle
1646895900,688,548,140,49,17,https://www.intensivregister.de/api/public/reporting/laendertabelle
1646899500,686,545,141,51,19,https://www.intensivregister.de/api/public/reporting/laendertabelle
1646903100,686,546,140,49,18,https://www.intensivregister.de/api/public/reporting/laendertabelle
1646957100,688,544,144,49,18,https://www.intensivregister.de/api/public/reporting/laendertabelle
1646967900,688,544,144,50,18,https://www.intensivregister.de/api/public/reporting/laendertabelle
1646971500,688,543,145,50,17,https://www.intensivregister.de/api/public/reporting/laendertabelle
1646975100,690,546,144,53,17,https://www.intensivregister.de/api/public/reporting/laendertabelle
1646978700,690,545,145,52,17,https://www.intensivregister.de/api/public/reporting/laendertabelle
1646982300,690,541,149,50,18,https://www.intensivregister.de/api/public/reporting/laendertabelle
1646989500,690,544,146,52,17,https://www.intensivregister.de/api/public/reporting/laendertabelle
1646993100,690,547,143,53,17,https://www.intensivregister.de/api/public/reporting/laendertabelle
1647014700,689,548,141,54,17,https://www.intensivregister.de/api/public/reporting/laendertabelle
1647054300,689,550,139,54,17,https://www.intensivregister.de/api/public/reporting/laendertabelle
1647061500,686,546,140,54,17,https://www.intensivregister.de/api/public/reporting/laendertabelle
1647065100,685,537,148,51,18,https://www.intensivregister.de/api/public/reporting/laendertabelle
1647068700,685,533,152,49,18,https://www.intensivregister.de/api/public/reporting/laendertabelle
1647072300,685,533,152,52,18,https://www.intensivregister.de/api/public/reporting/laendertabelle
1647075900,685,532,153,51,20,https://www.intensivregister.de/api/public/reporting/laendertabelle
1647147900,685,529,156,51,20,https://www.intensivregister.de/api/public/reporting/laendertabelle
1647151500,685,522,163,51,22,https://www.intensivregister.de/api/public/reporting/laendertabelle
1647155100,687,524,163,58,23,https://www.intensivregister.de/api/public/reporting/laendertabelle
1647158700,684,518,166,58,22,https://www.intensivregister.de/api/public/reporting/laendertabelle
1647162300,686,520,166,58,21,https://www.intensivregister.de/api/public/reporting/laendertabelle
1647165900,684,517,167,56,21,https://www.intensivregister.de/api/public/reporting/laendertabelle
1647169500,684,517,167,53,21,https://www.intensivregister.de/api/public/reporting/laendertabelle
1647209100,684,518,166,53,21,https://www.intensivregister.de/api/public/reporting/laendertabelle
1647219900,682,520,162,53,22,https://www.intensivregister.de/api/public/reporting/laendertabelle
1647230700,682,522,160,54,22,https://www.intensivregister.de/api/public/reporting/laendertabelle
1647234300,682,520,162,53,21,https://www.intensivregister.de/api/public/reporting/laendertabelle
1647237900,683,520,163,53,20,https://www.intensivregister.de/api/public/reporting/laendertabelle
1647241500,679,524,155,58,21,https://www.intensivregister.de/api/public/reporting/laendertabelle
1647245100,679,524,155,57,21,https://www.intensivregister.de/api/public/reporting/laendertabelle
1647248700,677,524,153,58,21,https://www.intensivregister.de/api/public/reporting/laendertabelle
1647302700,677,523,154,58,21,https://www.intensivregister.de/api/public/reporting/laendertabelle
1647320700,674,521,153,61,22,https://www.intensivregister.de/api/public/reporting/laendertabelle
1647324300,673,519,154,62,22,https://www.intensivregister.de/api/public/reporting/laendertabelle
1647327900,673,520,153,59,21,https://www.intensivregister.de/api/public/reporting/laendertabelle
1647331500,673,525,148,58,20,https://www.intensivregister.de/api/public/reporting/laendertabelle
1647335100,680,524,156,56,21,https://www.intensivregister.de/api/public/reporting/laendertabelle
1647338700,682,527,155,58,22,https://www.intensivregister.de/api/public/reporting/laendertabelle
1647407100,681,541,140,56,21,https://www.intensivregister.de/api/public/reporting/laendertabelle
1647410700,683,539,144,55,21,https://www.intensivregister.de/api/public/reporting/laendertabelle
1647414300,683,541,142,55,21,https://www.intensivregister.de/api/public/reporting/laendertabelle
1647417900,681,542,139,61,22,https://www.intensivregister.de/api/public/reporting/laendertabelle
1647421500,677,538,139,62,22,https://www.intensivregister.de/api/public/reporting/laendertabelle
1647475540,677,536,141,62,22,https://www.intensivregister.de/api/public/reporting/laendertabelle
1647479147,677,537,140,60,22,https://www.intensivregister.de/api/public/reporting/laendertabelle
1647489942,677,535,142,61,22,https://www.intensivregister.de/api/public/reporting/laendertabelle
1647493546,674,528,146,64,22,https://www.intensivregister.de/api/public/reporting/laendertabelle
1647497143,674,529,145,64,21,https://www.intensivregister.de/api/public/reporting/laendertabelle
1647500747,669,532,137,65,21,https://www.intensivregister.de/api/public/reporting/laendertabelle
1647507942,669,526,143,65,20,https://www.intensivregister.de/api/public/reporting/laendertabelle
1647511546,667,525,142,65,20,https://www.intensivregister.de/api/public/reporting/laendertabelle
1647558349,667,523,144,65,19,https://www.intensivregister.de/api/public/reporting/laendertabelle
1647561944,667,521,146,65,19,https://www.intensivregister.de/api/public/reporting/laendertabelle
1647572739,667,521,146,64,19,https://www.intensivregister.de/api/public/reporting/laendertabelle
1647576339,667,523,144,64,19,https://www.intensivregister.de/api/public/reporting/laendertabelle
1647579944,667,521,146,64,21,https://www.intensivregister.de/api/public/reporting/laendertabelle
1647583546,664,539,125,67,20,https://www.intensivregister.de/api/public/reporting/laendertabelle
1647587145,664,544,120,68,20,https://www.intensivregister.de/api/public/reporting/laendertabelle
1647594350,664,540,124,68,20,https://www.intensivregister.de/api/public/reporting/laendertabelle
1647648342,664,543,121,68,20,https://www.intensivregister.de/api/public/reporting/laendertabelle
1647666346,662,538,124,68,20,https://www.intensivregister.de/api/public/reporting/laendertabelle
1647669948,664,539,125,69,22,https://www.intensivregister.de/api/public/reporting/laendertabelle
1647673540,663,528,135,70,23,https://www.intensivregister.de/api/public/reporting/laendertabelle
1647677140,663,524,139,69,23,https://www.intensivregister.de/api/public/reporting/laendertabelle
1647680742,663,522,141,68,23,https://www.intensivregister.de/api/public/reporting/laendertabelle
1647756346,662,515,147,69,24,https://www.intensivregister.de/api/public/reporting/laendertabelle
1647759946,662,520,142,68,23,https://www.intensivregister.de/api/public/reporting/laendertabelle
1647763544,662,518,144,65,21,https://www.intensivregister.de/api/public/reporting/laendertabelle
1647767143,662,518,144,67,21,https://www.intensivregister.de/api/public/reporting/laendertabelle
1647806741,662,520,142,67,21,https://www.intensivregister.de/api/public/reporting/laendertabelle
1647831944,662,521,141,68,21,https://www.intensivregister.de/api/public/reporting/laendertabelle
1647835545,662,522,140,69,21,https://www.intensivregister.de/api/public/reporting/laendertabelle
1647839142,663,521,142,72,20,https://www.intensivregister.de/api/public/reporting/laendertabelle
1647842739,663,528,135,73,20,https://www.intensivregister.de/api/public/reporting/laendertabelle
1647846346,665,530,135,72,20,https://www.intensivregister.de/api/public/reporting/laendertabelle
1647853545,665,526,139,70,20,https://www.intensivregister.de/api/public/reporting/laendertabelle
1647857145,665,526,139,71,20,https://www.intensivregister.de/api/public/reporting/laendertabelle
1647907578,667,530,137,71,20,https://www.intensivregister.de/api/public/reporting/laendertabelle
1647911174,667,533,134,71,20,https://www.intensivregister.de/api/public/reporting/laendertabelle
1647921990,667,533,134,69,20,https://www.intensivregister.de/api/public/reporting/laendertabelle
1647925579,672,543,129,75,23,https://www.intensivregister.de/api/public/reporting/laendertabelle
1647932791,675,540,135,77,20,https://www.intensivregister.de/api/public/reporting/laendertabelle
1647936388,679,541,138,76,20,https://www.intensivregister.de/api/public/reporting/laendertabelle
1647939990,679,540,139,76,20,https://www.intensivregister.de/api/public/reporting/laendertabelle
1647943568,677,539,138,75,20,https://www.intensivregister.de/api/public/reporting/laendertabelle
1648001167,677,540,137,76,21,https://www.intensivregister.de/api/public/reporting/laendertabelle
1648011969,679,551,128,76,19,https://www.intensivregister.de/api/public/reporting/laendertabelle
1648015599,679,548,131,74,20,https://www.intensivregister.de/api/public/reporting/laendertabelle
1648022796,677,543,134,71,21,https://www.intensivregister.de/api/public/reporting/laendertabelle
1648026390,677,544,133,72,21,https://www.intensivregister.de/api/public/reporting/laendertabelle
1648033574,676,547,129,72,22,https://www.intensivregister.de/api/public/reporting/laendertabelle
1648087589,676,546,130,72,22,https://www.intensivregister.de/api/public/reporting/laendertabelle
1648094787,676,547,129,73,22,https://www.intensivregister.de/api/public/reporting/laendertabelle
1648098391,676,538,138,74,22,https://www.intensivregister.de/api/public/reporting/laendertabelle
1648101977,671,532,139,73,21,https://www.intensivregister.de/api/public/reporting/laendertabelle
1648105567,671,539,132,76,19,https://www.intensivregister.de/api/public/reporting/laendertabelle
1648109194,671,542,129,75,19,https://www.intensivregister.de/api/public/reporting/laendertabelle
1648112795,671,543,128,72,18,https://www.intensivregister.de/api/public/reporting/laendertabelle
1648181194,666,538,128,72,20,https://www.intensivregister.de/api/public/reporting/laendertabelle
1648184789,666,540,126,71,20,https://www.intensivregister.de/api/public/reporting/laendertabelle
1648188394,664,543,121,71,19,https://www.intensivregister.de/api/public/reporting/laendertabelle
1648191994,664,538,126,69,20,https://www.intensivregister.de/api/public/reporting/laendertabelle
1648199176,664,535,129,70,20,https://www.intensivregister.de/api/public/reporting/laendertabelle
1648213523,663,534,129,70,19,https://www.intensivregister.de/api/public/reporting/laendertabelle
1648256722,663,536,127,70,19,https://www.intensivregister.de/api/public/reporting/laendertabelle
1648263926,663,536,127,72,19,https://www.intensivregister.de/api/public/reporting/laendertabelle
1648267531,663,535,128,72,19,https://www.intensivregister.de/api/public/reporting/laendertabelle
1648271118,664,537,127,72,19,https://www.intensivregister.de/api/public/reporting/laendertabelle
1648274723,664,529,135,71,19,https://www.intensivregister.de/api/public/reporting/laendertabelle
1648278327,663,521,142,73,19,https://www.intensivregister.de/api/public/reporting/laendertabelle
1648285526,661,512,149,73,20,https://www.intensivregister.de/api/public/reporting/laendertabelle
1648339530,661,511,150,72,20,https://www.intensivregister.de/api/public/reporting/laendertabelle
1648350320,660,515,145,73,20,https://www.intensivregister.de/api/public/reporting/laendertabelle
1648353922,660,515,145,72,19,https://www.intensivregister.de/api/public/reporting/laendertabelle
1648357533,660,516,144,69,19,https://www.intensivregister.de/api/public/reporting/laendertabelle
1648364719,660,513,147,75,20,https://www.intensivregister.de/api/public/reporting/laendertabelle
1648368326,660,512,148,75,22,https://www.intensivregister.de/api/public/reporting/laendertabelle
1648425919,660,511,149,75,22,https://www.intensivregister.de/api/public/reporting/laendertabelle
1648436718,660,511,149,77,23,https://www.intensivregister.de/api/public/reporting/laendertabelle
1648440320,660,505,155,78,25,https://www.intensivregister.de/api/public/reporting/laendertabelle
1648443923,660,505,155,79,26,https://www.intensivregister.de/api/public/reporting/laendertabelle
1648447515,660,504,156,78,24,https://www.intensivregister.de/api/public/reporting/laendertabelle
1648451119,662,506,156,78,23,https://www.intensivregister.de/api/public/reporting/laendertabelle
1648458317,662,508,154,78,23,https://www.intensivregister.de/api/public/reporting/laendertabelle
1648461932,658,509,149,77,22,https://www.intensivregister.de/api/public/reporting/laendertabelle
1648497931,658,510,148,78,22,https://www.intensivregister.de/api/public/reporting/laendertabelle
1648512322,658,509,149,78,22,https://www.intensivregister.de/api/public/reporting/laendertabelle
1648519523,658,511,147,79,22,https://www.intensivregister.de/api/public/reporting/laendertabelle
1648523121,667,508,159,81,27,https://www.intensivregister.de/api/public/reporting/laendertabelle
1648526730,667,511,156,78,27,https://www.intensivregister.de/api/public/reporting/laendertabelle
1648530320,667,511,156,79,25,https://www.intensivregister.de/api/public/reporting/laendertabelle
1648541130,667,513,154,77,27,https://www.intensivregister.de/api/public/reporting/laendertabelle
1648591518,667,512,155,77,27,https://www.intensivregister.de/api/public/reporting/laendertabelle
1648609521,669,515,154,78,25,https://www.intensivregister.de/api/public/reporting/laendertabelle
1648613118,671,521,150,78,25,https://www.intensivregister.de/api/public/reporting/laendertabelle
1648616717,671,528,143,76,21,https://www.intensivregister.de/api/public/reporting/laendertabelle
1648623918,671,529,142,75,21,https://www.intensivregister.de/api/public/reporting/laendertabelle
1648627517,669,528,141,75,21,https://www.intensivregister.de/api/public/reporting/laendertabelle
1648677931,669,527,142,75,21,https://www.intensivregister.de/api/public/reporting/laendertabelle
1648688717,669,528,141,75,21,https://www.intensivregister.de/api/public/reporting/laendertabelle
1648695918,669,529,140,73,22,https://www.intensivregister.de/api/public/reporting/laendertabelle
1648703119,669,533,136,75,18,https://www.intensivregister.de/api/public/reporting/laendertabelle
1648706721,670,531,139,74,18,https://www.intensivregister.de/api/public/reporting/laendertabelle
1648713928,670,529,141,73,18,https://www.intensivregister.de/api/public/reporting/laendertabelle
1648760733,670,530,140,73,18,https://www.intensivregister.de/api/public/reporting/laendertabelle
1648764321,670,531,139,73,18,https://www.intensivregister.de/api/public/reporting/laendertabelle
1648782321,673,534,139,69,18,https://www.intensivregister.de/api/public/reporting/laendertabelle
1648785927,672,528,144,72,19,https://www.intensivregister.de/api/public/reporting/laendertabelle
1648789517,671,524,147,70,19,https://www.intensivregister.de/api/public/reporting/laendertabelle
1648793122,671,522,149,68,19,https://www.intensivregister.de/api/public/reporting/laendertabelle
1648800328,670,523,147,66,18,https://www.intensivregister.de/api/public/reporting/laendertabelle
1648915516,663,526,137,71,21,https://www.intensivregister.de/api/public/reporting/laendertabelle
1648947916,663,523,140,71,21,https://www.intensivregister.de/api/public/reporting/laendertabelle
1648955114,663,520,143,70,19,https://www.intensivregister.de/api/public/reporting/laendertabelle
1648958721,663,507,156,70,20,https://www.intensivregister.de/api/public/reporting/laendertabelle
1648962320,661,491,170,68,19,https://www.intensivregister.de/api/public/reporting/laendertabelle
1648965919,661,489,172,65,19,https://www.intensivregister.de/api/public/reporting/laendertabelle
1648969520,661,488,173,65,20,https://www.intensivregister.de/api/public/reporting/laendertabelle
1649023521,661,487,174,65,20,https://www.intensivregister.de/api/public/reporting/laendertabelle
1649041514,661,492,169,66,18,https://www.intensivregister.de/api/public/reporting/laendertabelle
1649045118,661,491,170,66,18,https://www.intensivregister.de/api/public/reporting/laendertabelle
1649052315,663,496,167,64,18,https://www.intensivregister.de/api/public/reporting/laendertabelle
1649055920,663,500,163,64,18,https://www.intensivregister.de/api/public/reporting/laendertabelle
1649073923,663,497,166,65,20,https://www.intensivregister.de/api/public/reporting/laendertabelle
1649120731,663,498,165,65,20,https://www.intensivregister.de/api/public/reporting/laendertabelle
1649124316,663,497,166,65,20,https://www.intensivregister.de/api/public/reporting/laendertabelle
1649131526,675,527,148,68,23,https://www.intensivregister.de/api/public/reporting/laendertabelle
1649135117,680,531,149,68,22,https://www.intensivregister.de/api/public/reporting/laendertabelle
1649138721,680,532,148,68,22,https://www.intensivregister.de/api/public/reporting/laendertabelle
1649142331,681,537,144,68,22,https://www.intensivregister.de/api/public/reporting/laendertabelle
1649145932,681,540,141,68,22,https://www.intensivregister.de/api/public/reporting/laendertabelle
1649210720,680,539,141,68,22,https://www.intensivregister.de/api/public/reporting/laendertabelle
1649214315,676,543,133,72,20,https://www.intensivregister.de/api/public/reporting/laendertabelle
1649221543,676,550,126,75,19,https://www.intensivregister.de/api/public/reporting/laendertabelle
1649225118,676,550,126,74,18,https://www.intensivregister.de/api/public/reporting/laendertabelle
1649228729,677,549,128,74,18,https://www.intensivregister.de/api/public/reporting/laendertabelle
1649279118,677,549,128,73,18,https://www.intensivregister.de/api/public/reporting/laendertabelle
1649297117,677,546,131,73,19,https://www.intensivregister.de/api/public/reporting/laendertabelle
1649300720,680,546,134,69,16,https://www.intensivregister.de/api/public/reporting/laendertabelle
1649304334,669,539,130,69,16,https://www.intensivregister.de/api/public/reporting/laendertabelle
1649307926,669,538,131,69,16,https://www.intensivregister.de/api/public/reporting/laendertabelle
1649311531,669,539,130,69,16,https://www.intensivregister.de/api/public/reporting/laendertabelle
1649318732,669,536,133,70,17,https://www.intensivregister.de/api/public/reporting/laendertabelle
1649322328,669,534,135,69,16,https://www.intensivregister.de/api/public/reporting/laendertabelle
1649383520,669,532,137,66,13,https://www.intensivregister.de/api/public/reporting/laendertabelle
1649387114,669,533,136,64,12,https://www.intensivregister.de/api/public/reporting/laendertabelle
1649394317,669,533,136,63,13,https://www.intensivregister.de/api/public/reporting/laendertabelle
1649401528,668,533,135,64,14,https://www.intensivregister.de/api/public/reporting/laendertabelle
1649451929,668,531,137,64,14,https://www.intensivregister.de/api/public/reporting/laendertabelle
1649455524,667,531,136,64,14,https://www.intensivregister.de/api/public/reporting/laendertabelle
1649473514,667,530,137,62,14,https://www.intensivregister.de/api/public/reporting/laendertabelle
1649477129,667,530,137,59,14,https://www.intensivregister.de/api/public/reporting/laendertabelle
1649480723,667,535,132,56,14,https://www.intensivregister.de/api/public/reporting/laendertabelle
1649487930,666,534,132,57,13,https://www.intensivregister.de/api/public/reporting/laendertabelle
1649538329,666,530,136,57,13,https://www.intensivregister.de/api/public/reporting/laendertabelle
1649541918,666,529,137,57,13,https://www.intensivregister.de/api/public/reporting/laendertabelle
1649556328,666,528,138,56,13,https://www.intensivregister.de/api/public/reporting/laendertabelle
1649559923,666,525,141,55,13,https://www.intensivregister.de/api/public/reporting/laendertabelle
1649563518,662,513,149,55,13,https://www.intensivregister.de/api/public/reporting/laendertabelle
1649567122,663,515,148,56,13,https://www.intensivregister.de/api/public/reporting/laendertabelle
1649577921,663,509,154,56,13,https://www.intensivregister.de/api/public/reporting/laendertabelle
1649631931,663,511,152,56,13,https://www.intensivregister.de/api/public/reporting/laendertabelle
1649642714,664,512,152,56,14,https://www.intensivregister.de/api/public/reporting/laendertabelle
1649649921,660,508,152,57,14,https://www.intensivregister.de/api/public/reporting/laendertabelle
1649653528,659,509,150,57,15,https://www.intensivregister.de/api/public/reporting/laendertabelle
1649660727,659,512,147,57,15,https://www.intensivregister.de/api/public/reporting/laendertabelle
1649664317,659,513,146,58,14,https://www.intensivregister.de/api/public/reporting/laendertabelle
1649711121,660,512,148,58,14,https://www.intensivregister.de/api/public/reporting/laendertabelle
1649725516,660,516,144,58,14,https://www.intensivregister.de/api/public/reporting/laendertabelle
1649732718,666,543,123,60,19,https://www.intensivregister.de/api/public/reporting/laendertabelle
1649736321,667,542,125,56,18,https://www.intensivregister.de/api/public/reporting/laendertabelle
1649739924,677,549,128,54,16,https://www.intensivregister.de/api/public/reporting/laendertabelle
1649743523,677,549,128,53,16,https://www.intensivregister.de/api/public/reporting/laendertabelle
1649797531,677,551,126,53,16,https://www.intensivregister.de/api/public/reporting/laendertabelle
1649815531,677,548,129,54,16,https://www.intensivregister.de/api/public/reporting/laendertabelle
1649822723,673,542,131,50,18,https://www.intensivregister.de/api/public/reporting/laendertabelle
1649883927,673,537,136,49,19,https://www.intensivregister.de/api/public/reporting/laendertabelle
1649891132,676,537,139,48,19,https://www.intensivregister.de/api/public/reporting/laendertabelle
1649905531,676,531,145,49,16,https://www.intensivregister.de/api/public/reporting/laendertabelle
1649912724,676,533,143,51,15,https://www.intensivregister.de/api/public/reporting/laendertabelle
1649919930,676,532,144,52,15,https://www.intensivregister.de/api/public/reporting/laendertabelle
1649927125,676,531,145,52,15,https://www.intensivregister.de/api/public/reporting/laendertabelle
1649970326,676,534,142,52,15,https://www.intensivregister.de/api/public/reporting/laendertabelle
1649977529,676,533,143,52,15,https://www.intensivregister.de/api/public/reporting/laendertabelle
1649984734,674,533,141,52,15,https://www.intensivregister.de/api/public/reporting/laendertabelle
1649991927,674,534,140,52,16,https://www.intensivregister.de/api/public/reporting/laendertabelle
1649995524,671,530,141,51,16,https://www.intensivregister.de/api/public/reporting/laendertabelle
1649999119,671,526,145,50,15,https://www.intensivregister.de/api/public/reporting/laendertabelle
1650002724,670,518,152,49,14,https://www.intensivregister.de/api/public/reporting/laendertabelle
1650006322,670,517,153,50,13,https://www.intensivregister.de/api/public/reporting/laendertabelle
1650013526,670,517,153,51,13,https://www.intensivregister.de/api/public/reporting/laendertabelle
1650060331,670,518,152,51,13,https://www.intensivregister.de/api/public/reporting/laendertabelle
1650078326,667,516,151,51,13,https://www.intensivregister.de/api/public/reporting/laendertabelle
1650081930,665,510,155,49,13,https://www.intensivregister.de/api/public/reporting/laendertabelle
1650089128,662,503,159,47,14,https://www.intensivregister.de/api/public/reporting/laendertabelle
1650092722,664,500,164,45,13,https://www.intensivregister.de/api/public/reporting/laendertabelle
1650096328,664,496,168,46,13,https://www.intensivregister.de/api/public/reporting/laendertabelle
1650150323,664,494,170,45,13,https://www.intensivregister.de/api/public/reporting/laendertabelle
1650168326,664,487,177,43,14,https://www.intensivregister.de/api/public/reporting/laendertabelle
1650171929,664,485,179,46,14,https://www.intensivregister.de/api/public/reporting/laendertabelle
1650175519,664,488,176,44,14,https://www.intensivregister.de/api/public/reporting/laendertabelle
1650179131,664,481,183,47,13,https://www.intensivregister.de/api/public/reporting/laendertabelle
1650182733,664,482,182,47,13,https://www.intensivregister.de/api/public/reporting/laendertabelle
1650233122,664,483,181,47,13,https://www.intensivregister.de/api/public/reporting/laendertabelle
1650251114,664,482,182,48,13,https://www.intensivregister.de/api/public/reporting/laendertabelle
1650254726,668,486,182,50,13,https://www.intensivregister.de/api/public/reporting/laendertabelle
1650261922,667,486,181,50,13,https://www.intensivregister.de/api/public/reporting/laendertabelle
1650265526,667,489,178,49,13,https://www.intensivregister.de/api/public/reporting/laendertabelle
1650269125,664,492,172,49,13,https://www.intensivregister.de/api/public/reporting/laendertabelle
1650326724,664,493,171,49,13,https://www.intensivregister.de/api/public/reporting/laendertabelle
1650333917,664,491,173,51,14,https://www.intensivregister.de/api/public/reporting/laendertabelle
1650337514,664,483,181,51,13,https://www.intensivregister.de/api/public/reporting/laendertabelle
1650341134,664,488,176,51,13,https://www.intensivregister.de/api/public/reporting/laendertabelle
1650344732,663,493,170,53,15,https://www.intensivregister.de/api/public/reporting/laendertabelle
1650351930,665,507,158,55,15,https://www.intensivregister.de/api/public/reporting/laendertabelle
1650355530,665,509,156,55,15,https://www.intensivregister.de/api/public/reporting/laendertabelle
1650366319,665,510,155,55,15,https://www.intensivregister.de/api/public/reporting/laendertabelle
1650416720,665,509,156,55,15,https://www.intensivregister.de/api/public/reporting/laendertabelle
1650420322,665,509,156,54,15,https://www.intensivregister.de/api/public/reporting/laendertabelle
1650423924,672,508,164,52,12,https://www.intensivregister.de/api/public/reporting/laendertabelle
1650427527,673,513,160,53,12,https://www.intensivregister.de/api/public/reporting/laendertabelle
1650431119,673,515,158,54,12,https://www.intensivregister.de/api/public/reporting/laendertabelle
1650434722,673,514,159,52,12,https://www.intensivregister.de/api/public/reporting/laendertabelle
1650441919,673,516,157,53,12,https://www.intensivregister.de/api/public/reporting/laendertabelle
1650485132,673,518,155,54,12,https://www.intensivregister.de/api/public/reporting/laendertabelle
1650495924,673,517,156,53,12,https://www.intensivregister.de/api/public/reporting/laendertabelle
1650506733,673,519,154,53,11,https://www.intensivregister.de/api/public/reporting/laendertabelle
1650510316,675,528,147,48,11,https://www.intensivregister.de/api/public/reporting/laendertabelle
1650513921,677,539,138,50,10,https://www.intensivregister.de/api/public/reporting/laendertabelle
1650517524,677,543,134,52,11,https://www.intensivregister.de/api/public/reporting/laendertabelle
1650524730,677,545,132,52,11,https://www.intensivregister.de/api/public/reporting/laendertabelle
1650549920,677,546,131,52,11,https://www.intensivregister.de/api/public/reporting/laendertabelle
1650578716,677,549,128,52,11,https://www.intensivregister.de/api/public/reporting/laendertabelle
1650582320,677,550,127,52,11,https://www.intensivregister.de/api/public/reporting/laendertabelle
1650589517,677,553,124,52,11,https://www.intensivregister.de/api/public/reporting/laendertabelle
1650593120,677,554,123,52,11,https://www.intensivregister.de/api/public/reporting/laendertabelle
1650596722,678,542,136,53,11,https://www.intensivregister.de/api/public/reporting/laendertabelle
1650600330,677,531,146,53,10,https://www.intensivregister.de/api/public/reporting/laendertabelle
1650607530,675,534,141,54,10,https://www.intensivregister.de/api/public/reporting/laendertabelle
1650611132,676,534,142,52,10,https://www.intensivregister.de/api/public/reporting/laendertabelle
1650614722,676,533,143,52,10,https://www.intensivregister.de/api/public/reporting/laendertabelle
1650661529,676,533,143,51,10,https://www.intensivregister.de/api/public/reporting/laendertabelle
1650683125,676,531,145,51,11,https://www.intensivregister.de/api/public/reporting/laendertabelle
1650686714,676,532,144,52,12,https://www.intensivregister.de/api/public/reporting/laendertabelle
1650690325,676,525,151,53,12,https://www.intensivregister.de/api/public/reporting/laendertabelle
1650697525,669,523,146,53,11,https://www.intensivregister.de/api/public/reporting/laendertabelle
1650751517,669,516,153,53,11,https://www.intensivregister.de/api/public/reporting/laendertabelle
1650769529,669,506,163,50,11,https://www.intensivregister.de/api/public/reporting/laendertabelle
1650773127,669,505,164,47,11,https://www.intensivregister.de/api/public/reporting/laendertabelle
1650776719,667,503,164,47,11,https://www.intensivregister.de/api/public/reporting/laendertabelle
1650783919,667,503,164,45,11,https://www.intensivregister.de/api/public/reporting/laendertabelle
1650787531,667,505,162,46,11,https://www.intensivregister.de/api/public/reporting/laendertabelle
1650855921,665,524,141,46,10,https://www.intensivregister.de/api/public/reporting/laendertabelle
1650859523,663,517,146,46,10,https://www.intensivregister.de/api/public/reporting/laendertabelle
1650863126,663,515,148,43,10,https://www.intensivregister.de/api/public/reporting/laendertabelle
1650870333,663,516,147,42,9,https://www.intensivregister.de/api/public/reporting/laendertabelle
1650931531,663,518,145,42,9,https://www.intensivregister.de/api/public/reporting/laendertabelle
1650938731,663,522,141,41,9,https://www.intensivregister.de/api/public/reporting/laendertabelle
1650942331,666,532,134,41,9,https://www.intensivregister.de/api/public/reporting/laendertabelle
1650945924,670,545,125,41,8,https://www.intensivregister.de/api/public/reporting/laendertabelle
1650953126,670,540,130,39,9,https://www.intensivregister.de/api/public/reporting/laendertabelle
1650956727,672,547,125,41,9,https://www.intensivregister.de/api/public/reporting/laendertabelle
1651010721,672,548,124,41,9,https://www.intensivregister.de/api/public/reporting/laendertabelle
1651025128,672,546,126,41,8,https://www.intensivregister.de/api/public/reporting/laendertabelle
1651028716,675,540,135,38,11,https://www.intensivregister.de/api/public/reporting/laendertabelle
1651035922,676,534,142,37,12,https://www.intensivregister.de/api/public/reporting/laendertabelle
1651039521,676,537,139,37,12,https://www.intensivregister.de/api/public/reporting/laendertabelle
1651046720,680,538,142,34,12,https://www.intensivregister.de/api/public/reporting/laendertabelle
1651046720,680,539,141,34,12,https://www.intensivregister.de/api/public/reporting/laendertabelle
1651118732,679,541,138,35,12,https://www.intensivregister.de/api/public/reporting/laendertabelle
1651125932,679,538,141,35,12,https://www.intensivregister.de/api/public/reporting/laendertabelle
1651133133,678,538,140,36,14,https://www.intensivregister.de/api/public/reporting/laendertabelle
1651179934,678,536,142,36,14,https://www.intensivregister.de/api/public/reporting/laendertabelle
1651183531,678,534,144,36,14,https://www.intensivregister.de/api/public/reporting/laendertabelle
1651197934,680,536,144,33,13,https://www.intensivregister.de/api/public/reporting/laendertabelle
1651205129,681,541,140,32,11,https://www.intensivregister.de/api/public/reporting/laendertabelle
1651212336,681,545,136,34,13,https://www.intensivregister.de/api/public/reporting/laendertabelle
1651219536,679,544,135,34,13,https://www.intensivregister.de/api/public/reporting/laendertabelle
1651273527,679,546,133,34,13,https://www.intensivregister.de/api/public/reporting/laendertabelle
1651287931,679,543,136,34,13,https://www.intensivregister.de/api/public/reporting/laendertabelle
1651295130,673,528,145,36,12,https://www.intensivregister.de/api/public/reporting/laendertabelle
1651298731,673,528,145,37,13,https://www.intensivregister.de/api/public/reporting/laendertabelle
1651302333,673,531,142,41,14,https://www.intensivregister.de/api/public/reporting/laendertabelle
1651305929,673,524,149,42,14,https://www.intensivregister.de/api/public/reporting/laendertabelle
1651327536,673,526,147,42,14,https://www.intensivregister.de/api/public/reporting/laendertabelle
1651352732,673,527,146,42,14,https://www.intensivregister.de/api/public/reporting/laendertabelle
1651363524,674,528,146,42,14,https://www.intensivregister.de/api/public/reporting/laendertabelle
1651374337,674,526,148,42,14,https://www.intensivregister.de/api/public/reporting/laendertabelle
1651377934,675,526,149,41,13,https://www.intensivregister.de/api/public/reporting/laendertabelle
1651381530,676,528,148,38,13,https://www.intensivregister.de/api/public/reporting/laendertabelle
1651388728,674,518,156,40,12,https://www.intensivregister.de/api/public/reporting/laendertabelle
1651392330,674,517,157,40,13,https://www.intensivregister.de/api/public/reporting/laendertabelle
1651439122,673,516,157,40,13,https://www.intensivregister.de/api/public/reporting/laendertabelle
1651453527,677,519,158,40,13,https://www.intensivregister.de/api/public/reporting/laendertabelle
1651457131,677,516,161,40,14,https://www.intensivregister.de/api/public/reporting/laendertabelle
1651460735,673,530,143,39,13,https://www.intensivregister.de/api/public/reporting/laendertabelle
1651467934,674,529,145,40,14,https://www.intensivregister.de/api/public/reporting/laendertabelle
1651471537,676,530,146,41,14,https://www.intensivregister.de/api/public/reporting/laendertabelle
1651525529,677,531,146,42,15,https://www.intensivregister.de/api/public/reporting/laendertabelle
1651532733,677,529,148,42,15,https://www.intensivregister.de/api/public/reporting/laendertabelle
1651550728,694,531,163,41,16,https://www.intensivregister.de/api/public/reporting/laendertabelle
1651554323,694,534,160,41,16,https://www.intensivregister.de/api/public/reporting/laendertabelle
1651561528,692,537,155,41,16,https://www.intensivregister.de/api/public/reporting/laendertabelle
1651565128,692,535,157,41,16,https://www.intensivregister.de/api/public/reporting/laendertabelle
1651622722,692,534,158,41,16,https://www.intensivregister.de/api/public/reporting/laendertabelle
1651633523,694,539,155,39,16,https://www.intensivregister.de/api/public/reporting/laendertabelle
1651637128,691,540,151,35,16,https://www.intensivregister.de/api/public/reporting/laendertabelle
1651640715,691,546,145,34,15,https://www.intensivregister.de/api/public/reporting/laendertabelle
1651647928,692,542,150,30,14,https://www.intensivregister.de/api/public/reporting/laendertabelle
1651701923,693,543,150,30,14,https://www.intensivregister.de/api/public/reporting/laendertabelle
1651709126,693,544,149,30,14,https://www.intensivregister.de/api/public/reporting/laendertabelle
1651719925,691,552,139,32,14,https://www.intensivregister.de/api/public/reporting/laendertabelle
1651723526,692,553,139,30,14,https://www.intensivregister.de/api/public/reporting/laendertabelle
1651730722,694,551,143,32,12,https://www.intensivregister.de/api/public/reporting/laendertabelle
1651734333,694,554,140,32,12,https://www.intensivregister.de/api/public/reporting/laendertabelle
1651737934,694,555,139,32,12,https://www.intensivregister.de/api/public/reporting/laendertabelle
1651745131,694,555,139,31,12,https://www.intensivregister.de/api/public/reporting/laendertabelle
1651788320,694,553,141,31,12,https://www.intensivregister.de/api/public/reporting/laendertabelle
1651802719,694,555,139,31,11,https://www.intensivregister.de/api/public/reporting/laendertabelle
1651806317,693,542,151,29,11,https://www.intensivregister.de/api/public/reporting/laendertabelle
1651809914,691,543,148,28,9,https://www.intensivregister.de/api/public/reporting/laendertabelle
1651817125,691,550,141,30,8,https://www.intensivregister.de/api/public/reporting/laendertabelle
1651820722,691,549,142,30,8,https://www.intensivregister.de/api/public/reporting/laendertabelle
1651824325,690,547,143,31,9,https://www.intensivregister.de/api/public/reporting/laendertabelle
1651831523,690,545,145,31,9,https://www.intensivregister.de/api/public/reporting/laendertabelle
1651871119,690,546,144,31,9,https://www.intensivregister.de/api/public/reporting/laendertabelle
1651892725,690,544,146,30,9,https://www.intensivregister.de/api/public/reporting/laendertabelle
1651896328,691,527,164,29,10,https://www.intensivregister.de/api/public/reporting/laendertabelle
1651903526,685,522,163,29,6,https://www.intensivregister.de/api/public/reporting/laendertabelle
1651917924,685,521,164,30,6,https://www.intensivregister.de/api/public/reporting/laendertabelle
1651961124,685,522,163,30,6,https://www.intensivregister.de/api/public/reporting/laendertabelle
1651979125,683,521,162,32,7,https://www.intensivregister.de/api/public/reporting/laendertabelle
1651982718,683,512,171,32,7,https://www.intensivregister.de/api/public/reporting/laendertabelle
1651986321,683,515,168,32,7,https://www.intensivregister.de/api/public/reporting/laendertabelle
1651993526,682,507,175,32,6,https://www.intensivregister.de/api/public/reporting/laendertabelle
1652040329,682,508,174,32,6,https://www.intensivregister.de/api/public/reporting/laendertabelle
1652061924,684,513,171,32,6,https://www.intensivregister.de/api/public/reporting/laendertabelle
1652065514,684,511,173,31,6,https://www.intensivregister.de/api/public/reporting/laendertabelle
1652069115,683,512,171,33,5,https://www.intensivregister.de/api/public/reporting/laendertabelle
1652072716,682,510,172,31,5,https://www.intensivregister.de/api/public/reporting/laendertabelle
1652151929,682,527,155,31,4,https://www.intensivregister.de/api/public/reporting/laendertabelle
1652155530,687,539,148,32,5,https://www.intensivregister.de/api/public/reporting/laendertabelle
1652159124,687,546,141,32,5,https://www.intensivregister.de/api/public/reporting/laendertabelle
1652162719,687,547,140,32,5,https://www.intensivregister.de/api/public/reporting/laendertabelle
1652166316,687,549,138,32,5,https://www.intensivregister.de/api/public/reporting/laendertabelle
1652169929,687,557,130,34,6,https://www.intensivregister.de/api/public/reporting/laendertabelle
1652187914,687,559,128,34,6,https://www.intensivregister.de/api/public/reporting/laendertabelle
1652223933,687,561,126,34,6,https://www.intensivregister.de/api/public/reporting/laendertabelle
1652234718,687,564,123,36,5,https://www.intensivregister.de/api/public/reporting/laendertabelle
1652238313,685,572,113,36,4,https://www.intensivregister.de/api/public/reporting/laendertabelle
1652241931,684,575,109,35,4,https://www.intensivregister.de/api/public/reporting/laendertabelle
1652245531,684,569,115,35,4,https://www.intensivregister.de/api/public/reporting/laendertabelle
1652252732,684,570,114,37,4,https://www.intensivregister.de/api/public/reporting/laendertabelle
1652256319,684,570,114,36,3,https://www.intensivregister.de/api/public/reporting/laendertabelle
1652303124,684,567,117,36,3,https://www.intensivregister.de/api/public/reporting/laendertabelle
1652317525,684,566,118,35,3,https://www.intensivregister.de/api/public/reporting/laendertabelle
1652321117,684,567,117,34,3,https://www.intensivregister.de/api/public/reporting/laendertabelle
1652324726,686,564,122,36,4,https://www.intensivregister.de/api/public/reporting/laendertabelle
1652328316,687,559,128,33,4,https://www.intensivregister.de/api/public/reporting/laendertabelle
1652335523,689,564,125,33,4,https://www.intensivregister.de/api/public/reporting/laendertabelle
1652342718,689,563,126,34,5,https://www.intensivregister.de/api/public/reporting/laendertabelle
1652393123,689,565,124,34,5,https://www.intensivregister.de/api/public/reporting/laendertabelle
1652411125,688,559,129,34,5,https://www.intensivregister.de/api/public/reporting/laendertabelle
1652418316,688,562,126,33,5,https://www.intensivregister.de/api/public/reporting/laendertabelle
1652421925,688,563,125,34,5,https://www.intensivregister.de/api/public/reporting/laendertabelle
1652425528,688,565,123,34,5,https://www.intensivregister.de/api/public/reporting/laendertabelle
1652432733,688,563,125,34,5,https://www.intensivregister.de/api/public/reporting/laendertabelle
1652439932,688,575,113,33,5,https://www.intensivregister.de/api/public/reporting/laendertabelle
1652475925,688,565,123,33,5,https://www.intensivregister.de/api/public/reporting/laendertabelle
1652493914,688,562,126,32,5,https://www.intensivregister.de/api/public/reporting/laendertabelle
1652501124,681,547,134,30,5,https://www.intensivregister.de/api/public/reporting/laendertabelle
1652508327,681,537,144,27,6,https://www.intensivregister.de/api/public/reporting/laendertabelle
1652511929,681,536,145,27,6,https://www.intensivregister.de/api/public/reporting/laendertabelle
1652580318,683,541,142,28,6,https://www.intensivregister.de/api/public/reporting/laendertabelle
1652583923,684,544,140,28,6,https://www.intensivregister.de/api/public/reporting/laendertabelle
1652587516,677,532,145,30,6,https://www.intensivregister.de/api/public/reporting/laendertabelle
1652594714,677,527,150,28,5,https://www.intensivregister.de/api/public/reporting/laendertabelle
1652601930,677,525,152,27,5,https://www.intensivregister.de/api/public/reporting/laendertabelle
1652663124,677,524,153,27,5,https://www.intensivregister.de/api/public/reporting/laendertabelle
1652666723,680,523,157,26,5,https://www.intensivregister.de/api/public/reporting/laendertabelle
1652673914,679,530,149,28,5,https://www.intensivregister.de/api/public/reporting/laendertabelle
1652677515,679,534,145,28,5,https://www.intensivregister.de/api/public/reporting/laendertabelle
1652684717,681,539,142,26,3,https://www.intensivregister.de/api/public/reporting/laendertabelle
1652735127,681,538,143,26,3,https://www.intensivregister.de/api/public/reporting/laendertabelle
1652738729,681,539,142,26,3,https://www.intensivregister.de/api/public/reporting/laendertabelle
1652742322,679,539,140,27,3,https://www.intensivregister.de/api/public/reporting/laendertabelle
1652756729,694,559,135,29,3,https://www.intensivregister.de/api/public/reporting/laendertabelle
1652763914,690,560,130,27,3,https://www.intensivregister.de/api/public/reporting/laendertabelle
1652767523,690,558,132,27,3,https://www.intensivregister.de/api/public/reporting/laendertabelle
1652774719,690,558,132,28,3,https://www.intensivregister.de/api/public/reporting/laendertabelle
1652781927,690,565,125,28,3,https://www.intensivregister.de/api/public/reporting/laendertabelle
1652821520,690,564,126,28,3,https://www.intensivregister.de/api/public/reporting/laendertabelle
1652843128,690,559,131,28,3,https://www.intensivregister.de/api/public/reporting/laendertabelle
1652846726,690,562,128,28,3,https://www.intensivregister.de/api/public/reporting/laendertabelle
1652853931,692,569,123,29,3,https://www.intensivregister.de/api/public/reporting/laendertabelle
1652857522,692,562,130,30,4,https://www.intensivregister.de/api/public/reporting/laendertabelle
1652864732,692,559,133,30,4,https://www.intensivregister.de/api/public/reporting/laendertabelle
1652911522,692,558,134,30,4,https://www.intensivregister.de/api/public/reporting/laendertabelle
1652922322,692,556,136,30,4,https://www.intensivregister.de/api/public/reporting/laendertabelle
1652925927,692,556,136,29,4,https://www.intensivregister.de/api/public/reporting/laendertabelle
1652929523,685,563,122,27,4,https://www.intensivregister.de/api/public/reporting/laendertabelle
1652933116,686,562,124,27,5,https://www.intensivregister.de/api/public/reporting/laendertabelle
1652940330,689,564,125,27,5,https://www.intensivregister.de/api/public/reporting/laendertabelle
1652947517,689,565,124,27,5,https://www.intensivregister.de/api/public/reporting/laendertabelle
1653001518,687,566,121,27,5,https://www.intensivregister.de/api/public/reporting/laendertabelle
1653012320,687,564,123,26,5,https://www.intensivregister.de/api/public/reporting/laendertabelle
1653019532,690,564,126,28,7,https://www.intensivregister.de/api/public/reporting/laendertabelle
1653026730,688,560,128,24,7,https://www.intensivregister.de/api/public/reporting/laendertabelle
1653030321,688,559,129,25,7,https://www.intensivregister.de/api/public/reporting/laendertabelle
1653084323,688,560,128,25,7,https://www.intensivregister.de/api/public/reporting/laendertabelle
1653087915,688,558,130,25,7,https://www.intensivregister.de/api/public/reporting/laendertabelle
1653105931,689,557,132,23,7,https://www.intensivregister.de/api/public/reporting/laendertabelle
1653109514,683,549,134,22,7,https://www.intensivregister.de/api/public/reporting/laendertabelle
1653113127,679,546,133,22,7,https://www.intensivregister.de/api/public/reporting/laendertabelle
1653116720,677,551,126,22,7,https://www.intensivregister.de/api/public/reporting/laendertabelle
1653185127,677,549,128,22,7,https://www.intensivregister.de/api/public/reporting/laendertabelle
1653188721,678,551,127,22,7,https://www.intensivregister.de/api/public/reporting/laendertabelle
1653195929,678,550,128,24,7,https://www.intensivregister.de/api/public/reporting/laendertabelle
1653195929,678,548,130,25,7,https://www.intensivregister.de/api/public/reporting/laendertabelle
1653203118,678,545,133,25,6,https://www.intensivregister.de/api/public/reporting/laendertabelle
1653206722,678,543,135,25,6,https://www.intensivregister.de/api/public/reporting/laendertabelle
1653260716,678,542,136,26,6,https://www.intensivregister.de/api/public/reporting/laendertabelle
1653271524,677,541,136,25,6,https://www.intensivregister.de/api/public/reporting/laendertabelle
1653275116,679,553,126,26,4,https://www.intensivregister.de/api/public/reporting/laendertabelle
1653278716,678,539,139,25,4,https://www.intensivregister.de/api/public/reporting/laendertabelle
1653282326,679,541,138,24,4,https://www.intensivregister.de/api/public/reporting/laendertabelle
1653289529,677,539,138,24,4,https://www.intensivregister.de/api/public/reporting/laendertabelle
1653296719,677,538,139,24,4,https://www.intensivregister.de/api/public/reporting/laendertabelle
1653347124,677,539,138,24,4,https://www.intensivregister.de/api/public/reporting/laendertabelle
1653357932,677,541,136,24,4,https://www.intensivregister.de/api/public/reporting/laendertabelle
1653361523,688,551,137,20,6,https://www.intensivregister.de/api/public/reporting/laendertabelle
1653365114,688,544,144,21,7,https://www.intensivregister.de/api/public/reporting/laendertabelle
1653368724,688,544,144,20,7,https://www.intensivregister.de/api/public/reporting/laendertabelle
1653379519,689,547,142,20,7,https://www.intensivregister.de/api/public/reporting/laendertabelle
1653429931,689,546,143,20,7,https://www.intensivregister.de/api/public/reporting/laendertabelle
1653444317,681,547,134,21,7,https://www.intensivregister.de/api/public/reporting/laendertabelle
1653451521,684,557,127,21,6,https://www.intensivregister.de/api/public/reporting/laendertabelle
1653465916,685,556,129,19,5,https://www.intensivregister.de/api/public/reporting/laendertabelle
1653512724,678,553,125,19,5,https://www.intensivregister.de/api/public/reporting/laendertabelle
1653534317,678,548,130,19,5,https://www.intensivregister.de/api/public/reporting/laendertabelle
1653537933,677,543,134,20,5,https://www.intensivregister.de/api/public/reporting/laendertabelle
1653541517,676,543,133,18,5,https://www.intensivregister.de/api/public/reporting/laendertabelle
1653545121,674,542,132,18,5,https://www.intensivregister.de/api/public/reporting/laendertabelle
1653552322,673,545,128,18,4,https://www.intensivregister.de/api/public/reporting/laendertabelle
1653617124,673,546,127,18,4,https://www.intensivregister.de/api/public/reporting/laendertabelle
1653624325,672,540,132,17,4,https://www.intensivregister.de/api/public/reporting/laendertabelle
1653631529,671,542,129,18,4,https://www.intensivregister.de/api/public/reporting/laendertabelle
1653638727,674,526,148,17,3,https://www.intensivregister.de/api/public/reporting/laendertabelle
1653649528,672,524,148,17,2,https://www.intensivregister.de/api/public/reporting/laendertabelle
1653685526,672,523,149,17,2,https://www.intensivregister.de/api/public/reporting/laendertabelle
1653707121,673,524,149,17,2,https://www.intensivregister.de/api/public/reporting/laendertabelle
1653714317,673,513,160,16,2,https://www.intensivregister.de/api/public/reporting/laendertabelle
1653717914,668,520,148,16,2,https://www.intensivregister.de/api/public/reporting/laendertabelle
1653779115,668,520,148,17,2,https://www.intensivregister.de/api/public/reporting/laendertabelle
1653789926,670,521,149,17,2,https://www.intensivregister.de/api/public/reporting/laendertabelle
1653800719,670,515,155,15,2,https://www.intensivregister.de/api/public/reporting/laendertabelle
1653804327,670,515,155,16,4,https://www.intensivregister.de/api/public/reporting/laendertabelle
1653807924,670,517,153,17,4,https://www.intensivregister.de/api/public/reporting/laendertabelle
1653811520,668,518,150,17,4,https://www.intensivregister.de/api/public/reporting/laendertabelle
1653854719,668,517,151,17,4,https://www.intensivregister.de/api/public/reporting/laendertabelle
1653883528,678,520,158,16,4,https://www.intensivregister.de/api/public/reporting/laendertabelle
1653887117,678,522,156,16,4,https://www.intensivregister.de/api/public/reporting/laendertabelle
1653890727,678,523,155,16,4,https://www.intensivregister.de/api/public/reporting/laendertabelle
1653894324,678,524,154,16,4,https://www.intensivregister.de/api/public/reporting/laendertabelle
1653901531,680,527,153,16,4,https://www.intensivregister.de/api/public/reporting/laendertabelle
1653951915,680,529,151,16,4,https://www.intensivregister.de/api/public/reporting/laendertabelle
1653959122,680,530,150,16,4,https://www.intensivregister.de/api/public/reporting/laendertabelle
1653962714,680,527,153,16,4,https://www.intensivregister.de/api/public/reporting/laendertabelle
1653969918,678,534,144,14,3,https://www.intensivregister.de/api/public/reporting/laendertabelle
1653980718,680,539,141,14,3,https://www.intensivregister.de/api/public/reporting/laendertabelle
1653984323,680,542,138,14,3,https://www.intensivregister.de/api/public/reporting/laendertabelle
1653987919,682,542,140,14,3,https://www.intensivregister.de/api/public/reporting/laendertabelle
1654041917,686,542,144,14,3,https://www.intensivregister.de/api/public/reporting/laendertabelle
1654049116,686,541,145,14,3,https://www.intensivregister.de/api/public/reporting/laendertabelle
1654056322,695,553,142,14,4,https://www.intensivregister.de/api/public/reporting/laendertabelle
1654059916,695,554,141,15,4,https://www.intensivregister.de/api/public/reporting/laendertabelle
1654067122,695,552,143,15,4,https://www.intensivregister.de/api/public/reporting/laendertabelle
1654074317,695,553,142,15,4,https://www.intensivregister.de/api/public/reporting/laendertabelle
1654128317,695,552,143,15,4,https://www.intensivregister.de/api/public/reporting/laendertabelle
1654135519,695,555,140,15,4,https://www.intensivregister.de/api/public/reporting/laendertabelle
1654139120,692,554,138,14,4,https://www.intensivregister.de/api/public/reporting/laendertabelle
1654142722,692,556,136,14,4,https://www.intensivregister.de/api/public/reporting/laendertabelle
1654149914,692,553,139,14,4,https://www.intensivregister.de/api/public/reporting/laendertabelle
1654157117,692,554,138,13,5,https://www.intensivregister.de/api/public/reporting/laendertabelle
1654207515,692,552,140,12,5,https://www.intensivregister.de/api/public/reporting/laendertabelle
1654221929,692,551,141,12,5,https://www.intensivregister.de/api/public/reporting/laendertabelle
1654225524,689,562,127,14,5,https://www.intensivregister.de/api/public/reporting/laendertabelle
1654232723,690,561,129,13,5,https://www.intensivregister.de/api/public/reporting/laendertabelle
1654239930,691,562,129,14,5,https://www.intensivregister.de/api/public/reporting/laendertabelle
1654293927,691,561,130,14,5,https://www.intensivregister.de/api/public/reporting/laendertabelle
1654297519,691,559,132,14,5,https://www.intensivregister.de/api/public/reporting/laendertabelle
1654311929,690,558,132,14,5,https://www.intensivregister.de/api/public/reporting/laendertabelle
1654315526,688,570,118,16,5,https://www.intensivregister.de/api/public/reporting/laendertabelle
1654322722,686,553,133,15,5,https://www.intensivregister.de/api/public/reporting/laendertabelle
1654329915,686,552,134,15,5,https://www.intensivregister.de/api/public/reporting/laendertabelle
1654351530,686,551,135,15,5,https://www.intensivregister.de/api/public/reporting/laendertabelle
1654376721,686,548,138,15,5,https://www.intensivregister.de/api/public/reporting/laendertabelle
1654380328,686,550,136,15,5,https://www.intensivregister.de/api/public/reporting/laendertabelle
1654398316,687,554,133,15,5,https://www.intensivregister.de/api/public/reporting/laendertabelle
1654401933,687,549,138,15,5,https://www.intensivregister.de/api/public/reporting/laendertabelle
1654409128,687,527,160,17,4,https://www.intensivregister.de/api/public/reporting/laendertabelle
1654412725,687,526,161,17,4,https://www.intensivregister.de/api/public/reporting/laendertabelle
1654466732,687,524,163,17,4,https://www.intensivregister.de/api/public/reporting/laendertabelle
1654473916,687,522,165,17,4,https://www.intensivregister.de/api/public/reporting/laendertabelle
1654481131,687,520,167,17,4,https://www.intensivregister.de/api/public/reporting/laendertabelle
1654488313,687,499,188,14,4,https://www.intensivregister.de/api/public/reporting/laendertabelle
1654495519,685,503,182,13,4,https://www.intensivregister.de/api/public/reporting/laendertabelle
1654499127,685,504,181,10,3,https://www.intensivregister.de/api/public/reporting/laendertabelle
1654549530,686,504,182,10,3,https://www.intensivregister.de/api/public/reporting/laendertabelle
1654560324,685,504,181,10,3,https://www.intensivregister.de/api/public/reporting/laendertabelle
1654567526,685,502,183,10,3,https://www.intensivregister.de/api/public/reporting/laendertabelle
1654574729,685,507,178,9,3,https://www.intensivregister.de/api/public/reporting/laendertabelle
1654581933,685,503,182,9,3,https://www.intensivregister.de/api/public/reporting/laendertabelle
1654589127,685,506,179,9,3,https://www.intensivregister.de/api/public/reporting/laendertabelle
1654635925,685,509,176,9,3,https://www.intensivregister.de/api/public/reporting/laendertabelle
1654653918,685,510,175,9,3,https://www.intensivregister.de/api/public/reporting/laendertabelle
1654661128,696,530,166,13,4,https://www.intensivregister.de/api/public/reporting/laendertabelle
1654664730,697,537,160,16,5,https://www.intensivregister.de/api/public/reporting/laendertabelle
1654671923,697,541,156,16,5,https://www.intensivregister.de/api/public/reporting/laendertabelle
1654675516,697,543,154,16,5,https://www.intensivregister.de/api/public/reporting/laendertabelle
1654679130,697,547,150,16,5,https://www.intensivregister.de/api/public/reporting/laendertabelle
1654722329,695,548,147,15,5,https://www.intensivregister.de/api/public/reporting/laendertabelle
1654729515,695,550,145,15,5,https://www.intensivregister.de/api/public/reporting/laendertabelle
1654733123,695,552,143,15,5,https://www.intensivregister.de/api/public/reporting/laendertabelle
1654743928,697,567,130,13,5,https://www.intensivregister.de/api/public/reporting/laendertabelle
1654751129,697,568,129,10,5,https://www.intensivregister.de/api/public/reporting/laendertabelle
1654754721,697,570,127,11,5,https://www.intensivregister.de/api/public/reporting/laendertabelle
1654761917,697,561,136,11,5,https://www.intensivregister.de/api/public/reporting/laendertabelle
1654808733,697,558,139,11,5,https://www.intensivregister.de/api/public/reporting/laendertabelle
1654830322,693,545,148,10,4,https://www.intensivregister.de/api/public/reporting/laendertabelle
1654833924,694,549,145,11,4,https://www.intensivregister.de/api/public/reporting/laendertabelle
1654837526,692,545,147,9,4,https://www.intensivregister.de/api/public/reporting/laendertabelle
1654844722,691,544,147,9,4,https://www.intensivregister.de/api/public/reporting/laendertabelle
1654848330,691,546,145,9,4,https://www.intensivregister.de/api/public/reporting/laendertabelle
1654909528,692,547,145,9,4,https://www.intensivregister.de/api/public/reporting/laendertabelle
1654916718,694,544,150,9,4,https://www.intensivregister.de/api/public/reporting/laendertabelle
1654920333,697,543,154,9,4,https://www.intensivregister.de/api/public/reporting/laendertabelle
1654927515,693,537,156,9,4,https://www.intensivregister.de/api/public/reporting/laendertabelle
1654931130,693,535,158,9,4,https://www.intensivregister.de/api/public/reporting/laendertabelle
1654934725,693,534,159,9,4,https://www.intensivregister.de/api/public/reporting/laendertabelle
1654981526,693,525,168,9,4,https://www.intensivregister.de/api/public/reporting/laendertabelle
1654999516,693,524,169,9,4,https://www.intensivregister.de/api/public/reporting/laendertabelle
1655006729,692,523,169,9,4,https://www.intensivregister.de/api/public/reporting/laendertabelle
1655010324,692,522,170,9,4,https://www.intensivregister.de/api/public/reporting/laendertabelle
1655013918,692,512,180,9,4,https://www.intensivregister.de/api/public/reporting/laendertabelle
1655017529,692,512,180,10,4,https://www.intensivregister.de/api/public/reporting/laendertabelle
1655024728,692,506,186,10,4,https://www.intensivregister.de/api/public/reporting/laendertabelle
1655028323,692,505,187,9,3,https://www.intensivregister.de/api/public/reporting/laendertabelle
1655031929,692,508,184,9,3,https://www.intensivregister.de/api/public/reporting/laendertabelle
1655057121,691,508,183,9,3,https://www.intensivregister.de/api/public/reporting/laendertabelle
1655067927,691,509,182,9,3,https://www.intensivregister.de/api/public/reporting/laendertabelle
1655075130,691,507,184,9,3,https://www.intensivregister.de/api/public/reporting/laendertabelle
1655085932,691,503,188,7,3,https://www.intensivregister.de/api/public/reporting/laendertabelle
1655089522,691,500,191,9,3,https://www.intensivregister.de/api/public/reporting/laendertabelle
1655093130,691,501,190,9,3,https://www.intensivregister.de/api/public/reporting/laendertabelle
1655100327,691,509,182,9,3,https://www.intensivregister.de/api/public/reporting/laendertabelle
1655107515,693,511,182,9,3,https://www.intensivregister.de/api/public/reporting/laendertabelle
1655157929,693,516,177,9,3,https://www.intensivregister.de/api/public/reporting/laendertabelle
1655168727,693,517,176,9,3,https://www.intensivregister.de/api/public/reporting/laendertabelle
1655175921,695,528,167,9,3,https://www.intensivregister.de/api/public/reporting/laendertabelle
1655183122,698,534,164,9,2,https://www.intensivregister.de/api/public/reporting/laendertabelle
1655190322,698,535,163,10,2,https://www.intensivregister.de/api/public/reporting/laendertabelle
1655193931,698,537,161,11,2,https://www.intensivregister.de/api/public/reporting/laendertabelle
1655240719,698,540,158,11,2,https://www.intensivregister.de/api/public/reporting/laendertabelle
1655247914,698,538,160,11,2,https://www.intensivregister.de/api/public/reporting/laendertabelle
1655255115,698,539,159,11,2,https://www.intensivregister.de/api/public/reporting/laendertabelle
1655262323,694,555,139,9,1,https://www.intensivregister.de/api/public/reporting/laendertabelle
1655265920,694,561,133,9,1,https://www.intensivregister.de/api/public/reporting/laendertabelle
1655273129,694,567,127,9,1,https://www.intensivregister.de/api/public/reporting/laendertabelle
1655330728,694,569,125,9,1,https://www.intensivregister.de/api/public/reporting/laendertabelle
1655337928,694,567,127,9,1,https://www.intensivregister.de/api/public/reporting/laendertabelle
1655345130,694,570,124,9,1,https://www.intensivregister.de/api/public/reporting/laendertabelle
1655348726,696,579,117,10,2,https://www.intensivregister.de/api/public/reporting/laendertabelle
1655352334,690,571,119,10,1,https://www.intensivregister.de/api/public/reporting/laendertabelle
1655355920,690,564,126,9,1,https://www.intensivregister.de/api/public/reporting/laendertabelle
1655363124,690,565,125,9,1,https://www.intensivregister.de/api/public/reporting/laendertabelle
1655431516,690,568,122,10,1,https://www.intensivregister.de/api/public/reporting/laendertabelle
1655435126,688,568,120,11,1,https://www.intensivregister.de/api/public/reporting/laendertabelle
1655438718,688,561,127,9,0,https://www.intensivregister.de/api/public/reporting/laendertabelle
1655442328,688,565,123,9,0,https://www.intensivregister.de/api/public/reporting/laendertabelle
1655445921,688,563,125,10,1,https://www.intensivregister.de/api/public/reporting/laendertabelle
1655449532,688,560,128,9,1,https://www.intensivregister.de/api/public/reporting/laendertabelle
1655503524,688,556,132,9,1,https://www.intensivregister.de/api/public/reporting/laendertabelle
1655521528,685,540,145,9,1,https://www.intensivregister.de/api/public/reporting/laendertabelle
1655528717,685,533,152,10,2,https://www.intensivregister.de/api/public/reporting/laendertabelle
1655532329,685,534,151,10,2,https://www.intensivregister.de/api/public/reporting/laendertabelle
1655539519,683,529,154,11,2,https://www.intensivregister.de/api/public/reporting/laendertabelle
1655589928,683,530,153,12,2,https://www.intensivregister.de/api/public/reporting/laendertabelle
1655607928,683,529,154,12,2,https://www.intensivregister.de/api/public/reporting/laendertabelle
1655611522,677,510,167,12,2,https://www.intensivregister.de/api/public/reporting/laendertabelle
1655615117,677,514,163,14,2,https://www.intensivregister.de/api/public/reporting/laendertabelle
1655618721,675,513,162,14,3,https://www.intensivregister.de/api/public/reporting/laendertabelle
1655622333,675,513,162,15,3,https://www.intensivregister.de/api/public/reporting/laendertabelle
1655672728,675,515,160,15,3,https://www.intensivregister.de/api/public/reporting/laendertabelle
1655679925,676,516,160,15,3,https://www.intensivregister.de/api/public/reporting/laendertabelle
1655690715,676,515,161,15,3,https://www.intensivregister.de/api/public/reporting/laendertabelle
1655694330,677,516,161,14,3,https://www.intensivregister.de/api/public/reporting/laendertabelle
1655697918,678,516,162,14,3,https://www.intensivregister.de/api/public/reporting/laendertabelle
1655701517,678,514,164,14,3,https://www.intensivregister.de/api/public/reporting/laendertabelle
1655708717,678,516,162,14,3,https://www.intensivregister.de/api/public/reporting/laendertabelle
1655712316,678,519,159,14,3,https://www.intensivregister.de/api/public/reporting/laendertabelle
1655715925,678,519,159,15,3,https://www.intensivregister.de/api/public/reporting/laendertabelle
1655759121,678,519,159,14,3,https://www.intensivregister.de/api/public/reporting/laendertabelle
1655769919,678,520,158,14,3,https://www.intensivregister.de/api/public/reporting/laendertabelle
1655777125,678,522,156,14,3,https://www.intensivregister.de/api/public/reporting/laendertabelle
1655784323,684,547,137,13,3,https://www.intensivregister.de/api/public/reporting/laendertabelle
1655787931,684,551,133,18,6,https://www.intensivregister.de/api/public/reporting/laendertabelle
1655791519,684,551,133,20,7,https://www.intensivregister.de/api/public/reporting/laendertabelle
1655798725,684,552,132,20,7,https://www.intensivregister.de/api/public/reporting/laendertabelle
1655852727,684,548,136,20,7,https://www.intensivregister.de/api/public/reporting/laendertabelle
1655863519,684,546,138,20,7,https://www.intensivregister.de/api/public/reporting/laendertabelle
1655867124,684,550,134,23,8,https://www.intensivregister.de/api/public/reporting/laendertabelle
1655870719,684,554,130,21,8,https://www.intensivregister.de/api/public/reporting/laendertabelle
1655874326,686,556,130,21,8,https://www.intensivregister.de/api/public/reporting/laendertabelle
1655877914,686,560,126,21,8,https://www.intensivregister.de/api/public/reporting/laendertabelle
1655881532,686,559,127,20,8,https://www.intensivregister.de/api/public/reporting/laendertabelle
1655895917,687,558,129,20,8,https://www.intensivregister.de/api/public/reporting/laendertabelle
1655935529,687,557,130,20,8,https://www.intensivregister.de/api/public/reporting/laendertabelle
1655942725,687,558,129,20,8,https://www.intensivregister.de/api/public/reporting/laendertabelle
1655949914,687,556,131,20,8,https://www.intensivregister.de/api/public/reporting/laendertabelle
1655957123,687,546,141,20,6,https://www.intensivregister.de/api/public/reporting/laendertabelle
1655960714,687,547,140,20,6,https://www.intensivregister.de/api/public/reporting/laendertabelle
1655964313,686,550,136,20,6,https://www.intensivregister.de/api/public/reporting/laendertabelle
1655971520,686,549,137,20,6,https://www.intensivregister.de/api/public/reporting/laendertabelle
1656018333,686,551,135,19,6,https://www.intensivregister.de/api/public/reporting/laendertabelle
1656021919,686,549,137,19,6,https://www.intensivregister.de/api/public/reporting/laendertabelle
1656039933,686,556,130,19,6,https://www.intensivregister.de/api/public/reporting/laendertabelle
1656043530,686,551,135,14,4,https://www.intensivregister.de/api/public/reporting/laendertabelle
1656050726,686,552,134,15,4,https://www.intensivregister.de/api/public/reporting/laendertabelle
1656054314,686,555,131,15,4,https://www.intensivregister.de/api/public/reporting/laendertabelle
1656057931,686,556,130,16,4,https://www.intensivregister.de/api/public/reporting/laendertabelle
1656065119,686,558,128,16,4,https://www.intensivregister.de/api/public/reporting/laendertabelle
1656097515,686,557,129,16,4,https://www.intensivregister.de/api/public/reporting/laendertabelle
1656111927,682,555,127,16,4,https://www.intensivregister.de/api/public/reporting/laendertabelle
1656122717,682,552,130,16,4,https://www.intensivregister.de/api/public/reporting/laendertabelle
1656129922,682,564,118,18,6,https://www.intensivregister.de/api/public/reporting/laendertabelle
1656133517,680,555,125,20,8,https://www.intensivregister.de/api/public/reporting/laendertabelle
1656140730,679,560,119,17,6,https://www.intensivregister.de/api/public/reporting/laendertabelle
1656194716,680,563,117,17,6,https://www.intensivregister.de/api/public/reporting/laendertabelle
1656212729,680,562,118,18,7,https://www.intensivregister.de/api/public/reporting/laendertabelle
1656216323,680,559,121,18,7,https://www.intensivregister.de/api/public/reporting/laendertabelle
1656223526,673,538,135,17,7,https://www.intensivregister.de/api/public/reporting/laendertabelle
1656227133,673,539,134,18,7,https://www.intensivregister.de/api/public/reporting/laendertabelle
1656284727,673,538,135,18,7,https://www.intensivregister.de/api/public/reporting/laendertabelle
1656295526,674,538,136,18,7,https://www.intensivregister.de/api/public/reporting/laendertabelle
1656299113,673,541,132,20,6,https://www.intensivregister.de/api/public/reporting/laendertabelle
1656302730,674,538,136,19,6,https://www.intensivregister.de/api/public/reporting/laendertabelle
1656306329,672,540,132,19,5,https://www.intensivregister.de/api/public/reporting/laendertabelle
1656313524,674,540,134,19,5,https://www.intensivregister.de/api/public/reporting/laendertabelle
1656317114,674,537,137,19,5,https://www.intensivregister.de/api/public/reporting/laendertabelle
1656363921,674,539,135,19,5,https://www.intensivregister.de/api/public/reporting/laendertabelle
1656371128,674,543,131,19,5,https://www.intensivregister.de/api/public/reporting/laendertabelle
1656378323,673,544,129,20,5,https://www.intensivregister.de/api/public/reporting/laendertabelle
1656381931,673,542,131,19,5,https://www.intensivregister.de/api/public/reporting/laendertabelle
1656385520,674,540,134,23,6,https://www.intensivregister.de/api/public/reporting/laendertabelle
1656389122,673,545,128,24,6,https://www.intensivregister.de/api/public/reporting/laendertabelle
1656392728,673,550,123,18,6,https://www.intensivregister.de/api/public/reporting/laendertabelle
1656396319,673,549,124,18,6,https://www.intensivregister.de/api/public/reporting/laendertabelle
1656403520,673,553,120,19,6,https://www.intensivregister.de/api/public/reporting/laendertabelle
1656450324,673,555,118,19,6,https://www.intensivregister.de/api/public/reporting/laendertabelle
1656468315,673,555,118,20,6,https://www.intensivregister.de/api/public/reporting/laendertabelle
1656475520,678,551,127,22,7,https://www.intensivregister.de/api/public/reporting/laendertabelle
1656482732,679,557,122,20,7,https://www.intensivregister.de/api/public/reporting/laendertabelle
1656489915,675,555,120,24,8,https://www.intensivregister.de/api/public/reporting/laendertabelle
1656536723,675,554,121,24,8,https://www.intensivregister.de/api/public/reporting/laendertabelle
1656551126,675,555,120,24,8,https://www.intensivregister.de/api/public/reporting/laendertabelle
1656554723,675,557,118,23,8,https://www.intensivregister.de/api/public/reporting/laendertabelle
1656558332,678,565,113,24,7,https://www.intensivregister.de/api/public/reporting/laendertabelle
1656561919,682,554,128,24,7,https://www.intensivregister.de/api/public/reporting/laendertabelle
1656569129,680,556,124,25,7,https://www.intensivregister.de/api/public/reporting/laendertabelle
1656579917,680,547,133,25,7,https://www.intensivregister.de/api/public/reporting/laendertabelle
1656633925,682,549,133,25,7,https://www.intensivregister.de/api/public/reporting/laendertabelle
1656641128,682,544,138,25,7,https://www.intensivregister.de/api/public/reporting/laendertabelle
1656644735,681,544,137,26,6,https://www.intensivregister.de/api/public/reporting/laendertabelle
1656648330,681,545,136,25,7,https://www.intensivregister.de/api/public/reporting/laendertabelle
1656659126,681,546,135,25,8,https://www.intensivregister.de/api/public/reporting/laendertabelle
1656662729,679,546,133,25,8,https://www.intensivregister.de/api/public/reporting/laendertabelle
1656713125,679,542,137,25,8,https://www.intensivregister.de/api/public/reporting/laendertabelle
1656720320,680,543,137,25,8,https://www.intensivregister.de/api/public/reporting/laendertabelle
1656727523,677,541,136,24,8,https://www.intensivregister.de/api/public/reporting/laendertabelle
1656734733,671,541,130,24,8,https://www.intensivregister.de/api/public/reporting/laendertabelle
1656738321,671,536,135,25,8,https://www.intensivregister.de/api/public/reporting/laendertabelle
1656741923,671,534,137,25,8,https://www.intensivregister.de/api/public/reporting/laendertabelle
1656749134,671,532,139,25,8,https://www.intensivregister.de/api/public/reporting/laendertabelle
1656799524,671,531,140,25,8,https://www.intensivregister.de/api/public/reporting/laendertabelle
1656803129,671,530,141,25,8,https://www.intensivregister.de/api/public/reporting/laendertabelle
1656817533,671,529,142,24,8,https://www.intensivregister.de/api/public/reporting/laendertabelle
1656821126,669,525,144,23,8,https://www.intensivregister.de/api/public/reporting/laendertabelle
1656828329,666,516,150,21,7,https://www.intensivregister.de/api/public/reporting/laendertabelle
1656831925,666,513,153,22,7,https://www.intensivregister.de/api/public/reporting/laendertabelle
1656835520,666,505,161,22,7,https://www.intensivregister.de/api/public/reporting/laendertabelle
1656882327,665,506,159,22,7,https://www.intensivregister.de/api/public/reporting/laendertabelle
1656900322,665,509,156,22,7,https://www.intensivregister.de/api/public/reporting/laendertabelle
1656903928,665,513,152,22,6,https://www.intensivregister.de/api/public/reporting/laendertabelle
1656907526,666,510,156,22,6,https://www.intensivregister.de/api/public/reporting/laendertabelle
1656911125,666,512,154,21,6,https://www.intensivregister.de/api/public/reporting/laendertabelle
1656918325,662,508,154,21,6,https://www.intensivregister.de/api/public/reporting/laendertabelle
1656921929,662,507,155,20,6,https://www.intensivregister.de/api/public/reporting/laendertabelle
1656943520,663,507,156,20,6,https://www.intensivregister.de/api/public/reporting/laendertabelle
1656975927,664,509,155,20,6,https://www.intensivregister.de/api/public/reporting/laendertabelle
1656986729,664,510,154,21,6,https://www.intensivregister.de/api/public/reporting/laendertabelle
1656993926,664,521,143,25,5,https://www.intensivregister.de/api/public/reporting/laendertabelle
1657001124,666,530,136,24,5,https://www.intensivregister.de/api/public/reporting/laendertabelle
1657008329,673,540,133,27,5,https://www.intensivregister.de/api/public/reporting/laendertabelle
1657051533,673,542,131,27,5,https://www.intensivregister.de/api/public/reporting/laendertabelle
1657058723,673,543,130,28,5,https://www.intensivregister.de/api/public/reporting/laendertabelle
1657073132,673,544,129,28,5,https://www.intensivregister.de/api/public/reporting/laendertabelle
1657076727,674,550,124,28,5,https://www.intensivregister.de/api/public/reporting/laendertabelle
1657080330,677,553,124,28,5,https://www.intensivregister.de/api/public/reporting/laendertabelle
1657083924,677,552,125,30,5,https://www.intensivregister.de/api/public/reporting/laendertabelle
1657091136,678,556,122,31,5,https://www.intensivregister.de/api/public/reporting/laendertabelle
1657159530,675,553,122,31,5,https://www.intensivregister.de/api/public/reporting/laendertabelle
1657166733,675,552,123,28,5,https://www.intensivregister.de/api/public/reporting/laendertabelle
1657170335,675,549,126,26,5,https://www.intensivregister.de/api/public/reporting/laendertabelle
1657177526,674,552,122,26,6,https://www.intensivregister.de/api/public/reporting/laendertabelle
1657181121,674,550,124,25,6,https://www.intensivregister.de/api/public/reporting/laendertabelle
1657227927,674,548,126,25,6,https://www.intensivregister.de/api/public/reporting/laendertabelle
1657245927,674,547,127,25,6,https://www.intensivregister.de/api/public/reporting/laendertabelle
1657249524,668,542,126,23,6,https://www.intensivregister.de/api/public/reporting/laendertabelle
1657256723,666,542,124,24,6,https://www.intensivregister.de/api/public/reporting/laendertabelle
1657260329,666,540,126,23,6,https://www.intensivregister.de/api/public/reporting/laendertabelle
1657263931,666,537,129,23,6,https://www.intensivregister.de/api/public/reporting/laendertabelle
1657267521,666,539,127,23,6,https://www.intensivregister.de/api/public/reporting/laendertabelle
1657314329,665,539,126,23,6,https://www.intensivregister.de/api/public/reporting/laendertabelle
1657321520,666,540,126,23,6,https://www.intensivregister.de/api/public/reporting/laendertabelle
1657335919,666,545,121,23,6,https://www.intensivregister.de/api/public/reporting/laendertabelle
1657339521,666,534,132,23,6,https://www.intensivregister.de/api/public/reporting/laendertabelle
1657346735,664,531,133,22,5,https://www.intensivregister.de/api/public/reporting/laendertabelle
1657353927,664,523,141,21,5,https://www.intensivregister.de/api/public/reporting/laendertabelle
1657397129,664,522,142,21,5,https://www.intensivregister.de/api/public/reporting/laendertabelle
1657400721,664,518,146,21,5,https://www.intensivregister.de/api/public/reporting/laendertabelle
1657415118,663,517,146,21,5,https://www.intensivregister.de/api/public/reporting/laendertabelle
1657422324,663,515,148,21,5,https://www.intensivregister.de/api/public/reporting/laendertabelle
1657429533,661,507,154,22,5,https://www.intensivregister.de/api/public/reporting/laendertabelle
1657436735,661,506,155,22,5,https://www.intensivregister.de/api/public/reporting/laendertabelle
1657443930,654,500,154,22,5,https://www.intensivregister.de/api/public/reporting/laendertabelle
1657461928,654,500,154,23,6,https://www.intensivregister.de/api/public/reporting/laendertabelle
1657487130,655,501,154,24,6,https://www.intensivregister.de/api/public/reporting/laendertabelle
1657490731,655,498,157,24,6,https://www.intensivregister.de/api/public/reporting/laendertabelle
1657494319,655,498,157,25,6,https://www.intensivregister.de/api/public/reporting/laendertabelle
1657501520,655,496,159,25,6,https://www.intensivregister.de/api/public/reporting/laendertabelle
1657512326,666,500,166,30,7,https://www.intensivregister.de/api/public/reporting/laendertabelle
1657515928,666,503,163,26,7,https://www.intensivregister.de/api/public/reporting/laendertabelle
1657526720,666,505,161,29,7,https://www.intensivregister.de/api/public/reporting/laendertabelle
1657591524,666,509,157,29,7,https://www.intensivregister.de/api/public/reporting/laendertabelle
1657595120,672,534,138,27,7,https://www.intensivregister.de/api/public/reporting/laendertabelle
1657598725,671,539,132,28,7,https://www.intensivregister.de/api/public/reporting/laendertabelle
1657602327,671,543,128,31,7,https://www.intensivregister.de/api/public/reporting/laendertabelle
1657609522,671,545,126,31,7,https://www.intensivregister.de/api/public/reporting/laendertabelle
1657613128,671,547,124,30,7,https://www.intensivregister.de/api/public/reporting/laendertabelle
1657616721,671,547,124,31,7,https://www.intensivregister.de/api/public/reporting/laendertabelle
1657667133,673,546,127,31,7,https://www.intensivregister.de/api/public/reporting/laendertabelle
1657670721,675,547,128,32,7,https://www.intensivregister.de/api/public/reporting/laendertabelle
1657681532,676,543,133,35,8,https://www.intensivregister.de/api/public/reporting/laendertabelle
1657685121,676,536,140,34,8,https://www.intensivregister.de/api/public/reporting/laendertabelle
1657692320,677,542,135,31,6,https://www.intensivregister.de/api/public/reporting/laendertabelle
1657749927,677,543,134,31,6,https://www.intensivregister.de/api/public/reporting/laendertabelle
1657760731,678,539,139,32,6,https://www.intensivregister.de/api/public/reporting/laendertabelle
1657764320,680,540,140,32,6,https://www.intensivregister.de/api/public/reporting/laendertabelle
1657767928,678,543,135,32,4,https://www.intensivregister.de/api/public/reporting/laendertabelle
1657775125,679,546,133,30,5,https://www.intensivregister.de/api/public/reporting/laendertabelle
1657782321,679,542,137,31,5,https://www.intensivregister.de/api/public/reporting/laendertabelle
1657785919,669,536,133,30,5,https://www.intensivregister.de/api/public/reporting/laendertabelle
1657789528,669,536,133,29,4,https://www.intensivregister.de/api/public/reporting/laendertabelle
1657832727,669,540,129,29,4,https://www.intensivregister.de/api/public/reporting/laendertabelle
1657836327,669,539,130,29,4,https://www.intensivregister.de/api/public/reporting/laendertabelle
1657854321,672,541,131,31,6,https://www.intensivregister.de/api/public/reporting/laendertabelle
1657857927,672,542,130,28,6,https://www.intensivregister.de/api/public/reporting/laendertabelle
1657865120,670,540,130,31,7,https://www.intensivregister.de/api/public/reporting/laendertabelle
1657872320,666,537,129,31,8,https://www.intensivregister.de/api/public/reporting/laendertabelle
1657875920,666,536,130,30,8,https://www.intensivregister.de/api/public/reporting/laendertabelle
1657879517,664,536,128,31,9,https://www.intensivregister.de/api/public/reporting/laendertabelle
1657922727,664,537,127,32,9,https://www.intensivregister.de/api/public/reporting/laendertabelle
1657940721,664,538,126,33,9,https://www.intensivregister.de/api/public/reporting/laendertabelle
1657944320,654,533,121,33,9,https://www.intensivregister.de/api/public/reporting/laendertabelle
1657951521,651,528,123,30,8,https://www.intensivregister.de/api/public/reporting/laendertabelle
1657955129,652,526,126,30,8,https://www.intensivregister.de/api/public/reporting/laendertabelle
1657962321,653,527,126,30,8,https://www.intensivregister.de/api/public/reporting/laendertabelle
1658005521,652,523,129,29,8,https://www.intensivregister.de/api/public/reporting/laendertabelle
1658027127,651,516,135,29,8,https://www.intensivregister.de/api/public/reporting/laendertabelle
1658030720,642,498,144,28,8,https://www.intensivregister.de/api/public/reporting/laendertabelle
1658034328,642,499,143,28,8,https://www.intensivregister.de/api/public/reporting/laendertabelle
1658037928,640,497,143,31,7,https://www.intensivregister.de/api/public/reporting/laendertabelle
1658041521,640,497,143,32,7,https://www.intensivregister.de/api/public/reporting/laendertabelle
1658070321,640,497,143,31,7,https://www.intensivregister.de/api/public/reporting/laendertabelle
1658088328,641,497,144,31,7,https://www.intensivregister.de/api/public/reporting/laendertabelle
1658095527,641,498,143,31,7,https://www.intensivregister.de/api/public/reporting/laendertabelle
1658106328,641,499,142,31,7,https://www.intensivregister.de/api/public/reporting/laendertabelle
1658109921,642,501,141,29,5,https://www.intensivregister.de/api/public/reporting/laendertabelle
1658117127,644,514,130,34,7,https://www.intensivregister.de/api/public/reporting/laendertabelle
1658124317,654,524,130,36,7,https://www.intensivregister.de/api/public/reporting/laendertabelle
1658131521,654,526,128,36,7,https://www.intensivregister.de/api/public/reporting/laendertabelle
1658181918,654,527,127,37,8,https://www.intensivregister.de/api/public/reporting/laendertabelle
1658192717,654,528,126,37,8,https://www.intensivregister.de/api/public/reporting/laendertabelle
1658199921,659,535,124,34,7,https://www.intensivregister.de/api/public/reporting/laendertabelle
1658203520,670,548,122,35,9,https://www.intensivregister.de/api/public/reporting/laendertabelle
1658207120,670,547,123,34,9,https://www.intensivregister.de/api/public/reporting/laendertabelle
1658214321,670,549,121,34,9,https://www.intensivregister.de/api/public/reporting/laendertabelle
1658217918,670,549,121,35,9,https://www.intensivregister.de/api/public/reporting/laendertabelle
1658282720,670,543,127,36,9,https://www.intensivregister.de/api/public/reporting/laendertabelle
1658289921,670,549,121,36,10,https://www.intensivregister.de/api/public/reporting/laendertabelle
1658293521,671,550,121,36,10,https://www.intensivregister.de/api/public/reporting/laendertabelle
1658297118,671,551,120,36,10,https://www.intensivregister.de/api/public/reporting/laendertabelle
1658300718,671,551,120,34,10,https://www.intensivregister.de/api/public/reporting/laendertabelle
1658369128,671,554,117,34,10,https://www.intensivregister.de/api/public/reporting/laendertabelle
1658372728,672,548,124,33,11,https://www.intensivregister.de/api/public/reporting/laendertabelle
1658376321,673,548,125,31,10,https://www.intensivregister.de/api/public/reporting/laendertabelle
1658379918,673,541,132,31,11,https://www.intensivregister.de/api/public/reporting/laendertabelle
1658387122,675,545,130,31,11,https://www.intensivregister.de/api/public/reporting/laendertabelle
1658390721,675,546,129,32,11,https://www.intensivregister.de/api/public/reporting/laendertabelle
1658451931,675,544,131,32,11,https://www.intensivregister.de/api/public/reporting/laendertabelle
1658455529,675,542,133,32,10,https://www.intensivregister.de/api/public/reporting/laendertabelle
1658462721,673,536,137,32,8,https://www.intensivregister.de/api/public/reporting/laendertabelle
1658462721,673,541,132,34,8,https://www.intensivregister.de/api/public/reporting/laendertabelle
1658469921,673,542,131,33,8,https://www.intensivregister.de/api/public/reporting/laendertabelle
1658473521,673,540,133,33,8,https://www.intensivregister.de/api/public/reporting/laendertabelle
1658523917,673,539,134,32,8,https://www.intensivregister.de/api/public/reporting/laendertabelle
1658527528,673,536,137,33,9,https://www.intensivregister.de/api/public/reporting/laendertabelle
1658545518,673,529,144,31,9,https://www.intensivregister.de/api/public/reporting/laendertabelle
1658549117,671,536,135,30,9,https://www.intensivregister.de/api/public/reporting/laendertabelle
1658552721,671,537,134,30,10,https://www.intensivregister.de/api/public/reporting/laendertabelle
1658559917,671,529,142,30,10,https://www.intensivregister.de/api/public/reporting/laendertabelle
1658563522,670,530,140,30,10,https://www.intensivregister.de/api/public/reporting/laendertabelle
1658610321,670,531,139,30,10,https://www.intensivregister.de/api/public/reporting/laendertabelle
1658631917,671,535,136,30,10,https://www.intensivregister.de/api/public/reporting/laendertabelle
1658639118,667,534,133,31,10,https://www.intensivregister.de/api/public/reporting/laendertabelle
1658642717,667,533,134,32,11,https://www.intensivregister.de/api/public/reporting/laendertabelle
1658646329,667,532,135,33,11,https://www.intensivregister.de/api/public/reporting/laendertabelle
1658653520,664,528,136,33,11,https://www.intensivregister.de/api/public/reporting/laendertabelle
1658664321,666,530,136,33,11,https://www.intensivregister.de/api/public/reporting/laendertabelle
1658714720,666,527,139,33,11,https://www.intensivregister.de/api/public/reporting/laendertabelle
1658721918,665,535,130,35,12,https://www.intensivregister.de/api/public/reporting/laendertabelle
1658725528,666,534,132,37,13,https://www.intensivregister.de/api/public/reporting/laendertabelle
1658732720,667,532,135,38,13,https://www.intensivregister.de/api/public/reporting/laendertabelle
1658736328,670,535,135,39,13,https://www.intensivregister.de/api/public/reporting/laendertabelle
1658786728,670,533,137,39,12,https://www.intensivregister.de/api/public/reporting/laendertabelle
1658793928,670,534,136,39,12,https://www.intensivregister.de/api/public/reporting/laendertabelle
1658797528,670,536,134,38,12,https://www.intensivregister.de/api/public/reporting/laendertabelle
1658801121,672,539,133,40,12,https://www.intensivregister.de/api/public/reporting/laendertabelle
1658804729,670,534,136,40,12,https://www.intensivregister.de/api/public/reporting/laendertabelle
1658811923,677,544,133,40,9,https://www.intensivregister.de/api/public/reporting/laendertabelle
1658819121,677,548,129,44,10,https://www.intensivregister.de/api/public/reporting/laendertabelle
1658833521,678,547,131,44,10,https://www.intensivregister.de/api/public/reporting/laendertabelle
1658873121,678,549,129,45,11,https://www.intensivregister.de/api/public/reporting/laendertabelle
1658891118,682,556,126,40,8,https://www.intensivregister.de/api/public/reporting/laendertabelle
1658894721,682,553,129,42,8,https://www.intensivregister.de/api/public/reporting/laendertabelle
1658898322,682,554,128,42,8,https://www.intensivregister.de/api/public/reporting/laendertabelle
1658901923,682,552,130,40,8,https://www.intensivregister.de/api/public/reporting/laendertabelle
1658905529,682,551,131,39,8,https://www.intensivregister.de/api/public/reporting/laendertabelle
1658945128,681,552,129,39,8,https://www.intensivregister.de/api/public/reporting/laendertabelle
1658955921,681,554,127,39,8,https://www.intensivregister.de/api/public/reporting/laendertabelle
1658959527,681,555,126,39,8,https://www.intensivregister.de/api/public/reporting/laendertabelle
1658973921,681,555,126,38,8,https://www.intensivregister.de/api/public/reporting/laendertabelle
1658977521,680,550,130,36,8,https://www.intensivregister.de/api/public/reporting/laendertabelle
1658981123,680,543,137,33,8,https://www.intensivregister.de/api/public/reporting/laendertabelle
1658988317,680,547,133,32,9,https://www.intensivregister.de/api/public/reporting/laendertabelle
1658991918,680,547,133,33,9,https://www.intensivregister.de/api/public/reporting/laendertabelle
1659038728,680,544,136,33,9,https://www.intensivregister.de/api/public/reporting/laendertabelle
1659042323,680,543,137,33,9,https://www.intensivregister.de/api/public/reporting/laendertabelle
1659063921,678,532,146,33,8,https://www.intensivregister.de/api/public/reporting/laendertabelle
1659067528,678,534,144,33,9,https://www.intensivregister.de/api/public/reporting/laendertabelle
1659071118,678,535,143,34,9,https://www.intensivregister.de/api/public/reporting/laendertabelle
1659074722,678,534,144,34,9,https://www.intensivregister.de/api/public/reporting/laendertabelle
1659081921,677,536,141,34,9,https://www.intensivregister.de/api/public/reporting/laendertabelle
1659125128,677,535,142,34,9,https://www.intensivregister.de/api/public/reporting/laendertabelle
1659128723,677,536,141,33,8,https://www.intensivregister.de/api/public/reporting/laendertabelle
1659150327,675,536,139,35,9,https://www.intensivregister.de/api/public/reporting/laendertabelle
1659153918,675,536,139,36,9,https://www.intensivregister.de/api/public/reporting/laendertabelle
1659157518,668,525,143,35,10,https://www.intensivregister.de/api/public/reporting/laendertabelle
1659161129,668,531,137,32,11,https://www.intensivregister.de/api/public/reporting/laendertabelle
1659168321,668,530,138,34,10,https://www.intensivregister.de/api/public/reporting/laendertabelle
1659215129,668,529,139,33,11,https://www.intensivregister.de/api/public/reporting/laendertabelle
1659222321,667,529,138,34,11,https://www.intensivregister.de/api/public/reporting/laendertabelle
1659236718,667,527,140,32,11,https://www.intensivregister.de/api/public/reporting/laendertabelle
1659240329,664,522,142,31,12,https://www.intensivregister.de/api/public/reporting/laendertabelle
1659247521,660,516,144,31,12,https://www.intensivregister.de/api/public/reporting/laendertabelle
1659251127,659,510,149,30,12,https://www.intensivregister.de/api/public/reporting/laendertabelle
1659319520,659,510,149,29,12,https://www.intensivregister.de/api/public/reporting/laendertabelle
1659323118,660,520,140,31,12,https://www.intensivregister.de/api/public/reporting/laendertabelle
1659330321,660,518,142,36,15,https://www.intensivregister.de/api/public/reporting/laendertabelle
1659333917,660,516,144,34,15,https://www.intensivregister.de/api/public/reporting/laendertabelle
1659341128,663,526,137,34,15,https://www.intensivregister.de/api/public/reporting/laendertabelle
1659348322,663,531,132,34,15,https://www.intensivregister.de/api/public/reporting/laendertabelle
1659387928,663,529,134,35,15,https://www.intensivregister.de/api/public/reporting/laendertabelle
1659391517,663,530,133,35,15,https://www.intensivregister.de/api/public/reporting/laendertabelle
1659413121,668,546,122,39,14,https://www.intensivregister.de/api/public/reporting/laendertabelle
1659420317,675,552,123,38,14,https://www.intensivregister.de/api/public/reporting/laendertabelle
1659427517,675,557,118,38,14,https://www.intensivregister.de/api/public/reporting/laendertabelle
1659474328,675,557,118,39,14,https://www.intensivregister.de/api/public/reporting/laendertabelle
1659488720,675,556,119,39,14,https://www.intensivregister.de/api/public/reporting/laendertabelle
1659495918,679,552,127,42,14,https://www.intensivregister.de/api/public/reporting/laendertabelle
1659503121,685,556,129,39,13,https://www.intensivregister.de/api/public/reporting/laendertabelle
1659506727,685,555,130,40,12,https://www.intensivregister.de/api/public/reporting/laendertabelle
1659513928,686,556,130,39,12,https://www.intensivregister.de/api/public/reporting/laendertabelle
1659531921,686,555,131,42,16,https://www.intensivregister.de/api/public/reporting/laendertabelle
1659560728,686,556,130,42,16,https://www.intensivregister.de/api/public/reporting/laendertabelle
1659578722,687,555,132,42,16,https://www.intensivregister.de/api/public/reporting/laendertabelle
1659585927,685,549,136,38,13,https://www.intensivregister.de/api/public/reporting/laendertabelle
1659589528,685,550,135,39,13,https://www.intensivregister.de/api/public/reporting/laendertabelle
1659593118,684,549,135,40,13,https://www.intensivregister.de/api/public/reporting/laendertabelle
1659596718,684,545,139,40,13,https://www.intensivregister.de/api/public/reporting/laendertabelle
1659668721,684,537,147,37,13,https://www.intensivregister.de/api/public/reporting/laendertabelle
1659672327,684,537,147,38,11,https://www.intensivregister.de/api/public/reporting/laendertabelle
1659675917,684,546,138,39,11,https://www.intensivregister.de/api/public/reporting/laendertabelle
1659683121,683,553,130,37,10,https://www.intensivregister.de/api/public/reporting/laendertabelle
1659686718,683,557,126,37,10,https://www.intensivregister.de/api/public/reporting/laendertabelle
1659704717,683,558,125,37,10,https://www.intensivregister.de/api/public/reporting/laendertabelle
1659733520,683,557,126,37,10,https://www.intensivregister.de/api/public/reporting/laendertabelle
1659740729,683,558,125,37,10,https://www.intensivregister.de/api/public/reporting/laendertabelle
1659755128,683,556,127,38,11,https://www.intensivregister.de/api/public/reporting/laendertabelle
1659762329,683,560,123,41,12,https://www.intensivregister.de/api/public/reporting/laendertabelle
1659765922,676,558,118,37,12,https://www.intensivregister.de/api/public/reporting/laendertabelle
1659773121,677,553,124,34,12,https://www.intensivregister.de/api/public/reporting/laendertabelle
1659819919,677,548,129,34,12,https://www.intensivregister.de/api/public/reporting/laendertabelle
1659841522,678,549,129,34,13,https://www.intensivregister.de/api/public/reporting/laendertabelle
1659848718,676,527,149,30,10,https://www.intensivregister.de/api/public/reporting/laendertabelle
1659852321,678,522,156,30,10,https://www.intensivregister.de/api/public/reporting/laendertabelle
1659859521,678,514,164,29,10,https://www.intensivregister.de/api/public/reporting/laendertabelle
1659899128,678,516,162,29,10,https://www.intensivregister.de/api/public/reporting/laendertabelle
1659902717,676,514,162,29,10,https://www.intensivregister.de/api/public/reporting/laendertabelle
1659906327,676,512,164,29,10,https://www.intensivregister.de/api/public/reporting/laendertabelle
1659927918,680,517,163,28,11,https://www.intensivregister.de/api/public/reporting/laendertabelle
1659935121,681,523,158,30,11,https://www.intensivregister.de/api/public/reporting/laendertabelle
1659942317,681,528,153,31,11,https://www.intensivregister.de/api/public/reporting/laendertabelle
1659945921,681,525,156,31,11,https://www.intensivregister.de/api/public/reporting/laendertabelle
1659989117,681,527,154,31,11,https://www.intensivregister.de/api/public/reporting/laendertabelle
1659996320,681,525,156,31,11,https://www.intensivregister.de/api/public/reporting/laendertabelle
1660017921,683,531,152,33,10,https://www.intensivregister.de/api/public/reporting/laendertabelle
1660025121,684,532,152,33,11,https://www.intensivregister.de/api/public/reporting/laendertabelle
1660035929,684,536,148,33,10,https://www.intensivregister.de/api/public/reporting/laendertabelle
1660043118,686,536,150,33,10,https://www.intensivregister.de/api/public/reporting/laendertabelle
1660079117,686,537,149,33,10,https://www.intensivregister.de/api/public/reporting/laendertabelle
1660093522,686,536,150,33,10,https://www.intensivregister.de/api/public/reporting/laendertabelle
1660104328,682,547,135,33,7,https://www.intensivregister.de/api/public/reporting/laendertabelle
1660107927,682,551,131,33,7,https://www.intensivregister.de/api/public/reporting/laendertabelle
1660115118,682,553,129,34,7,https://www.intensivregister.de/api/public/reporting/laendertabelle
1660118718,682,552,130,34,7,https://www.intensivregister.de/api/public/reporting/laendertabelle
1660165528,682,552,130,35,7,https://www.intensivregister.de/api/public/reporting/laendertabelle
1660176321,682,553,129,35,7,https://www.intensivregister.de/api/public/reporting/laendertabelle
1660187118,682,553,129,34,8,https://www.intensivregister.de/api/public/reporting/laendertabelle
1660190720,682,545,137,31,8,https://www.intensivregister.de/api/public/reporting/laendertabelle
1660194328,682,543,139,29,9,https://www.intensivregister.de/api/public/reporting/laendertabelle
1660197921,682,538,144,28,9,https://www.intensivregister.de/api/public/reporting/laendertabelle
1660205120,678,536,142,26,10,https://www.intensivregister.de/api/public/reporting/laendertabelle
1660255528,678,537,141,28,11,https://www.intensivregister.de/api/public/reporting/laendertabelle
1660259118,678,536,142,28,11,https://www.intensivregister.de/api/public/reporting/laendertabelle
1660262730,678,537,141,29,11,https://www.intensivregister.de/api/public/reporting/laendertabelle
1660266318,678,540,138,29,11,https://www.intensivregister.de/api/public/reporting/laendertabelle
1660269921,678,541,137,29,11,https://www.intensivregister.de/api/public/reporting/laendertabelle
1660277121,677,545,132,31,9,https://www.intensivregister.de/api/public/reporting/laendertabelle
1660280722,677,544,133,32,10,https://www.intensivregister.de/api/public/reporting/laendertabelle
1660284322,675,547,128,32,10,https://www.intensivregister.de/api/public/reporting/laendertabelle
1660291522,675,548,127,34,10,https://www.intensivregister.de/api/public/reporting/laendertabelle
1660334718,675,546,129,33,10,https://www.intensivregister.de/api/public/reporting/laendertabelle
1660349129,675,547,128,33,10,https://www.intensivregister.de/api/public/reporting/laendertabelle
1660363518,676,540,136,31,10,https://www.intensivregister.de/api/public/reporting/laendertabelle
1660367120,669,526,143,31,10,https://www.intensivregister.de/api/public/reporting/laendertabelle
1660370721,663,525,138,28,9,https://www.intensivregister.de/api/public/reporting/laendertabelle
1660374328,663,522,141,30,10,https://www.intensivregister.de/api/public/reporting/laendertabelle
1660377921,663,521,142,30,10,https://www.intensivregister.de/api/public/reporting/laendertabelle
1660435521,663,520,143,30,10,https://www.intensivregister.de/api/public/reporting/laendertabelle
1660439122,663,518,145,29,10,https://www.intensivregister.de/api/public/reporting/laendertabelle
1660453521,658,500,158,26,10,https://www.intensivregister.de/api/public/reporting/laendertabelle
1660457121,658,499,159,26,10,https://www.intensivregister.de/api/public/reporting/laendertabelle
1660503927,658,501,157,26,9,https://www.intensivregister.de/api/public/reporting/laendertabelle
1660507528,658,504,154,26,9,https://www.intensivregister.de/api/public/reporting/laendertabelle
1660514728,658,501,157,26,9,https://www.intensivregister.de/api/public/reporting/laendertabelle
1660532727,658,503,155,27,9,https://www.intensivregister.de/api/public/reporting/laendertabelle
1660536318,660,504,156,28,8,https://www.intensivregister.de/api/public/reporting/laendertabelle
1660539929,659,498,161,28,8,https://www.intensivregister.de/api/public/reporting/laendertabelle
1660547128,659,503,156,28,8,https://www.intensivregister.de/api/public/reporting/laendertabelle
1660550721,659,500,159,28,8,https://www.intensivregister.de/api/public/reporting/laendertabelle
1660593929,659,501,158,28,8,https://www.intensivregister.de/api/public/reporting/laendertabelle
1660597521,659,498,161,28,8,https://www.intensivregister.de/api/public/reporting/laendertabelle
1660604728,656,499,157,30,8,https://www.intensivregister.de/api/public/reporting/laendertabelle
1660611921,656,505,151,30,8,https://www.intensivregister.de/api/public/reporting/laendertabelle
1660619118,668,514,154,28,7,https://www.intensivregister.de/api/public/reporting/laendertabelle
1660622718,668,529,139,26,6,https://www.intensivregister.de/api/public/reporting/laendertabelle
1660629921,674,533,141,25,6,https://www.intensivregister.de/api/public/reporting/laendertabelle
1660633520,674,535,139,24,6,https://www.intensivregister.de/api/public/reporting/laendertabelle
1660669528,674,536,138,24,5,https://www.intensivregister.de/api/public/reporting/laendertabelle
1660680317,674,535,139,24,5,https://www.intensivregister.de/api/public/reporting/laendertabelle
1660687528,674,535,139,23,4,https://www.intensivregister.de/api/public/reporting/laendertabelle
1660705521,674,528,146,23,4,https://www.intensivregister.de/api/public/reporting/laendertabelle
1660709128,674,523,151,25,4,https://www.intensivregister.de/api/public/reporting/laendertabelle
1660712720,674,522,152,27,4,https://www.intensivregister.de/api/public/reporting/laendertabelle
1660716328,676,527,149,26,4,https://www.intensivregister.de/api/public/reporting/laendertabelle
1660723529,676,520,156,27,5,https://www.intensivregister.de/api/public/reporting/laendertabelle
1660730728,676,520,156,28,5,https://www.intensivregister.de/api/public/reporting/laendertabelle
1660773923,679,519,160,27,5,https://www.intensivregister.de/api/public/reporting/laendertabelle
1660795525,677,527,150,29,5,https://www.intensivregister.de/api/public/reporting/laendertabelle
1660802715,677,525,152,29,5,https://www.intensivregister.de/api/public/reporting/laendertabelle
1660806314,677,534,143,30,5,https://www.intensivregister.de/api/public/reporting/laendertabelle
1660860314,677,536,141,30,5,https://www.intensivregister.de/api/public/reporting/laendertabelle
1660874715,677,540,137,30,5,https://www.intensivregister.de/api/public/reporting/laendertabelle
1660881925,675,539,136,31,5,https://www.intensivregister.de/api/public/reporting/laendertabelle
1660889115,672,536,136,28,5,https://www.intensivregister.de/api/public/reporting/laendertabelle
1660896314,672,534,138,28,5,https://www.intensivregister.de/api/public/reporting/laendertabelle
1660907115,668,533,135,31,5,https://www.intensivregister.de/api/public/reporting/laendertabelle
1660939524,668,536,132,31,5,https://www.intensivregister.de/api/public/reporting/laendertabelle
1660946715,668,534,134,31,5,https://www.intensivregister.de/api/public/reporting/laendertabelle
1660971914,665,529,136,31,4,https://www.intensivregister.de/api/public/reporting/laendertabelle
1661000724,665,530,135,28,4,https://www.intensivregister.de/api/public/reporting/laendertabelle
1661011515,665,528,137,28,4,https://www.intensivregister.de/api/public/reporting/laendertabelle
1661036715,665,526,139,28,4,https://www.intensivregister.de/api/public/reporting/laendertabelle
1661094324,665,514,151,30,4,https://www.intensivregister.de/api/public/reporting/laendertabelle
1661112314,665,515,150,30,4,https://www.intensivregister.de/api/public/reporting/laendertabelle
1661119523,665,517,148,30,4,https://www.intensivregister.de/api/public/reporting/laendertabelle
1661126724,665,516,149,30,4,https://www.intensivregister.de/api/public/reporting/laendertabelle
1661137515,662,511,151,29,5,https://www.intensivregister.de/api/public/reporting/laendertabelle
1661141116,670,506,164,29,5,https://www.intensivregister.de/api/public/reporting/laendertabelle
1661148324,670,501,169,29,5,https://www.intensivregister.de/api/public/reporting/laendertabelle
1661155524,670,502,168,30,5,https://www.intensivregister.de/api/public/reporting/laendertabelle
1661162714,670,503,167,30,5,https://www.intensivregister.de/api/public/reporting/laendertabelle
1661202314,674,514,160,29,5,https://www.intensivregister.de/api/public/reporting/laendertabelle
1661209514,674,515,159,29,5,https://www.intensivregister.de/api/public/reporting/laendertabelle
1661220324,674,516,158,29,5,https://www.intensivregister.de/api/public/reporting/laendertabelle
1661227524,672,528,144,30,6,https://www.intensivregister.de/api/public/reporting/laendertabelle
1661231124,672,531,141,31,6,https://www.intensivregister.de/api/public/reporting/laendertabelle
1661238324,672,533,139,31,5,https://www.intensivregister.de/api/public/reporting/laendertabelle
1661256324,672,536,136,31,5,https://www.intensivregister.de/api/public/reporting/laendertabelle
1661288724,672,533,139,31,5,https://www.intensivregister.de/api/public/reporting/laendertabelle
1661299524,672,532,140,32,5,https://www.intensivregister.de/api/public/reporting/laendertabelle
1661303114,672,534,138,32,5,https://www.intensivregister.de/api/public/reporting/laendertabelle
1661313914,680,541,139,30,6,https://www.intensivregister.de/api/public/reporting/laendertabelle
1661321114,680,536,144,30,5,https://www.intensivregister.de/api/public/reporting/laendertabelle
1661346314,681,538,143,29,6,https://www.intensivregister.de/api/public/reporting/laendertabelle
1661375124,681,535,146,29,7,https://www.intensivregister.de/api/public/reporting/laendertabelle
1661393114,681,536,145,29,7,https://www.intensivregister.de/api/public/reporting/laendertabelle
1661396714,680,537,143,30,7,https://www.intensivregister.de/api/public/reporting/laendertabelle
1661400325,679,533,146,28,8,https://www.intensivregister.de/api/public/reporting/laendertabelle
1661407523,677,531,146,28,8,https://www.intensivregister.de/api/public/reporting/laendertabelle
1661411113,677,532,145,27,9,https://www.intensivregister.de/api/public/reporting/laendertabelle
1661465114,677,529,148,27,9,https://www.intensivregister.de/api/public/reporting/laendertabelle
1661479525,678,530,148,27,9,https://www.intensivregister.de/api/public/reporting/laendertabelle
1661483114,670,528,142,26,7,https://www.intensivregister.de/api/public/reporting/laendertabelle
1661490315,670,532,138,24,6,https://www.intensivregister.de/api/public/reporting/laendertabelle
1661493924,670,533,137,25,6,https://www.intensivregister.de/api/public/reporting/laendertabelle
1661497514,668,530,138,26,7,https://www.intensivregister.de/api/public/reporting/laendertabelle
1661504715,669,529,140,26,8,https://www.intensivregister.de/api/public/reporting/laendertabelle
1661565914,671,529,142,26,8,https://www.intensivregister.de/api/public/reporting/laendertabelle
1661573124,672,513,159,26,8,https://www.intensivregister.de/api/public/reporting/laendertabelle
1661580315,670,508,162,27,8,https://www.intensivregister.de/api/public/reporting/laendertabelle
1661583914,670,510,160,27,8,https://www.intensivregister.de/api/public/reporting/laendertabelle
1661594714,674,509,165,27,9,https://www.intensivregister.de/api/public/reporting/laendertabelle
1661634313,674,511,163,27,9,https://www.intensivregister.de/api/public/reporting/laendertabelle
1661659513,670,491,179,26,9,https://www.intensivregister.de/api/public/reporting/laendertabelle
1661666714,670,491,179,24,9,https://www.intensivregister.de/api/public/reporting/laendertabelle
1661670314,670,496,174,23,8,https://www.intensivregister.de/api/public/reporting/laendertabelle
1661720724,670,494,176,23,8,https://www.intensivregister.de/api/public/reporting/laendertabelle
1661727914,670,495,175,23,8,https://www.intensivregister.de/api/public/reporting/laendertabelle
1661738714,670,493,177,23,8,https://www.intensivregister.de/api/public/reporting/laendertabelle
1661745914,673,499,174,22,9,https://www.intensivregister.de/api/public/reporting/laendertabelle
1661749524,673,500,173,24,9,https://www.intensivregister.de/api/public/reporting/laendertabelle
1661753114,677,504,173,26,9,https://www.intensivregister.de/api/public/reporting/laendertabelle
1661756724,678,506,172,26,9,https://www.intensivregister.de/api/public/reporting/laendertabelle
1661807114,678,511,167,26,9,https://www.intensivregister.de/api/public/reporting/laendertabelle
1661810714,682,511,171,26,9,https://www.intensivregister.de/api/public/reporting/laendertabelle
1661825124,682,513,169,26,9,https://www.intensivregister.de/api/public/reporting/laendertabelle
1661828715,686,518,168,25,10,https://www.intensivregister.de/api/public/reporting/laendertabelle
1661832315,684,522,162,25,10,https://www.intensivregister.de/api/public/reporting/laendertabelle
1661839517,686,524,162,25,9,https://www.intensivregister.de/api/public/reporting/laendertabelle
1661846716,685,526,159,25,10,https://www.intensivregister.de/api/public/reporting/laendertabelle
1661893514,685,524,161,25,10,https://www.intensivregister.de/api/public/reporting/laendertabelle
1661904324,685,522,163,26,11,https://www.intensivregister.de/api/public/reporting/laendertabelle
1661918714,683,527,156,25,10,https://www.intensivregister.de/api/public/reporting/laendertabelle
1661925923,683,534,149,22,10,https://www.intensivregister.de/api/public/reporting/laendertabelle
1661929523,683,534,149,23,10,https://www.intensivregister.de/api/public/reporting/laendertabelle
1662001513,683,543,140,22,8,https://www.intensivregister.de/api/public/reporting/laendertabelle
1662005124,683,546,137,25,10,https://www.intensivregister.de/api/public/reporting/laendertabelle
1662008714,685,551,134,26,10,https://www.intensivregister.de/api/public/reporting/laendertabelle
1662015915,685,548,137,25,10,https://www.intensivregister.de/api/public/reporting/laendertabelle
1662019514,686,548,138,24,10,https://www.intensivregister.de/api/public/reporting/laendertabelle
1662033923,686,547,139,24,10,https://www.intensivregister.de/api/public/reporting/laendertabelle
1662066323,686,548,138,24,10,https://www.intensivregister.de/api/public/reporting/laendertabelle
1662087913,684,543,141,25,9,https://www.intensivregister.de/api/public/reporting/laendertabelle
1662091513,674,547,127,26,9,https://www.intensivregister.de/api/public/reporting/laendertabelle
1662095114,672,552,120,26,9,https://www.intensivregister.de/api/public/reporting/laendertabelle
1662098723,672,551,121,26,9,https://www.intensivregister.de/api/public/reporting/laendertabelle
1662105923,666,546,120,26,9,https://www.intensivregister.de/api/public/reporting/laendertabelle
1662116713,666,547,119,26,9,https://www.intensivregister.de/api/public/reporting/laendertabelle
1662156323,666,544,122,26,9,https://www.intensivregister.de/api/public/reporting/laendertabelle
1662163523,666,549,117,26,9,https://www.intensivregister.de/api/public/reporting/laendertabelle
1662174323,663,547,116,27,9,https://www.intensivregister.de/api/public/reporting/laendertabelle
1662181523,660,545,115,25,8,https://www.intensivregister.de/api/public/reporting/laendertabelle
1662188724,662,549,113,25,8,https://www.intensivregister.de/api/public/reporting/laendertabelle
1662192314,662,548,114,25,8,https://www.intensivregister.de/api/public/reporting/laendertabelle
1662199513,662,545,117,25,8,https://www.intensivregister.de/api/public/reporting/laendertabelle
1662242713,662,544,118,25,8,https://www.intensivregister.de/api/public/reporting/laendertabelle
1662249913,662,543,119,25,8,https://www.intensivregister.de/api/public/reporting/laendertabelle
1662257113,662,542,120,25,8,https://www.intensivregister.de/api/public/reporting/laendertabelle
1662260715,662,541,121,25,8,https://www.intensivregister.de/api/public/reporting/laendertabelle
1662267914,661,527,134,24,8,https://www.intensivregister.de/api/public/reporting/laendertabelle
1662271514,661,525,136,23,8,https://www.intensivregister.de/api/public/reporting/laendertabelle
1662275114,661,518,143,23,8,https://www.intensivregister.de/api/public/reporting/laendertabelle
1662278713,661,513,148,24,9,https://www.intensivregister.de/api/public/reporting/laendertabelle
1662343513,661,514,147,24,9,https://www.intensivregister.de/api/public/reporting/laendertabelle
1662347124,662,516,146,25,8,https://www.intensivregister.de/api/public/reporting/laendertabelle
1662350713,660,519,141,25,8,https://www.intensivregister.de/api/public/reporting/laendertabelle
1662354314,660,518,142,25,8,https://www.intensivregister.de/api/public/reporting/laendertabelle
1662357914,661,521,140,25,8,https://www.intensivregister.de/api/public/reporting/laendertabelle
1662368724,661,519,142,25,8,https://www.intensivregister.de/api/public/reporting/laendertabelle
1662411913,661,513,148,25,8,https://www.intensivregister.de/api/public/reporting/laendertabelle
1662415513,661,512,149,25,8,https://www.intensivregister.de/api/public/reporting/laendertabelle
1662433513,669,524,145,27,7,https://www.intensivregister.de/api/public/reporting/laendertabelle
1662437114,670,530,140,28,8,https://www.intensivregister.de/api/public/reporting/laendertabelle
1662440714,670,531,139,28,8,https://www.intensivregister.de/api/public/reporting/laendertabelle
1662447913,671,539,132,28,8,https://www.intensivregister.de/api/public/reporting/laendertabelle
1662494723,671,538,133,28,8,https://www.intensivregister.de/api/public/reporting/laendertabelle
1662498314,672,537,135,28,8,https://www.intensivregister.de/api/public/reporting/laendertabelle
1662523524,670,548,122,24,7,https://www.intensivregister.de/api/public/reporting/laendertabelle
1662530716,670,547,123,24,7,https://www.intensivregister.de/api/public/reporting/laendertabelle
1662584713,670,546,124,24,7,https://www.intensivregister.de/api/public/reporting/laendertabelle
1662606324,669,542,127,25,7,https://www.intensivregister.de/api/public/reporting/laendertabelle
1662609914,667,543,124,29,8,https://www.intensivregister.de/api/public/reporting/laendertabelle
1662617114,665,539,126,28,8,https://www.intensivregister.de/api/public/reporting/laendertabelle
1662620724,665,536,129,28,8,https://www.intensivregister.de/api/public/reporting/laendertabelle
1662624324,665,537,128,28,8,https://www.intensivregister.de/api/public/reporting/laendertabelle
1662667524,667,539,128,28,8,https://www.intensivregister.de/api/public/reporting/laendertabelle
1662671114,667,542,125,28,8,https://www.intensivregister.de/api/public/reporting/laendertabelle
1662674715,668,543,125,28,8,https://www.intensivregister.de/api/public/reporting/laendertabelle
1662689124,668,544,124,28,8,https://www.intensivregister.de/api/public/reporting/laendertabelle
1662692724,671,545,126,25,8,https://www.intensivregister.de/api/public/reporting/laendertabelle
1662696315,671,550,121,25,8,https://www.intensivregister.de/api/public/reporting/laendertabelle
1662699915,673,548,125,25,8,https://www.intensivregister.de/api/public/reporting/laendertabelle
1662703514,673,547,126,26,8,https://www.intensivregister.de/api/public/reporting/laendertabelle
1662707116,673,548,125,26,8,https://www.intensivregister.de/api/public/reporting/laendertabelle
1662753924,673,549,124,26,8,https://www.intensivregister.de/api/public/reporting/laendertabelle
1662761114,673,549,124,25,7,https://www.intensivregister.de/api/public/reporting/laendertabelle
1662782714,667,540,127,23,6,https://www.intensivregister.de/api/public/reporting/laendertabelle
1662786314,666,540,126,23,6,https://www.intensivregister.de/api/public/reporting/laendertabelle
1662789924,666,531,135,24,6,https://www.intensivregister.de/api/public/reporting/laendertabelle
1662793525,666,531,135,23,6,https://www.intensivregister.de/api/public/reporting/laendertabelle
1662797114,666,530,136,23,6,https://www.intensivregister.de/api/public/reporting/laendertabelle
1662843915,666,526,140,23,6,https://www.intensivregister.de/api/public/reporting/laendertabelle
1662865524,659,518,141,23,6,https://www.intensivregister.de/api/public/reporting/laendertabelle
1662869124,659,509,150,23,5,https://www.intensivregister.de/api/public/reporting/laendertabelle
1662872715,659,505,154,25,5,https://www.intensivregister.de/api/public/reporting/laendertabelle
1662876314,659,499,160,25,6,https://www.intensivregister.de/api/public/reporting/laendertabelle
1662879915,659,497,162,25,6,https://www.intensivregister.de/api/public/reporting/laendertabelle
1662883515,657,495,162,24,6,https://www.intensivregister.de/api/public/reporting/laendertabelle
1662948315,657,496,161,24,6,https://www.intensivregister.de/api/public/reporting/laendertabelle
1662951914,663,492,171,21,6,https://www.intensivregister.de/api/public/reporting/laendertabelle
1662955515,664,498,166,22,6,https://www.intensivregister.de/api/public/reporting/laendertabelle
1662959114,664,496,168,22,6,https://www.intensivregister.de/api/public/reporting/laendertabelle
1662962715,664,493,171,23,6,https://www.intensivregister.de/api/public/reporting/laendertabelle
1662966314,664,500,164,23,6,https://www.intensivregister.de/api/public/reporting/laendertabelle
1663016714,664,501,163,23,6,https://www.intensivregister.de/api/public/reporting/laendertabelle
1663031124,664,504,160,23,6,https://www.intensivregister.de/api/public/reporting/laendertabelle
1663034714,664,505,159,23,6,https://www.intensivregister.de/api/public/reporting/laendertabelle
1663038315,676,533,143,22,7,https://www.intensivregister.de/api/public/reporting/laendertabelle
1663041914,676,533,143,25,8,https://www.intensivregister.de/api/public/reporting/laendertabelle
1663045524,676,533,143,26,8,https://www.intensivregister.de/api/public/reporting/laendertabelle
1663049115,676,534,142,26,8,https://www.intensivregister.de/api/public/reporting/laendertabelle
1663052714,676,538,138,26,8,https://www.intensivregister.de/api/public/reporting/laendertabelle
1663103114,676,539,137,26,8,https://www.intensivregister.de/api/public/reporting/laendertabelle
1663113915,676,540,136,26,8,https://www.intensivregister.de/api/public/reporting/laendertabelle
1663121114,676,538,138,26,8,https://www.intensivregister.de/api/public/reporting/laendertabelle
1663124724,678,543,135,27,8,https://www.intensivregister.de/api/public/reporting/laendertabelle
1663128315,680,545,135,27,8,https://www.intensivregister.de/api/public/reporting/laendertabelle
1663131914,680,550,130,25,8,https://www.intensivregister.de/api/public/reporting/laendertabelle
1663135514,682,554,128,24,8,https://www.intensivregister.de/api/public/reporting/laendertabelle
1663139114,692,552,140,24,8,https://www.intensivregister.de/api/public/reporting/laendertabelle
1663189515,691,545,146,24,8,https://www.intensivregister.de/api/public/reporting/laendertabelle
1663207514,691,547,144,25,9,https://www.intensivregister.de/api/public/reporting/laendertabelle
1663211115,693,553,140,24,9,https://www.intensivregister.de/api/public/reporting/laendertabelle
1663214715,693,551,142,23,9,https://www.intensivregister.de/api/public/reporting/laendertabelle
1663218316,693,546,147,25,9,https://www.intensivregister.de/api/public/reporting/laendertabelle
1663221915,693,544,149,25,9,https://www.intensivregister.de/api/public/reporting/laendertabelle
1663225524,693,546,147,25,9,https://www.intensivregister.de/api/public/reporting/laendertabelle
1663229124,693,549,144,25,9,https://www.intensivregister.de/api/public/reporting/laendertabelle
1663272315,694,549,145,25,9,https://www.intensivregister.de/api/public/reporting/laendertabelle
1663286724,694,544,150,25,9,https://www.intensivregister.de/api/public/reporting/laendertabelle
1663293914,691,542,149,25,9,https://www.intensivregister.de/api/public/reporting/laendertabelle
1663297514,691,548,143,25,9,https://www.intensivregister.de/api/public/reporting/laendertabelle
1663301114,691,547,144,25,10,https://www.intensivregister.de/api/public/reporting/laendertabelle
1663304715,691,542,149,22,9,https://www.intensivregister.de/api/public/reporting/laendertabelle
1663308315,689,541,148,23,10,https://www.intensivregister.de/api/public/reporting/laendertabelle
1663315525,689,538,151,23,10,https://www.intensivregister.de/api/public/reporting/laendertabelle
1663362316,689,539,150,23,10,https://www.intensivregister.de/api/public/reporting/laendertabelle
1663365914,689,540,149,23,10,https://www.intensivregister.de/api/public/reporting/laendertabelle
1663387514,685,526,159,23,10,https://www.intensivregister.de/api/public/reporting/laendertabelle
1663391117,682,523,159,21,7,https://www.intensivregister.de/api/public/reporting/laendertabelle
1663394716,682,520,162,22,8,https://www.intensivregister.de/api/public/reporting/laendertabelle
1663445115,682,519,163,22,8,https://www.intensivregister.de/api/public/reporting/laendertabelle
1663448725,682,518,164,22,8,https://www.intensivregister.de/api/public/reporting/laendertabelle
1663455925,682,517,165,22,8,https://www.intensivregister.de/api/public/reporting/laendertabelle
1663470316,682,515,167,22,8,https://www.intensivregister.de/api/public/reporting/laendertabelle
1663473915,679,504,175,22,8,https://www.intensivregister.de/api/public/reporting/laendertabelle
1663477514,676,507,169,19,8,https://www.intensivregister.de/api/public/reporting/laendertabelle
1663481114,676,509,167,19,8,https://www.intensivregister.de/api/public/reporting/laendertabelle
1663484724,673,509,164,18,8,https://www.intensivregister.de/api/public/reporting/laendertabelle
1663495524,672,507,165,18,8,https://www.intensivregister.de/api/public/reporting/laendertabelle
1663502714,672,506,166,18,8,https://www.intensivregister.de/api/public/reporting/laendertabelle
1663513514,672,508,164,18,8,https://www.intensivregister.de/api/public/reporting/laendertabelle
1663535114,672,506,166,18,8,https://www.intensivregister.de/api/public/reporting/laendertabelle
1663542314,672,507,165,18,8,https://www.intensivregister.de/api/public/reporting/laendertabelle
1663556725,675,498,177,20,8,https://www.intensivregister.de/api/public/reporting/laendertabelle
1663560326,675,493,182,23,8,https://www.intensivregister.de/api/public/reporting/laendertabelle
1663563916,675,492,183,23,8,https://www.intensivregister.de/api/public/reporting/laendertabelle
1663567516,677,501,176,25,9,https://www.intensivregister.de/api/public/reporting/laendertabelle
1663571114,677,507,170,25,9,https://www.intensivregister.de/api/public/reporting/laendertabelle
1663617914,677,504,173,25,9,https://www.intensivregister.de/api/public/reporting/laendertabelle
1663635926,677,502,175,25,9,https://www.intensivregister.de/api/public/reporting/laendertabelle
1663643115,678,504,174,25,9,https://www.intensivregister.de/api/public/reporting/laendertabelle
1663646716,678,515,163,26,10,https://www.intensivregister.de/api/public/reporting/laendertabelle
1663650315,678,518,160,25,10,https://www.intensivregister.de/api/public/reporting/laendertabelle
1663653915,677,515,162,25,11,https://www.intensivregister.de/api/public/reporting/laendertabelle
1663657524,677,518,159,25,11,https://www.intensivregister.de/api/public/reporting/laendertabelle
1663661114,678,521,157,26,11,https://www.intensivregister.de/api/public/reporting/laendertabelle
1663704315,678,523,155,26,11,https://www.intensivregister.de/api/public/reporting/laendertabelle
1663707915,678,526,152,26,11,https://www.intensivregister.de/api/public/reporting/laendertabelle
1663729515,678,517,161,23,9,https://www.intensivregister.de/api/public/reporting/laendertabelle
1663733116,678,517,161,24,9,https://www.intensivregister.de/api/public/reporting/laendertabelle
1663736725,678,514,164,24,9,https://www.intensivregister.de/api/public/reporting/laendertabelle
1663740314,680,516,164,24,9,https://www.intensivregister.de/api/public/reporting/laendertabelle
1663747525,683,515,168,24,9,https://www.intensivregister.de/api/public/reporting/laendertabelle
1663812324,683,516,167,24,9,https://www.intensivregister.de/api/public/reporting/laendertabelle
1663815915,684,517,167,21,6,https://www.intensivregister.de/api/public/reporting/laendertabelle
1663819514,684,521,163,23,6,https://www.intensivregister.de/api/public/reporting/laendertabelle
1663823115,682,524,158,22,6,https://www.intensivregister.de/api/public/reporting/laendertabelle
1663826715,683,526,157,23,6,https://www.intensivregister.de/api/public/reporting/laendertabelle
1663830324,683,527,156,23,7,https://www.intensivregister.de/api/public/reporting/laendertabelle
1663833924,683,512,171,20,6,https://www.intensivregister.de/api/public/reporting/laendertabelle
1663877115,683,513,170,20,6,https://www.intensivregister.de/api/public/reporting/laendertabelle
1663880717,683,511,172,20,6,https://www.intensivregister.de/api/public/reporting/laendertabelle
1663884315,683,510,173,20,6,https://www.intensivregister.de/api/public/reporting/laendertabelle
1663898714,683,511,172,20,6,https://www.intensivregister.de/api/public/reporting/laendertabelle
1663902314,687,521,166,20,6,https://www.intensivregister.de/api/public/reporting/laendertabelle
1663905916,685,524,161,19,6,https://www.intensivregister.de/api/public/reporting/laendertabelle
1663909515,684,524,160,20,6,https://www.intensivregister.de/api/public/reporting/laendertabelle
1663913115,684,536,148,20,6,https://www.intensivregister.de/api/public/reporting/laendertabelle
1663967114,684,537,147,21,6,https://www.intensivregister.de/api/public/reporting/laendertabelle
1663974315,684,538,146,21,6,https://www.intensivregister.de/api/public/reporting/laendertabelle
1663985114,684,536,148,21,7,https://www.intensivregister.de/api/public/reporting/laendertabelle
1663988715,684,537,147,20,7,https://www.intensivregister.de/api/public/reporting/laendertabelle
1663992315,684,530,154,21,6,https://www.intensivregister.de/api/public/reporting/laendertabelle
1663995924,684,532,152,20,6,https://www.intensivregister.de/api/public/reporting/laendertabelle
1663999514,684,532,152,21,6,https://www.intensivregister.de/api/public/reporting/laendertabelle
1664003114,683,533,150,20,6,https://www.intensivregister.de/api/public/reporting/laendertabelle
1664006724,683,532,151,20,6,https://www.intensivregister.de/api/public/reporting/laendertabelle
1664039115,683,533,150,20,6,https://www.intensivregister.de/api/public/reporting/laendertabelle
1664049914,683,531,152,20,6,https://www.intensivregister.de/api/public/reporting/laendertabelle
1664075118,683,526,157,20,6,https://www.intensivregister.de/api/public/reporting/laendertabelle
1664078714,683,518,165,18,4,https://www.intensivregister.de/api/public/reporting/laendertabelle
1664082314,683,514,169,18,4,https://www.intensivregister.de/api/public/reporting/laendertabelle
1664085914,681,506,175,19,5,https://www.intensivregister.de/api/public/reporting/laendertabelle
1664089515,681,512,169,19,5,https://www.intensivregister.de/api/public/reporting/laendertabelle
1664093124,675,504,171,20,5,https://www.intensivregister.de/api/public/reporting/laendertabelle
1664139914,675,503,172,21,5,https://www.intensivregister.de/api/public/reporting/laendertabelle
1664147115,675,504,171,21,5,https://www.intensivregister.de/api/public/reporting/laendertabelle
1664154324,675,504,171,22,5,https://www.intensivregister.de/api/public/reporting/laendertabelle
1664157914,675,502,173,22,5,https://www.intensivregister.de/api/public/reporting/laendertabelle
1664161524,677,495,182,21,3,https://www.intensivregister.de/api/public/reporting/laendertabelle
1664165115,675,494,181,21,3,https://www.intensivregister.de/api/public/reporting/laendertabelle
1664168715,677,492,185,21,4,https://www.intensivregister.de/api/public/reporting/laendertabelle
1664172315,677,493,184,21,4,https://www.intensivregister.de/api/public/reporting/laendertabelle
1664179514,675,500,175,21,4,https://www.intensivregister.de/api/public/reporting/laendertabelle
1664233515,675,505,170,21,4,https://www.intensivregister.de/api/public/reporting/laendertabelle
1664244314,675,504,171,21,5,https://www.intensivregister.de/api/public/reporting/laendertabelle
1664247915,674,536,138,23,5,https://www.intensivregister.de/api/public/reporting/laendertabelle
1664251515,674,540,134,24,6,https://www.intensivregister.de/api/public/reporting/laendertabelle
1664255115,674,541,133,26,6,https://www.intensivregister.de/api/public/reporting/laendertabelle
1664258716,674,540,134,26,6,https://www.intensivregister.de/api/public/reporting/laendertabelle
1664262317,683,542,141,26,6,https://www.intensivregister.de/api/public/reporting/laendertabelle
1664265915,683,544,139,26,6,https://www.intensivregister.de/api/public/reporting/laendertabelle
1664312714,683,546,137,26,6,https://www.intensivregister.de/api/public/reporting/laendertabelle
1664330714,683,548,135,26,6,https://www.intensivregister.de/api/public/reporting/laendertabelle
1664334315,683,540,143,28,7,https://www.intensivregister.de/api/public/reporting/laendertabelle
1664337914,682,535,147,29,8,https://www.intensivregister.de/api/public/reporting/laendertabelle
1664341514,684,536,148,27,7,https://www.intensivregister.de/api/public/reporting/laendertabelle
1664345116,684,539,145,27,7,https://www.intensivregister.de/api/public/reporting/laendertabelle
1664348715,684,540,144,25,7,https://www.intensivregister.de/api/public/reporting/laendertabelle
1664352316,684,538,146,24,7,https://www.intensivregister.de/api/public/reporting/laendertabelle
1664399124,684,537,147,25,6,https://www.intensivregister.de/api/public/reporting/laendertabelle
1664417114,684,535,149,24,6,https://www.intensivregister.de/api/public/reporting/laendertabelle
1664420715,684,531,153,22,6,https://www.intensivregister.de/api/public/reporting/laendertabelle
1664424314,684,528,156,22,6,https://www.intensivregister.de/api/public/reporting/laendertabelle
1664427914,684,529,155,22,6,https://www.intensivregister.de/api/public/reporting/laendertabelle
1664435116,684,528,156,23,6,https://www.intensivregister.de/api/public/reporting/laendertabelle
1664438714,684,530,154,23,6,https://www.intensivregister.de/api/public/reporting/laendertabelle
1664442314,685,532,153,23,7,https://www.intensivregister.de/api/public/reporting/laendertabelle
1664503524,685,533,152,22,6,https://www.intensivregister.de/api/public/reporting/laendertabelle
1664507124,685,539,146,21,6,https://www.intensivregister.de/api/public/reporting/laendertabelle
1664510715,686,539,147,19,6,https://www.intensivregister.de/api/public/reporting/laendertabelle
1664514316,684,542,142,18,6,https://www.intensivregister.de/api/public/reporting/laendertabelle
1664521514,682,536,146,19,6,https://www.intensivregister.de/api/public/reporting/laendertabelle
1664525124,682,535,147,19,6,https://www.intensivregister.de/api/public/reporting/laendertabelle
1664593524,682,530,152,20,6,https://www.intensivregister.de/api/public/reporting/laendertabelle
1664597114,682,530,152,25,7,https://www.intensivregister.de/api/public/reporting/laendertabelle
1664600714,681,539,142,25,7,https://www.intensivregister.de/api/public/reporting/laendertabelle
1664607914,681,536,145,25,7,https://www.intensivregister.de/api/public/reporting/laendertabelle
1664611515,673,532,141,25,7,https://www.intensivregister.de/api/public/reporting/laendertabelle
1664669114,673,529,144,24,6,https://www.intensivregister.de/api/public/reporting/laendertabelle
1664679925,673,526,147,23,6,https://www.intensivregister.de/api/public/reporting/laendertabelle
1664683514,672,525,147,23,7,https://www.intensivregister.de/api/public/reporting/laendertabelle
1664687117,671,515,156,22,7,https://www.intensivregister.de/api/public/reporting/laendertabelle
1664690714,671,514,157,22,7,https://www.intensivregister.de/api/public/reporting/laendertabelle
1664697914,671,513,158,22,7,https://www.intensivregister.de/api/public/reporting/laendertabelle
1664744714,670,511,159,22,7,https://www.intensivregister.de/api/public/reporting/laendertabelle
1664759124,670,513,157,23,7,https://www.intensivregister.de/api/public/reporting/laendertabelle
1664766314,670,513,157,25,7,https://www.intensivregister.de/api/public/reporting/laendertabelle
1664769914,670,512,158,24,7,https://www.intensivregister.de/api/public/reporting/laendertabelle
1664773514,674,514,160,27,7,https://www.intensivregister.de/api/public/reporting/laendertabelle
1664777116,669,516,153,29,7,https://www.intensivregister.de/api/public/reporting/laendertabelle
1664780715,671,518,153,30,7,https://www.intensivregister.de/api/public/reporting/laendertabelle
1664784316,671,519,152,30,7,https://www.intensivregister.de/api/public/reporting/laendertabelle
1664841914,671,521,150,30,7,https://www.intensivregister.de/api/public/reporting/laendertabelle
1664849115,671,522,149,30,7,https://www.intensivregister.de/api/public/reporting/laendertabelle
1664852726,674,524,150,34,7,https://www.intensivregister.de/api/public/reporting/laendertabelle
1664856315,672,523,149,32,7,https://www.intensivregister.de/api/public/reporting/laendertabelle
1664859915,672,526,146,35,7,https://www.intensivregister.de/api/public/reporting/laendertabelle
1664863514,672,517,155,37,8,https://www.intensivregister.de/api/public/reporting/laendertabelle
1664867115,672,514,158,37,8,https://www.intensivregister.de/api/public/reporting/laendertabelle
1664917514,674,516,158,36,8,https://www.intensivregister.de/api/public/reporting/laendertabelle
1664921115,674,522,152,36,8,https://www.intensivregister.de/api/public/reporting/laendertabelle
1664931924,674,524,150,36,8,https://www.intensivregister.de/api/public/reporting/laendertabelle
1664935524,674,525,149,36,8,https://www.intensivregister.de/api/public/reporting/laendertabelle
1664939124,676,523,153,34,8,https://www.intensivregister.de/api/public/reporting/laendertabelle
1664942714,678,527,151,37,8,https://www.intensivregister.de/api/public/reporting/laendertabelle
1664946316,678,534,144,38,8,https://www.intensivregister.de/api/public/reporting/laendertabelle
1664949915,676,536,140,39,8,https://www.intensivregister.de/api/public/reporting/laendertabelle
1664953515,674,538,136,39,9,https://www.intensivregister.de/api/public/reporting/laendertabelle
1664957115,674,540,134,39,10,https://www.intensivregister.de/api/public/reporting/laendertabelle
1665007514,674,539,135,40,10,https://www.intensivregister.de/api/public/reporting/laendertabelle
1665014715,674,538,136,40,10,https://www.intensivregister.de/api/public/reporting/laendertabelle
1665021925,677,541,136,41,10,https://www.intensivregister.de/api/public/reporting/laendertabelle
1665025514,678,542,136,44,11,https://www.intensivregister.de/api/public/reporting/laendertabelle
1665029115,678,545,133,43,11,https://www.intensivregister.de/api/public/reporting/laendertabelle
1665032714,678,546,132,45,11,https://www.intensivregister.de/api/public/reporting/laendertabelle
1665036315,682,554,128,46,11,https://www.intensivregister.de/api/public/reporting/laendertabelle
1665090314,682,554,128,45,11,https://www.intensivregister.de/api/public/reporting/laendertabelle
1665097515,682,553,129,45,11,https://www.intensivregister.de/api/public/reporting/laendertabelle
1665108314,682,554,128,45,11,https://www.intensivregister.de/api/public/reporting/laendertabelle
1665111915,684,555,129,41,11,https://www.intensivregister.de/api/public/reporting/laendertabelle
1665115515,683,552,131,40,11,https://www.intensivregister.de/api/public/reporting/laendertabelle
1665119115,681,553,128,38,11,https://www.intensivregister.de/api/public/reporting/laendertabelle
1665122715,681,556,125,38,11,https://www.intensivregister.de/api/public/reporting/laendertabelle
1665140725,681,564,117,38,11,https://www.intensivregister.de/api/public/reporting/laendertabelle
1665180314,681,565,116,38,11,https://www.intensivregister.de/api/public/reporting/laendertabelle
1665198314,678,565,113,38,11,https://www.intensivregister.de/api/public/reporting/laendertabelle
1665201915,674,561,113,42,11,https://www.intensivregister.de/api/public/reporting/laendertabelle
1665205515,674,560,114,40,10,https://www.intensivregister.de/api/public/reporting/laendertabelle
1665209124,674,557,117,40,11,https://www.intensivregister.de/api/public/reporting/laendertabelle
1665212725,674,551,123,40,11,https://www.intensivregister.de/api/public/reporting/laendertabelle
1665216324,674,551,123,41,11,https://www.intensivregister.de/api/public/reporting/laendertabelle
1665263114,673,544,129,40,10,https://www.intensivregister.de/api/public/reporting/laendertabelle
1665288324,673,539,134,41,10,https://www.intensivregister.de/api/public/reporting/laendertabelle
1665291915,672,540,132,41,10,https://www.intensivregister.de/api/public/reporting/laendertabelle
1665295515,666,538,128,43,10,https://www.intensivregister.de/api/public/reporting/laendertabelle
1665299114,665,533,132,44,10,https://www.intensivregister.de/api/public/reporting/laendertabelle
1665306315,665,532,133,44,10,https://www.intensivregister.de/api/public/reporting/laendertabelle
1665349515,665,533,132,44,10,https://www.intensivregister.de/api/public/reporting/laendertabelle
1665353124,665,532,133,44,10,https://www.intensivregister.de/api/public/reporting/laendertabelle
1665367515,665,531,134,44,10,https://www.intensivregister.de/api/public/reporting/laendertabelle
1665371115,666,532,134,50,11,https://www.intensivregister.de/api/public/reporting/laendertabelle
1665374715,666,531,135,51,11,https://www.intensivregister.de/api/public/reporting/laendertabelle
1665378325,669,532,137,51,11,https://www.intensivregister.de/api/public/reporting/laendertabelle
1665381915,669,533,136,52,11,https://www.intensivregister.de/api/public/reporting/laendertabelle
1665389116,669,534,135,52,11,https://www.intensivregister.de/api/public/reporting/laendertabelle
1665410715,669,536,133,53,12,https://www.intensivregister.de/api/public/reporting/laendertabelle
1665435915,669,535,134,53,12,https://www.intensivregister.de/api/public/reporting/laendertabelle
1665453914,669,536,133,55,12,https://www.intensivregister.de/api/public/reporting/laendertabelle
1665457525,662,546,116,55,11,https://www.intensivregister.de/api/public/reporting/laendertabelle
1665461114,668,555,113,54,11,https://www.intensivregister.de/api/public/reporting/laendertabelle
1665464726,670,555,115,53,11,https://www.intensivregister.de/api/public/reporting/laendertabelle
1665468315,670,552,118,53,11,https://www.intensivregister.de/api/public/reporting/laendertabelle
1665475515,670,547,123,53,11,https://www.intensivregister.de/api/public/reporting/laendertabelle
1665522325,670,546,124,53,11,https://www.intensivregister.de/api/public/reporting/laendertabelle
1665540315,670,545,125,52,10,https://www.intensivregister.de/api/public/reporting/laendertabelle
1665543925,670,543,127,52,10,https://www.intensivregister.de/api/public/reporting/laendertabelle
1665547515,672,545,127,51,11,https://www.intensivregister.de/api/public/reporting/laendertabelle
1665551124,672,550,122,51,11,https://www.intensivregister.de/api/public/reporting/laendertabelle
1665554734,672,560,112,51,12,https://www.intensivregister.de/api/public/reporting/laendertabelle
1665561915,672,561,111,50,12,https://www.intensivregister.de/api/public/reporting/laendertabelle
1665572715,672,562,110,50,12,https://www.intensivregister.de/api/public/reporting/laendertabelle
1665608715,672,561,111,50,12,https://www.intensivregister.de/api/public/reporting/laendertabelle
1665626717,671,564,107,51,12,https://www.intensivregister.de/api/public/reporting/laendertabelle
1665630314,671,558,113,54,14,https://www.intensivregister.de/api/public/reporting/laendertabelle
1665633925,670,558,112,53,13,https://www.intensivregister.de/api/public/reporting/laendertabelle
1665637515,670,559,111,53,13,https://www.intensivregister.de/api/public/reporting/laendertabelle
1665641116,670,558,112,52,12,https://www.intensivregister.de/api/public/reporting/laendertabelle
1665644715,670,563,107,54,12,https://www.intensivregister.de/api/public/reporting/laendertabelle
1665648315,671,564,107,56,12,https://www.intensivregister.de/api/public/reporting/laendertabelle
1665695114,671,566,105,56,12,https://www.intensivregister.de/api/public/reporting/laendertabelle
1665713125,671,567,104,56,12,https://www.intensivregister.de/api/public/reporting/laendertabelle
1665716715,666,567,99,57,12,https://www.intensivregister.de/api/public/reporting/laendertabelle
1665720317,665,564,101,57,12,https://www.intensivregister.de/api/public/reporting/laendertabelle
1665723915,665,562,103,58,12,https://www.intensivregister.de/api/public/reporting/laendertabelle
1665727515,665,563,102,58,12,https://www.intensivregister.de/api/public/reporting/laendertabelle
1665731125,666,566,100,59,13,https://www.intensivregister.de/api/public/reporting/laendertabelle
1665734716,665,562,103,56,13,https://www.intensivregister.de/api/public/reporting/laendertabelle
1665752715,664,561,103,56,13,https://www.intensivregister.de/api/public/reporting/laendertabelle
1665795925,664,563,101,58,14,https://www.intensivregister.de/api/public/reporting/laendertabelle
1665803125,664,560,104,60,14,https://www.intensivregister.de/api/public/reporting/laendertabelle
1665806725,663,550,113,57,13,https://www.intensivregister.de/api/public/reporting/laendertabelle
1665810315,666,538,128,57,13,https://www.intensivregister.de/api/public/reporting/laendertabelle
1665813915,666,532,134,56,12,https://www.intensivregister.de/api/public/reporting/laendertabelle
1665821124,664,529,135,56,12,https://www.intensivregister.de/api/public/reporting/laendertabelle
1665835515,655,522,133,56,12,https://www.intensivregister.de/api/public/reporting/laendertabelle
1665846315,655,522,133,57,12,https://www.intensivregister.de/api/public/reporting/laendertabelle
1665867915,654,521,133,57,12,https://www.intensivregister.de/api/public/reporting/laendertabelle
1665889525,654,518,136,57,12,https://www.intensivregister.de/api/public/reporting/laendertabelle
1665893115,653,508,145,56,13,https://www.intensivregister.de/api/public/reporting/laendertabelle
1665896715,651,512,139,57,13,https://www.intensivregister.de/api/public/reporting/laendertabelle
1665900325,651,507,144,57,13,https://www.intensivregister.de/api/public/reporting/laendertabelle
1665903914,651,511,140,57,13,https://www.intensivregister.de/api/public/reporting/laendertabelle
1665954315,651,512,139,57,13,https://www.intensivregister.de/api/public/reporting/laendertabelle
1665972315,651,513,138,58,13,https://www.intensivregister.de/api/public/reporting/laendertabelle
1665975915,650,510,140,58,13,https://www.intensivregister.de/api/public/reporting/laendertabelle
1665979525,645,504,141,59,14,https://www.intensivregister.de/api/public/reporting/laendertabelle
1665983115,645,504,141,56,14,https://www.intensivregister.de/api/public/reporting/laendertabelle
1665993925,655,511,144,56,16,https://www.intensivregister.de/api/public/reporting/laendertabelle
1666001125,655,509,146,55,16,https://www.intensivregister.de/api/public/reporting/laendertabelle
1666040716,656,506,150,54,16,https://www.intensivregister.de/api/public/reporting/laendertabelle
1666058715,656,507,149,54,16,https://www.intensivregister.de/api/public/reporting/laendertabelle
1666062315,664,504,160,55,15,https://www.intensivregister.de/api/public/reporting/laendertabelle
1666065915,663,514,149,57,12,https://www.intensivregister.de/api/public/reporting/laendertabelle
1666069525,667,522,145,58,12,https://www.intensivregister.de/api/public/reporting/laendertabelle
1666076715,666,520,146,58,11,https://www.intensivregister.de/api/public/reporting/laendertabelle
1666080325,667,522,145,60,11,https://www.intensivregister.de/api/public/reporting/laendertabelle
1666127115,667,522,145,61,11,https://www.intensivregister.de/api/public/reporting/laendertabelle
1666145114,664,519,145,60,11,https://www.intensivregister.de/api/public/reporting/laendertabelle
1666148715,663,549,114,65,12,https://www.intensivregister.de/api/public/reporting/laendertabelle
1666152315,663,544,119,63,12,https://www.intensivregister.de/api/public/reporting/laendertabelle
1666155916,663,540,123,60,12,https://www.intensivregister.de/api/public/reporting/laendertabelle
1666159515,664,540,124,59,10,https://www.intensivregister.de/api/public/reporting/laendertabelle
1666163115,664,539,125,60,10,https://www.intensivregister.de/api/public/reporting/laendertabelle
1666209924,663,538,125,60,10,https://www.intensivregister.de/api/public/reporting/laendertabelle
1666213515,664,538,126,60,10,https://www.intensivregister.de/api/public/reporting/laendertabelle
1666217114,664,540,124,60,11,https://www.intensivregister.de/api/public/reporting/laendertabelle
1666220715,662,535,127,60,11,https://www.intensivregister.de/api/public/reporting/laendertabelle
1666231515,664,537,127,60,11,https://www.intensivregister.de/api/public/reporting/laendertabelle
1666235114,663,537,126,61,12,https://www.intensivregister.de/api/public/reporting/laendertabelle
1666238724,660,535,125,61,13,https://www.intensivregister.de/api/public/reporting/laendertabelle
1666242325,662,534,128,60,13,https://www.intensivregister.de/api/public/reporting/laendertabelle
1666245915,662,530,132,60,13,https://www.intensivregister.de/api/public/reporting/laendertabelle
1666249514,660,529,131,60,14,https://www.intensivregister.de/api/public/reporting/laendertabelle
1666256724,660,527,133,60,14,https://www.intensivregister.de/api/public/reporting/laendertabelle
1666299915,662,528,134,60,15,https://www.intensivregister.de/api/public/reporting/laendertabelle
1666307115,663,529,134,60,15,https://www.intensivregister.de/api/public/reporting/laendertabelle
1666317915,663,528,135,60,15,https://www.intensivregister.de/api/public/reporting/laendertabelle
1666321515,663,530,133,59,15,https://www.intensivregister.de/api/public/reporting/laendertabelle
1666325125,663,535,128,59,15,https://www.intensivregister.de/api/public/reporting/laendertabelle
1666328715,665,539,126,58,15,https://www.intensivregister.de/api/public/reporting/laendertabelle
1666332315,663,539,124,55,15,https://www.intensivregister.de/api/public/reporting/laendertabelle
1666335915,661,532,129,55,16,https://www.intensivregister.de/api/public/reporting/laendertabelle
1666339516,661,533,128,57,15,https://www.intensivregister.de/api/public/reporting/laendertabelle
1666389915,661,532,129,57,15,https://www.intensivregister.de/api/public/reporting/laendertabelle
1666407924,661,528,133,57,15,https://www.intensivregister.de/api/public/reporting/laendertabelle
1666411515,659,526,133,56,15,https://www.intensivregister.de/api/public/reporting/laendertabelle
1666415114,658,523,135,53,16,https://www.intensivregister.de/api/public/reporting/laendertabelle
1666418715,658,520,138,52,15,https://www.intensivregister.de/api/public/reporting/laendertabelle
1666429514,658,524,134,53,14,https://www.intensivregister.de/api/public/reporting/laendertabelle
1666472715,659,526,133,53,14,https://www.intensivregister.de/api/public/reporting/laendertabelle
1666494315,658,524,134,53,14,https://www.intensivregister.de/api/public/reporting/laendertabelle
1666497915,655,520,135,54,14,https://www.intensivregister.de/api/public/reporting/laendertabelle
1666501515,656,521,135,56,14,https://www.intensivregister.de/api/public/reporting/laendertabelle
1666505115,652,514,138,51,14,https://www.intensivregister.de/api/public/reporting/laendertabelle
1666508715,652,515,137,53,14,https://www.intensivregister.de/api/public/reporting/laendertabelle
1666512315,652,523,129,54,15,https://www.intensivregister.de/api/public/reporting/laendertabelle
1666573524,652,518,134,55,15,https://www.intensivregister.de/api/public/reporting/laendertabelle
1666580716,653,516,137,55,15,https://www.intensivregister.de/api/public/reporting/laendertabelle
1666584315,653,514,139,54,16,https://www.intensivregister.de/api/public/reporting/laendertabelle
1666587915,652,517,135,54,16,https://www.intensivregister.de/api/public/reporting/laendertabelle
1666591515,652,513,139,54,16,https://www.intensivregister.de/api/public/reporting/laendertabelle
1666595115,654,510,144,55,16,https://www.intensivregister.de/api/public/reporting/laendertabelle
1666598715,656,514,142,55,16,https://www.intensivregister.de/api/public/reporting/laendertabelle
1666605915,656,512,144,55,16,https://www.intensivregister.de/api/public/reporting/laendertabelle
1666645524,656,515,141,56,16,https://www.intensivregister.de/api/public/reporting/laendertabelle
1666649125,657,516,141,56,16,https://www.intensivregister.de/api/public/reporting/laendertabelle
1666659916,657,517,140,55,15,https://www.intensivregister.de/api/public/reporting/laendertabelle
1666663515,657,517,140,56,15,https://www.intensivregister.de/api/public/reporting/laendertabelle
1666667125,657,525,132,61,15,https://www.intensivregister.de/api/public/reporting/laendertabelle
1666670716,661,543,118,62,16,https://www.intensivregister.de/api/public/reporting/laendertabelle
1666674316,661,546,115,64,16,https://www.intensivregister.de/api/public/reporting/laendertabelle
1666677914,664,554,110,64,15,https://www.intensivregister.de/api/public/reporting/laendertabelle
1666681514,664,556,108,64,15,https://www.intensivregister.de/api/public/reporting/laendertabelle
1666685115,664,557,107,64,15,https://www.intensivregister.de/api/public/reporting/laendertabelle
1666703116,664,554,110,64,15,https://www.intensivregister.de/api/public/reporting/laendertabelle
1666724714,664,554,110,63,14,https://www.intensivregister.de/api/public/reporting/laendertabelle
1666731915,664,552,112,63,14,https://www.intensivregister.de/api/public/reporting/laendertabelle
1666735524,664,548,116,63,14,https://www.intensivregister.de/api/public/reporting/laendertabelle
1666749925,664,548,116,62,14,https://www.intensivregister.de/api/public/reporting/laendertabelle
1666753525,670,556,114,54,15,https://www.intensivregister.de/api/public/reporting/laendertabelle
1666757115,672,549,123,56,14,https://www.intensivregister.de/api/public/reporting/laendertabelle
1666760715,673,552,121,55,13,https://www.intensivregister.de/api/public/reporting/laendertabelle
1666764315,673,553,120,55,13,https://www.intensivregister.de/api/public/reporting/laendertabelle
1666767915,672,553,119,55,15,https://www.intensivregister.de/api/public/reporting/laendertabelle
1666771524,672,552,120,55,15,https://www.intensivregister.de/api/public/reporting/laendertabelle
1666778715,672,551,121,55,15,https://www.intensivregister.de/api/public/reporting/laendertabelle
1666825515,672,555,117,53,14,https://www.intensivregister.de/api/public/reporting/laendertabelle
1666836325,670,554,116,51,14,https://www.intensivregister.de/api/public/reporting/laendertabelle
1666839915,670,568,102,50,14,https://www.intensivregister.de/api/public/reporting/laendertabelle
1666843515,671,567,104,52,14,https://www.intensivregister.de/api/public/reporting/laendertabelle
1666847125,670,566,104,50,15,https://www.intensivregister.de/api/public/reporting/laendertabelle
1666854316,671,567,104,48,13,https://www.intensivregister.de/api/public/reporting/laendertabelle
1666857916,671,567,104,49,13,https://www.intensivregister.de/api/public/reporting/laendertabelle
1666865124,671,568,103,49,13,https://www.intensivregister.de/api/public/reporting/laendertabelle
1666904715,671,565,106,49,13,https://www.intensivregister.de/api/public/reporting/laendertabelle
1666911915,671,564,107,49,13,https://www.intensivregister.de/api/public/reporting/laendertabelle
1666929915,670,560,110,48,12,https://www.intensivregister.de/api/public/reporting/laendertabelle
1666933516,670,555,115,47,12,https://www.intensivregister.de/api/public/reporting/laendertabelle
1666937126,670,548,122,44,11,https://www.intensivregister.de/api/public/reporting/laendertabelle
1666940715,670,550,120,44,11,https://www.intensivregister.de/api/public/reporting/laendertabelle
1666944325,668,548,120,44,11,https://www.intensivregister.de/api/public/reporting/laendertabelle
1666947915,668,547,121,43,10,https://www.intensivregister.de/api/public/reporting/laendertabelle
1666991115,668,546,122,43,10,https://www.intensivregister.de/api/public/reporting/laendertabelle
1666994715,667,544,123,43,10,https://www.intensivregister.de/api/public/reporting/laendertabelle
1667012714,668,541,127,42,10,https://www.intensivregister.de/api/public/reporting/laendertabelle
1667016315,668,542,126,40,9,https://www.intensivregister.de/api/public/reporting/laendertabelle
1667019915,668,535,133,37,8,https://www.intensivregister.de/api/public/reporting/laendertabelle
1667023515,668,531,137,37,7,https://www.intensivregister.de/api/public/reporting/laendertabelle
1667027115,668,528,140,38,7,https://www.intensivregister.de/api/public/reporting/laendertabelle
1667030715,668,532,136,39,7,https://www.intensivregister.de/api/public/reporting/laendertabelle
1667081114,664,531,133,38,7,https://www.intensivregister.de/api/public/reporting/laendertabelle
1667106325,664,530,134,38,7,https://www.intensivregister.de/api/public/reporting/laendertabelle
1667109914,661,521,140,39,10,https://www.intensivregister.de/api/public/reporting/laendertabelle
1667113514,657,521,136,39,12,https://www.intensivregister.de/api/public/reporting/laendertabelle
1667117115,657,523,134,39,12,https://www.intensivregister.de/api/public/reporting/laendertabelle
1667120715,655,519,136,39,12,https://www.intensivregister.de/api/public/reporting/laendertabelle
1667167524,655,514,141,39,12,https://www.intensivregister.de/api/public/reporting/laendertabelle
1667171125,655,515,140,39,12,https://www.intensivregister.de/api/public/reporting/laendertabelle
1667192716,659,519,140,42,13,https://www.intensivregister.de/api/public/reporting/laendertabelle
1667196325,659,519,140,41,13,https://www.intensivregister.de/api/public/reporting/laendertabelle
1667199915,657,518,139,42,12,https://www.intensivregister.de/api/public/reporting/laendertabelle
1667203514,657,510,147,42,12,https://www.intensivregister.de/api/public/reporting/laendertabelle
1667207125,657,511,146,42,12,https://www.intensivregister.de/api/public/reporting/laendertabelle
1667210715,657,512,145,42,12,https://www.intensivregister.de/api/public/reporting/laendertabelle
1667257515,657,512,145,41,12,https://www.intensivregister.de/api/public/reporting/laendertabelle
1667275525,657,513,144,41,12,https://www.intensivregister.de/api/public/reporting/laendertabelle
1667279115,663,522,141,44,13,https://www.intensivregister.de/api/public/reporting/laendertabelle
1667282715,663,519,144,44,14,https://www.intensivregister.de/api/public/reporting/laendertabelle
1667286315,663,522,141,44,14,https://www.intensivregister.de/api/public/reporting/laendertabelle
1667289915,665,521,144,43,14,https://www.intensivregister.de/api/public/reporting/laendertabelle
1667293514,669,519,150,43,14,https://www.intensivregister.de/api/public/reporting/laendertabelle
1667297125,669,521,148,44,14,https://www.intensivregister.de/api/public/reporting/laendertabelle
1667354715,669,523,146,46,14,https://www.intensivregister.de/api/public/reporting/laendertabelle
1667361925,669,522,147,46,14,https://www.intensivregister.de/api/public/reporting/laendertabelle
1667365515,687,536,151,42,10,https://www.intensivregister.de/api/public/reporting/laendertabelle
1667369116,684,529,155,42,9,https://www.intensivregister.de/api/public/reporting/laendertabelle
1667372725,683,537,146,43,9,https://www.intensivregister.de/api/public/reporting/laendertabelle
1667376316,683,538,145,43,9,https://www.intensivregister.de/api/public/reporting/laendertabelle
1667383515,683,542,141,41,9,https://www.intensivregister.de/api/public/reporting/laendertabelle
1667426715,683,541,142,41,9,https://www.intensivregister.de/api/public/reporting/laendertabelle
1667430314,683,541,142,42,9,https://www.intensivregister.de/api/public/reporting/laendertabelle
1667451915,686,539,147,41,8,https://www.intensivregister.de/api/public/reporting/laendertabelle
1667455525,691,555,136,40,8,https://www.intensivregister.de/api/public/reporting/laendertabelle
1667459115,692,562,130,45,10,https://www.intensivregister.de/api/public/reporting/laendertabelle
1667462725,692,570,122,44,10,https://www.intensivregister.de/api/public/reporting/laendertabelle
1667469915,692,568,124,43,10,https://www.intensivregister.de/api/public/reporting/laendertabelle
1667495125,692,572,120,43,10,https://www.intensivregister.de/api/public/reporting/laendertabelle
1667534715,688,570,118,44,9,https://www.intensivregister.de/api/public/reporting/laendertabelle
1667538316,686,571,115,43,9,https://www.intensivregister.de/api/public/reporting/laendertabelle
1667541915,686,577,109,43,10,https://www.intensivregister.de/api/public/reporting/laendertabelle
1667545527,686,576,110,43,10,https://www.intensivregister.de/api/public/reporting/laendertabelle
1667549125,686,573,113,43,10,https://www.intensivregister.de/api/public/reporting/laendertabelle
1667552725,686,572,114,43,10,https://www.intensivregister.de/api/public/reporting/laendertabelle
1667556315,686,575,111,43,10,https://www.intensivregister.de/api/public/reporting/laendertabelle
1667563515,686,577,109,42,10,https://www.intensivregister.de/api/public/reporting/laendertabelle
1667603114,687,578,109,42,10,https://www.intensivregister.de/api/public/reporting/laendertabelle
1667606724,687,576,111,41,10,https://www.intensivregister.de/api/public/reporting/laendertabelle
1667624725,687,580,107,42,10,https://www.intensivregister.de/api/public/reporting/laendertabelle
1667628317,679,570,109,36,6,https://www.intensivregister.de/api/public/reporting/laendertabelle
1667631914,683,566,117,37,6,https://www.intensivregister.de/api/public/reporting/laendertabelle
1667635515,682,560,122,38,6,https://www.intensivregister.de/api/public/reporting/laendertabelle
1667639125,682,555,127,37,6,https://www.intensivregister.de/api/public/reporting/laendertabelle
1667653516,682,554,128,36,6,https://www.intensivregister.de/api/public/reporting/laendertabelle
1667693124,682,555,127,38,8,https://www.intensivregister.de/api/public/reporting/laendertabelle
1667700324,682,555,127,36,8,https://www.intensivregister.de/api/public/reporting/laendertabelle
1667711115,682,554,128,36,8,https://www.intensivregister.de/api/public/reporting/laendertabelle
1667714715,681,547,134,33,8,https://www.intensivregister.de/api/public/reporting/laendertabelle
1667718315,683,551,132,35,11,https://www.intensivregister.de/api/public/reporting/laendertabelle
1667721914,681,550,131,35,11,https://www.intensivregister.de/api/public/reporting/laendertabelle
1667725515,679,549,130,34,11,https://www.intensivregister.de/api/public/reporting/laendertabelle
1667729124,679,547,132,34,12,https://www.intensivregister.de/api/public/reporting/laendertabelle
1667775925,677,545,132,34,12,https://www.intensivregister.de/api/public/reporting/laendertabelle
1667783124,677,542,135,34,12,https://www.intensivregister.de/api/public/reporting/laendertabelle
1667786724,677,541,136,34,12,https://www.intensivregister.de/api/public/reporting/laendertabelle
1667797515,677,540,137,35,12,https://www.intensivregister.de/api/public/reporting/laendertabelle
1667801116,677,541,136,36,12,https://www.intensivregister.de/api/public/reporting/laendertabelle
1667804715,682,539,143,38,12,https://www.intensivregister.de/api/public/reporting/laendertabelle
1667822715,673,533,140,38,12,https://www.intensivregister.de/api/public/reporting/laendertabelle
1667865915,673,533,140,40,13,https://www.intensivregister.de/api/public/reporting/laendertabelle
1667880316,673,538,135,39,11,https://www.intensivregister.de/api/public/reporting/laendertabelle
1667883915,681,553,128,39,10,https://www.intensivregister.de/api/public/reporting/laendertabelle
1667887516,683,558,125,41,10,https://www.intensivregister.de/api/public/reporting/laendertabelle
1667891115,683,563,120,43,10,https://www.intensivregister.de/api/public/reporting/laendertabelle
1667894716,683,562,121,43,10,https://www.intensivregister.de/api/public/reporting/laendertabelle
1667898315,685,562,123,41,11,https://www.intensivregister.de/api/public/reporting/laendertabelle
1667901916,683,563,120,42,13,https://www.intensivregister.de/api/public/reporting/laendertabelle
1667945116,683,563,120,41,13,https://www.intensivregister.de/api/public/reporting/laendertabelle
1667959514,683,561,122,41,13,https://www.intensivregister.de/api/public/reporting/laendertabelle
1667966715,683,561,122,40,13,https://www.intensivregister.de/api/public/reporting/laendertabelle
1667970316,680,558,122,40,14,https://www.intensivregister.de/api/public/reporting/laendertabelle
1667973916,680,549,131,35,14,https://www.intensivregister.de/api/public/reporting/laendertabelle
1667977515,680,546,134,34,13,https://www.intensivregister.de/api/public/reporting/laendertabelle
1667981115,680,547,133,34,13,https://www.intensivregister.de/api/public/reporting/laendertabelle
1667988315,680,547,133,35,13,https://www.intensivregister.de/api/public/reporting/laendertabelle
1668042315,680,550,130,35,13,https://www.intensivregister.de/api/public/reporting/laendertabelle
1668053124,680,554,126,35,13,https://www.intensivregister.de/api/public/reporting/laendertabelle
1668056715,683,557,126,36,13,https://www.intensivregister.de/api/public/reporting/laendertabelle
1668060315,685,563,122,35,12,https://www.intensivregister.de/api/public/reporting/laendertabelle
1668063925,686,562,124,35,12,https://www.intensivregister.de/api/public/reporting/laendertabelle
1668067518,686,561,125,35,11,https://www.intensivregister.de/api/public/reporting/laendertabelle
1668071115,686,566,120,35,10,https://www.intensivregister.de/api/public/reporting/laendertabelle
1668125115,686,564,122,35,10,https://www.intensivregister.de/api/public/reporting/laendertabelle
1668139515,686,562,124,35,10,https://www.intensivregister.de/api/public/reporting/laendertabelle
1668143126,684,554,130,35,7,https://www.intensivregister.de/api/public/reporting/laendertabelle
1668146725,682,557,125,33,7,https://www.intensivregister.de/api/public/reporting/laendertabelle
1668150325,682,552,130,33,6,https://www.intensivregister.de/api/public/reporting/laendertabelle
1668153915,682,553,129,33,6,https://www.intensivregister.de/api/public/reporting/laendertabelle
1668157525,682,553,129,32,6,https://www.intensivregister.de/api/public/reporting/laendertabelle
1668207925,678,552,126,31,5,https://www.intensivregister.de/api/public/reporting/laendertabelle
1668222314,678,553,125,31,5,https://www.intensivregister.de/api/public/reporting/laendertabelle
1668229525,674,544,130,31,5,https://www.intensivregister.de/api/public/reporting/laendertabelle
1668233115,674,541,133,35,5,https://www.intensivregister.de/api/public/reporting/laendertabelle
1668236724,672,533,139,35,5,https://www.intensivregister.de/api/public/reporting/laendertabelle
1668240315,672,532,140,34,6,https://www.intensivregister.de/api/public/reporting/laendertabelle
1668243915,671,528,143,34,6,https://www.intensivregister.de/api/public/reporting/laendertabelle
1668251115,669,530,139,37,8,https://www.intensivregister.de/api/public/reporting/laendertabelle
1668308715,669,529,140,37,8,https://www.intensivregister.de/api/public/reporting/laendertabelle
1668315915,669,530,139,37,8,https://www.intensivregister.de/api/public/reporting/laendertabelle
1668319515,673,533,140,36,8,https://www.intensivregister.de/api/public/reporting/laendertabelle
1668323114,673,533,140,34,7,https://www.intensivregister.de/api/public/reporting/laendertabelle
1668326725,672,533,139,32,6,https://www.intensivregister.de/api/public/reporting/laendertabelle
1668333925,672,527,145,32,6,https://www.intensivregister.de/api/public/reporting/laendertabelle
1668344715,672,529,143,32,6,https://www.intensivregister.de/api/public/reporting/laendertabelle
1668377116,673,528,145,32,6,https://www.intensivregister.de/api/public/reporting/laendertabelle
1668380715,673,527,146,32,6,https://www.intensivregister.de/api/public/reporting/laendertabelle
1668398715,673,523,150,32,6,https://www.intensivregister.de/api/public/reporting/laendertabelle
1668402316,671,526,145,41,8,https://www.intensivregister.de/api/public/reporting/laendertabelle
1668405915,671,525,146,32,8,https://www.intensivregister.de/api/public/reporting/laendertabelle
1668409515,671,532,139,33,8,https://www.intensivregister.de/api/public/reporting/laendertabelle
1668413125,671,534,137,34,8,https://www.intensivregister.de/api/public/reporting/laendertabelle
1668416714,672,534,138,34,8,https://www.intensivregister.de/api/public/reporting/laendertabelle
1668423915,682,546,136,32,6,https://www.intensivregister.de/api/public/reporting/laendertabelle
1668467125,682,549,133,32,6,https://www.intensivregister.de/api/public/reporting/laendertabelle
1668470715,682,547,135,32,6,https://www.intensivregister.de/api/public/reporting/laendertabelle
1668485114,682,549,133,33,6,https://www.intensivregister.de/api/public/reporting/laendertabelle
1668488725,682,549,133,32,6,https://www.intensivregister.de/api/public/reporting/laendertabelle
1668492325,688,559,129,32,6,https://www.intensivregister.de/api/public/reporting/laendertabelle
1668495915,688,557,131,33,6,https://www.intensivregister.de/api/public/reporting/laendertabelle
1668499525,689,559,130,32,6,https://www.intensivregister.de/api/public/reporting/laendertabelle
1668503115,690,561,129,32,6,https://www.intensivregister.de/api/public/reporting/laendertabelle
1668553514,690,559,131,34,7,https://www.intensivregister.de/api/public/reporting/laendertabelle
1668571525,690,560,130,33,7,https://www.intensivregister.de/api/public/reporting/laendertabelle
1668575125,696,562,134,34,7,https://www.intensivregister.de/api/public/reporting/laendertabelle
1668578715,696,565,131,35,7,https://www.intensivregister.de/api/public/reporting/laendertabelle
1668582325,696,567,129,33,8,https://www.intensivregister.de/api/public/reporting/laendertabelle
1668585915,696,566,130,33,8,https://www.intensivregister.de/api/public/reporting/laendertabelle
1668589517,695,562,133,33,8,https://www.intensivregister.de/api/public/reporting/laendertabelle
1668618316,695,563,132,33,8,https://www.intensivregister.de/api/public/reporting/laendertabelle
1668643524,695,562,133,33,8,https://www.intensivregister.de/api/public/reporting/laendertabelle
1668657915,695,559,136,32,8,https://www.intensivregister.de/api/public/reporting/laendertabelle
1668661515,691,556,135,31,6,https://www.intensivregister.de/api/public/reporting/laendertabelle
1668665116,685,549,136,30,6,https://www.intensivregister.de/api/public/reporting/laendertabelle
1668668716,687,551,136,33,5,https://www.intensivregister.de/api/public/reporting/laendertabelle
1668672316,687,549,138,33,5,https://www.intensivregister.de/api/public/reporting/laendertabelle
1668675916,688,548,140,32,5,https://www.intensivregister.de/api/public/reporting/laendertabelle
1668679515,688,547,141,32,5,https://www.intensivregister.de/api/public/reporting/laendertabelle
1668726324,688,549,139,32,5,https://www.intensivregister.de/api/public/reporting/laendertabelle
1668747916,690,553,137,30,4,https://www.intensivregister.de/api/public/reporting/laendertabelle
1668751515,690,551,139,31,4,https://www.intensivregister.de/api/public/reporting/laendertabelle
1668755115,691,554,137,31,4,https://www.intensivregister.de/api/public/reporting/laendertabelle
1668758718,691,556,135,31,4,https://www.intensivregister.de/api/public/reporting/laendertabelle
1668762325,691,561,130,30,4,https://www.intensivregister.de/api/public/reporting/laendertabelle
1668809114,691,559,132,30,4,https://www.intensivregister.de/api/public/reporting/laendertabelle
1668812715,691,561,130,30,4,https://www.intensivregister.de/api/public/reporting/laendertabelle
1668816315,691,560,131,30,4,https://www.intensivregister.de/api/public/reporting/laendertabelle
1668834325,691,558,133,30,4,https://www.intensivregister.de/api/public/reporting/laendertabelle
1668837926,693,558,135,27,4,https://www.intensivregister.de/api/public/reporting/laendertabelle
1668841516,684,544,140,25,3,https://www.intensivregister.de/api/public/reporting/laendertabelle
1668845115,684,542,142,25,3,https://www.intensivregister.de/api/public/reporting/laendertabelle
1668852314,684,545,139,25,3,https://www.intensivregister.de/api/public/reporting/laendertabelle
1668855915,684,544,140,25,3,https://www.intensivregister.de/api/public/reporting/laendertabelle
1668924314,684,531,153,24,3,https://www.intensivregister.de/api/public/reporting/laendertabelle
1668927926,682,518,164,23,3,https://www.intensivregister.de/api/public/reporting/laendertabelle
1668931514,680,513,167,22,3,https://www.intensivregister.de/api/public/reporting/laendertabelle
1668935115,680,518,162,21,3,https://www.intensivregister.de/api/public/reporting/laendertabelle
1668985515,680,516,164,21,3,https://www.intensivregister.de/api/public/reporting/laendertabelle
1669003514,680,518,162,21,3,https://www.intensivregister.de/api/public/reporting/laendertabelle
1669007115,680,526,154,24,3,https://www.intensivregister.de/api/public/reporting/laendertabelle
1669010715,680,522,158,24,3,https://www.intensivregister.de/api/public/reporting/laendertabelle
1669014325,680,526,154,25,3,https://www.intensivregister.de/api/public/reporting/laendertabelle
1669017925,680,530,150,25,3,https://www.intensivregister.de/api/public/reporting/laendertabelle
1669021515,682,535,147,26,3,https://www.intensivregister.de/api/public/reporting/laendertabelle
1669028715,673,528,145,26,3,https://www.intensivregister.de/api/public/reporting/laendertabelle
1669068315,673,528,145,27,4,https://www.intensivregister.de/api/public/reporting/laendertabelle
1669071914,674,531,143,27,4,https://www.intensivregister.de/api/public/reporting/laendertabelle
1669089925,674,529,145,27,4,https://www.intensivregister.de/api/public/reporting/laendertabelle
1669093515,681,538,143,27,5,https://www.intensivregister.de/api/public/reporting/laendertabelle
1669097125,679,539,140,27,5,https://www.intensivregister.de/api/public/reporting/laendertabelle
1669100715,679,540,139,27,5,https://www.intensivregister.de/api/public/reporting/laendertabelle
1669104325,679,540,139,26,5,https://www.intensivregister.de/api/public/reporting/laendertabelle
1669107925,679,542,137,26,5,https://www.intensivregister.de/api/public/reporting/laendertabelle
1669111516,678,541,137,26,5,https://www.intensivregister.de/api/public/reporting/laendertabelle
1669115115,687,547,140,26,5,https://www.intensivregister.de/api/public/reporting/laendertabelle
1669129525,687,549,138,26,5,https://www.intensivregister.de/api/public/reporting/laendertabelle
1669158315,685,549,136,24,6,https://www.intensivregister.de/api/public/reporting/laendertabelle
1669176315,685,554,131,24,6,https://www.intensivregister.de/api/public/reporting/laendertabelle
1669179915,685,565,120,30,6,https://www.intensivregister.de/api/public/reporting/laendertabelle
1669183516,687,572,115,31,6,https://www.intensivregister.de/api/public/reporting/laendertabelle
1669187115,687,575,112,31,6,https://www.intensivregister.de/api/public/reporting/laendertabelle
1669190715,688,573,115,31,6,https://www.intensivregister.de/api/public/reporting/laendertabelle
1669194316,688,571,117,30,6,https://www.intensivregister.de/api/public/reporting/laendertabelle
1669244725,688,572,116,30,6,https://www.intensivregister.de/api/public/reporting/laendertabelle
1669262715,688,570,118,30,6,https://www.intensivregister.de/api/public/reporting/laendertabelle
1669266325,688,559,129,29,6,https://www.intensivregister.de/api/public/reporting/laendertabelle
1669269916,688,562,126,28,6,https://www.intensivregister.de/api/public/reporting/laendertabelle
1669273515,688,561,127,27,6,https://www.intensivregister.de/api/public/reporting/laendertabelle
1669277116,688,562,126,27,6,https://www.intensivregister.de/api/public/reporting/laendertabelle
1669287915,688,561,127,27,6,https://www.intensivregister.de/api/public/reporting/laendertabelle
1669331115,688,558,130,27,6,https://www.intensivregister.de/api/public/reporting/laendertabelle
1669349125,688,555,133,27,6,https://www.intensivregister.de/api/public/reporting/laendertabelle
1669352714,686,557,129,24,5,https://www.intensivregister.de/api/public/reporting/laendertabelle
1669356325,686,554,132,25,5,https://www.intensivregister.de/api/public/reporting/laendertabelle
1669359915,686,558,128,26,5,https://www.intensivregister.de/api/public/reporting/laendertabelle
1669363525,684,558,126,26,5,https://www.intensivregister.de/api/public/reporting/laendertabelle
1669417515,684,557,127,26,4,https://www.intensivregister.de/api/public/reporting/laendertabelle
1669435515,684,557,127,28,4,https://www.intensivregister.de/api/public/reporting/laendertabelle
1669439115,684,561,123,28,4,https://www.intensivregister.de/api/public/reporting/laendertabelle
1669442715,682,565,117,27,3,https://www.intensivregister.de/api/public/reporting/laendertabelle
1669446325,684,557,127,29,3,https://www.intensivregister.de/api/public/reporting/laendertabelle
1669449925,683,565,118,30,3,https://www.intensivregister.de/api/public/reporting/laendertabelle
1669453524,683,560,123,29,3,https://www.intensivregister.de/api/public/reporting/laendertabelle
1669503915,683,561,122,29,3,https://www.intensivregister.de/api/public/reporting/laendertabelle
1669507515,683,560,123,29,3,https://www.intensivregister.de/api/public/reporting/laendertabelle
1669525525,681,557,124,29,3,https://www.intensivregister.de/api/public/reporting/laendertabelle
1669529118,681,555,126,28,3,https://www.intensivregister.de/api/public/reporting/laendertabelle
1669532715,681,563,118,28,3,https://www.intensivregister.de/api/public/reporting/laendertabelle
1669536315,677,563,114,24,3,https://www.intensivregister.de/api/public/reporting/laendertabelle
1669539915,678,565,113,25,3,https://www.intensivregister.de/api/public/reporting/laendertabelle
1669590324,678,568,110,25,3,https://www.intensivregister.de/api/public/reporting/laendertabelle
1669601125,678,569,109,25,3,https://www.intensivregister.de/api/public/reporting/laendertabelle
1669608315,678,568,110,25,2,https://www.intensivregister.de/api/public/reporting/laendertabelle
1669611925,679,573,106,25,2,https://www.intensivregister.de/api/public/reporting/laendertabelle
1669615515,681,572,109,21,2,https://www.intensivregister.de/api/public/reporting/laendertabelle
1669619125,683,578,105,23,2,https://www.intensivregister.de/api/public/reporting/laendertabelle
1669622715,687,583,104,22,1,https://www.intensivregister.de/api/public/reporting/laendertabelle
1669626325,686,581,105,21,1,https://www.intensivregister.de/api/public/reporting/laendertabelle
1669694715,694,589,105,21,2,https://www.intensivregister.de/api/public/reporting/laendertabelle
1669698315,695,584,111,19,2,https://www.intensivregister.de/api/public/reporting/laendertabelle
1669701915,695,587,108,20,2,https://www.intensivregister.de/api/public/reporting/laendertabelle
1669705516,693,581,112,20,2,https://www.intensivregister.de/api/public/reporting/laendertabelle
1669709125,693,584,109,20,2,https://www.intensivregister.de/api/public/reporting/laendertabelle
1669712725,694,584,110,21,3,https://www.intensivregister.de/api/public/reporting/laendertabelle
1669716317,694,585,109,22,4,https://www.intensivregister.de/api/public/reporting/laendertabelle
1669770325,694,586,108,22,4,https://www.intensivregister.de/api/public/reporting/laendertabelle
1669784714,689,576,113,23,6,https://www.intensivregister.de/api/public/reporting/laendertabelle
1669788325,691,572,119,22,6,https://www.intensivregister.de/api/public/reporting/laendertabelle
1669791916,691,572,119,21,6,https://www.intensivregister.de/api/public/reporting/laendertabelle
1669795517,691,570,121,22,6,https://www.intensivregister.de/api/public/reporting/laendertabelle
1669799115,690,565,125,22,6,https://www.intensivregister.de/api/public/reporting/laendertabelle
1669813516,690,567,123,22,6,https://www.intensivregister.de/api/public/reporting/laendertabelle
1669849515,690,566,124,22,6,https://www.intensivregister.de/api/public/reporting/laendertabelle
1669867515,690,567,123,22,6,https://www.intensivregister.de/api/public/reporting/laendertabelle
1669871125,688,574,114,20,6,https://www.intensivregister.de/api/public/reporting/laendertabelle
1669874725,688,570,118,20,5,https://www.intensivregister.de/api/public/reporting/laendertabelle
1669878315,686,571,115,22,5,https://www.intensivregister.de/api/public/reporting/laendertabelle
1669881924,686,579,107,19,5,https://www.intensivregister.de/api/public/reporting/laendertabelle
1669935915,686,576,110,20,5,https://www.intensivregister.de/api/public/reporting/laendertabelle
1669943125,686,574,112,20,5,https://www.intensivregister.de/api/public/reporting/laendertabelle
1669953915,687,577,110,20,5,https://www.intensivregister.de/api/public/reporting/laendertabelle
1669961125,689,578,111,19,5,https://www.intensivregister.de/api/public/reporting/laendertabelle
1669964725,689,580,109,19,5,https://www.intensivregister.de/api/public/reporting/laendertabelle
1669968315,690,579,111,19,5,https://www.intensivregister.de/api/public/reporting/laendertabelle
1669975515,690,577,113,19,5,https://www.intensivregister.de/api/public/reporting/laendertabelle
1669986325,688,576,112,19,5,https://www.intensivregister.de/api/public/reporting/laendertabelle
1669997115,688,575,113,19,5,https://www.intensivregister.de/api/public/reporting/laendertabelle
1670022325,688,573,115,19,5,https://www.intensivregister.de/api/public/reporting/laendertabelle
1670029515,687,571,116,19,5,https://www.intensivregister.de/api/public/reporting/laendertabelle
1670033125,687,572,115,19,5,https://www.intensivregister.de/api/public/reporting/laendertabelle
1670043915,687,569,118,19,5,https://www.intensivregister.de/api/public/reporting/laendertabelle
1670047515,680,554,126,22,4,https://www.intensivregister.de/api/public/reporting/laendertabelle
1670051115,672,556,116,23,4,https://www.intensivregister.de/api/public/reporting/laendertabelle
1670054715,672,548,124,24,4,https://www.intensivregister.de/api/public/reporting/laendertabelle
1670058315,672,548,124,26,5,https://www.intensivregister.de/api/public/reporting/laendertabelle
1670061925,672,545,127,26,5,https://www.intensivregister.de/api/public/reporting/laendertabelle
1670087124,672,544,128,25,5,https://www.intensivregister.de/api/public/reporting/laendertabelle
1670119515,672,545,127,25,5,https://www.intensivregister.de/api/public/reporting/laendertabelle
1670126725,672,546,126,25,5,https://www.intensivregister.de/api/public/reporting/laendertabelle
1670130315,672,547,125,25,5,https://www.intensivregister.de/api/public/reporting/laendertabelle
1670133925,671,536,135,23,5,https://www.intensivregister.de/api/public/reporting/laendertabelle
1670137515,671,528,143,23,5,https://www.intensivregister.de/api/public/reporting/laendertabelle
1670141115,671,529,142,23,5,https://www.intensivregister.de/api/public/reporting/laendertabelle
1670144715,671,531,140,23,5,https://www.intensivregister.de/api/public/reporting/laendertabelle
1670148325,671,534,137,24,5,https://www.intensivregister.de/api/public/reporting/laendertabelle
1670195115,671,535,136,24,6,https://www.intensivregister.de/api/public/reporting/laendertabelle
1670198715,671,533,138,24,6,https://www.intensivregister.de/api/public/reporting/laendertabelle
1670213125,671,534,137,24,6,https://www.intensivregister.de/api/public/reporting/laendertabelle
1670216715,671,538,133,23,6,https://www.intensivregister.de/api/public/reporting/laendertabelle
1670223917,670,537,133,23,6,https://www.intensivregister.de/api/public/reporting/laendertabelle
1670227515,670,537,133,21,5,https://www.intensivregister.de/api/public/reporting/laendertabelle
1670241915,670,538,132,21,5,https://www.intensivregister.de/api/public/reporting/laendertabelle
1670281524,670,539,131,21,5,https://www.intensivregister.de/api/public/reporting/laendertabelle
1670303115,671,542,129,23,6,https://www.intensivregister.de/api/public/reporting/laendertabelle
1670306715,671,544,127,24,6,https://www.intensivregister.de/api/public/reporting/laendertabelle
1670310315,671,549,122,25,6,https://www.intensivregister.de/api/public/reporting/laendertabelle
1670317516,671,549,122,26,6,https://www.intensivregister.de/api/public/reporting/laendertabelle
1670367925,671,553,118,25,6,https://www.intensivregister.de/api/public/reporting/laendertabelle
1670371525,671,552,119,25,6,https://www.intensivregister.de/api/public/reporting/laendertabelle
1670375115,671,555,116,24,5,https://www.intensivregister.de/api/public/reporting/laendertabelle
1670382315,671,556,115,24,5,https://www.intensivregister.de/api/public/reporting/laendertabelle
1670385915,670,556,114,24,5,https://www.intensivregister.de/api/public/reporting/laendertabelle
1670389515,675,561,114,27,4,https://www.intensivregister.de/api/public/reporting/laendertabelle
1670396715,675,569,106,29,4,https://www.intensivregister.de/api/public/reporting/laendertabelle
1670400325,675,567,108,28,4,https://www.intensivregister.de/api/public/reporting/laendertabelle
1670454324,675,567,108,29,3,https://www.intensivregister.de/api/public/reporting/laendertabelle
1670472315,675,566,109,29,3,https://www.intensivregister.de/api/public/reporting/laendertabelle
1670475915,669,553,116,27,2,https://www.intensivregister.de/api/public/reporting/laendertabelle
1670479516,669,550,119,26,2,https://www.intensivregister.de/api/public/reporting/laendertabelle
1670483125,669,547,122,27,2,https://www.intensivregister.de/api/public/reporting/laendertabelle
1670497517,669,549,120,27,2,https://www.intensivregister.de/api/public/reporting/laendertabelle
1670540715,669,546,123,27,2,https://www.intensivregister.de/api/public/reporting/laendertabelle
1670547925,669,545,124,27,2,https://www.intensivregister.de/api/public/reporting/laendertabelle
1670558716,668,547,121,28,2,https://www.intensivregister.de/api/public/reporting/laendertabelle
1670562315,667,558,109,25,3,https://www.intensivregister.de/api/public/reporting/laendertabelle
1670565915,667,561,106,24,3,https://www.intensivregister.de/api/public/reporting/laendertabelle
1670569525,667,560,107,24,3,https://www.intensivregister.de/api/public/reporting/laendertabelle
1670573116,667,561,106,25,4,https://www.intensivregister.de/api/public/reporting/laendertabelle
1670580316,667,559,108,29,4,https://www.intensivregister.de/api/public/reporting/laendertabelle
1670591115,658,554,104,29,4,https://www.intensivregister.de/api/public/reporting/laendertabelle
1670627115,657,552,105,27,3,https://www.intensivregister.de/api/public/reporting/laendertabelle
1670630715,657,550,107,27,3,https://www.intensivregister.de/api/public/reporting/laendertabelle
1670648715,657,551,106,27,3,https://www.intensivregister.de/api/public/reporting/laendertabelle
1670652321,650,549,101,27,3,https://www.intensivregister.de/api/public/reporting/laendertabelle
1670655916,648,547,101,25,3,https://www.intensivregister.de/api/public/reporting/laendertabelle
1670659516,646,547,99,24,3,https://www.intensivregister.de/api/public/reporting/laendertabelle
1670663125,646,546,100,24,3,https://www.intensivregister.de/api/public/reporting/laendertabelle
1670666725,646,549,97,25,3,https://www.intensivregister.de/api/public/reporting/laendertabelle
1670735125,646,546,100,25,3,https://www.intensivregister.de/api/public/reporting/laendertabelle
1670738715,646,539,107,25,3,https://www.intensivregister.de/api/public/reporting/laendertabelle
1670742325,648,545,103,23,3,https://www.intensivregister.de/api/public/reporting/laendertabelle
1670745915,646,539,107,21,3,https://www.intensivregister.de/api/public/reporting/laendertabelle
1670749515,644,535,109,22,2,https://www.intensivregister.de/api/public/reporting/laendertabelle
1670753115,644,534,110,21,2,https://www.intensivregister.de/api/public/reporting/laendertabelle
1670760325,644,532,112,21,2,https://www.intensivregister.de/api/public/reporting/laendertabelle
1670799918,645,535,110,21,2,https://www.intensivregister.de/api/public/reporting/laendertabelle
1670810715,645,536,109,22,3,https://www.intensivregister.de/api/public/reporting/laendertabelle
1670817916,645,537,108,22,3,https://www.intensivregister.de/api/public/reporting/laendertabelle
1670821515,645,530,115,23,4,https://www.intensivregister.de/api/public/reporting/laendertabelle
1670825115,648,541,107,21,6,https://www.intensivregister.de/api/public/reporting/laendertabelle
1670828725,650,539,111,21,6,https://www.intensivregister.de/api/public/reporting/laendertabelle
1670835916,652,542,110,21,6,https://www.intensivregister.de/api/public/reporting/laendertabelle
1670839525,652,544,108,20,6,https://www.intensivregister.de/api/public/reporting/laendertabelle
1670886319,652,541,111,20,6,https://www.intensivregister.de/api/public/reporting/laendertabelle
1670889915,652,539,113,19,6,https://www.intensivregister.de/api/public/reporting/laendertabelle
1670907916,667,556,111,20,9,https://www.intensivregister.de/api/public/reporting/laendertabelle
1670911516,667,561,106,22,9,https://www.intensivregister.de/api/public/reporting/laendertabelle
1670915126,667,564,103,23,9,https://www.intensivregister.de/api/public/reporting/laendertabelle
1670918715,667,565,102,23,9,https://www.intensivregister.de/api/public/reporting/laendertabelle
1670922315,676,568,108,24,9,https://www.intensivregister.de/api/public/reporting/laendertabelle
1670972725,676,575,101,25,9,https://www.intensivregister.de/api/public/reporting/laendertabelle
1670987115,676,576,100,25,9,https://www.intensivregister.de/api/public/reporting/laendertabelle
1670994325,671,577,94,23,8,https://www.intensivregister.de/api/public/reporting/laendertabelle
1670997925,671,573,98,24,8,https://www.intensivregister.de/api/public/reporting/laendertabelle
1671001525,670,576,94,24,8,https://www.intensivregister.de/api/public/reporting/laendertabelle
1671008715,670,578,92,22,8,https://www.intensivregister.de/api/public/reporting/laendertabelle
1671012316,670,577,93,22,8,https://www.intensivregister.de/api/public/reporting/laendertabelle
1671015915,670,573,97,22,8,https://www.intensivregister.de/api/public/reporting/laendertabelle
1671026715,668,573,95,22,8,https://www.intensivregister.de/api/public/reporting/laendertabelle
1671062725,668,574,94,23,8,https://www.intensivregister.de/api/public/reporting/laendertabelle
1671077115,668,571,97,23,8,https://www.intensivregister.de/api/public/reporting/laendertabelle
1671080725,672,575,97,20,7,https://www.intensivregister.de/api/public/reporting/laendertabelle
1671084315,673,572,101,19,7,https://www.intensivregister.de/api/public/reporting/laendertabelle
1671091515,673,570,103,19,7,https://www.intensivregister.de/api/public/reporting/laendertabelle
1671095115,673,568,105,19,7,https://www.intensivregister.de/api/public/reporting/laendertabelle
1671098716,673,564,109,19,7,https://www.intensivregister.de/api/public/reporting/laendertabelle
1671141916,673,562,111,19,7,https://www.intensivregister.de/api/public/reporting/laendertabelle
1671159915,673,561,112,19,7,https://www.intensivregister.de/api/public/reporting/laendertabelle
1671163515,677,568,109,19,6,https://www.intensivregister.de/api/public/reporting/laendertabelle
1671167115,677,565,112,19,6,https://www.intensivregister.de/api/public/reporting/laendertabelle
1671170715,677,569,108,21,5,https://www.intensivregister.de/api/public/reporting/laendertabelle
1671174316,677,570,107,21,5,https://www.intensivregister.de/api/public/reporting/laendertabelle
1671177917,673,570,103,22,6,https://www.intensivregister.de/api/public/reporting/laendertabelle
1671246315,675,571,104,22,6,https://www.intensivregister.de/api/public/reporting/laendertabelle
1671257115,670,558,112,22,7,https://www.intensivregister.de/api/public/reporting/laendertabelle
1671260715,670,559,111,19,7,https://www.intensivregister.de/api/public/reporting/laendertabelle
1671264315,668,562,106,20,7,https://www.intensivregister.de/api/public/reporting/laendertabelle
1671267915,668,562,106,19,6,https://www.intensivregister.de/api/public/reporting/laendertabelle
1671271515,667,559,108,19,6,https://www.intensivregister.de/api/public/reporting/laendertabelle
1671275115,667,559,108,20,6,https://www.intensivregister.de/api/public/reporting/laendertabelle
1671318315,667,557,110,19,6,https://www.intensivregister.de/api/public/reporting/laendertabelle
1671329115,667,561,106,19,6,https://www.intensivregister.de/api/public/reporting/laendertabelle
1671336315,667,560,107,19,6,https://www.intensivregister.de/api/public/reporting/laendertabelle
1671339915,666,558,108,19,6,https://www.intensivregister.de/api/public/reporting/laendertabelle
1671343525,666,554,112,18,6,https://www.intensivregister.de/api/public/reporting/laendertabelle
1671347115,666,548,118,18,6,https://www.intensivregister.de/api/public/reporting/laendertabelle
1671350715,666,548,118,17,5,https://www.intensivregister.de/api/public/reporting/laendertabelle
1671354325,671,550,121,17,5,https://www.intensivregister.de/api/public/reporting/laendertabelle
1671357925,667,546,121,17,5,https://www.intensivregister.de/api/public/reporting/laendertabelle
1671365125,667,547,120,17,5,https://www.intensivregister.de/api/public/reporting/laendertabelle
1671411915,667,546,121,17,5,https://www.intensivregister.de/api/public/reporting/laendertabelle
1671422716,667,551,116,17,5,https://www.intensivregister.de/api/public/reporting/laendertabelle
1671426316,667,555,112,19,6,https://www.intensivregister.de/api/public/reporting/laendertabelle
1671429916,667,551,116,20,7,https://www.intensivregister.de/api/public/reporting/laendertabelle
1671433525,669,555,114,20,6,https://www.intensivregister.de/api/public/reporting/laendertabelle
1671437116,668,556,112,21,6,https://www.intensivregister.de/api/public/reporting/laendertabelle
1671440716,668,559,109,21,6,https://www.intensivregister.de/api/public/reporting/laendertabelle
1671494715,668,560,108,21,6,https://www.intensivregister.de/api/public/reporting/laendertabelle
1671505515,668,561,107,21,6,https://www.intensivregister.de/api/public/reporting/laendertabelle
1671509115,668,563,105,21,6,https://www.intensivregister.de/api/public/reporting/laendertabelle
1671512715,667,553,114,21,6,https://www.intensivregister.de/api/public/reporting/laendertabelle
1671516315,674,565,109,21,5,https://www.intensivregister.de/api/public/reporting/laendertabelle
1671519925,676,567,109,21,5,https://www.intensivregister.de/api/public/reporting/laendertabelle
1671527115,674,567,107,21,5,https://www.intensivregister.de/api/public/reporting/laendertabelle
1671530715,678,571,107,25,8,https://www.intensivregister.de/api/public/reporting/laendertabelle
1671581125,674,568,106,24,8,https://www.intensivregister.de/api/public/reporting/laendertabelle
1671588315,674,570,104,24,8,https://www.intensivregister.de/api/public/reporting/laendertabelle
1671595515,672,567,105,25,9,https://www.intensivregister.de/api/public/reporting/laendertabelle
1671599125,677,580,97,28,9,https://www.intensivregister.de/api/public/reporting/laendertabelle
1671602714,673,578,95,31,11,https://www.intensivregister.de/api/public/reporting/laendertabelle
1671609925,674,580,94,30,11,https://www.intensivregister.de/api/public/reporting/laendertabelle
1671624316,674,581,93,30,11,https://www.intensivregister.de/api/public/reporting/laendertabelle
1671663919,674,585,89,30,12,https://www.intensivregister.de/api/public/reporting/laendertabelle
1671667523,674,587,87,30,12,https://www.intensivregister.de/api/public/reporting/laendertabelle
1671685523,674,589,85,32,13,https://www.intensivregister.de/api/public/reporting/laendertabelle
1671689123,671,584,87,30,13,https://www.intensivregister.de/api/public/reporting/laendertabelle
1671696319,671,584,87,31,13,https://www.intensivregister.de/api/public/reporting/laendertabelle
1671732323,671,585,86,31,13,https://www.intensivregister.de/api/public/reporting/laendertabelle
1671753930,670,584,86,31,13,https://www.intensivregister.de/api/public/reporting/laendertabelle
1671757519,670,585,85,31,13,https://www.intensivregister.de/api/public/reporting/laendertabelle
1671764719,670,585,85,30,13,https://www.intensivregister.de/api/public/reporting/laendertabelle
1671768323,672,587,85,30,13,https://www.intensivregister.de/api/public/reporting/laendertabelle
1671771929,672,574,98,32,12,https://www.intensivregister.de/api/public/reporting/laendertabelle
1671775523,672,575,97,32,12,https://www.intensivregister.de/api/public/reporting/laendertabelle
1671779123,674,575,99,34,12,https://www.intensivregister.de/api/public/reporting/laendertabelle
1671782723,674,573,101,33,12,https://www.intensivregister.de/api/public/reporting/laendertabelle
1671786323,674,573,101,34,12,https://www.intensivregister.de/api/public/reporting/laendertabelle
1671836720,674,570,104,34,12,https://www.intensivregister.de/api/public/reporting/laendertabelle
1671858323,671,567,104,37,11,https://www.intensivregister.de/api/public/reporting/laendertabelle
1671861923,672,564,108,36,12,https://www.intensivregister.de/api/public/reporting/laendertabelle
1671865519,674,568,106,35,12,https://www.intensivregister.de/api/public/reporting/laendertabelle
1671869124,674,568,106,36,13,https://www.intensivregister.de/api/public/reporting/laendertabelle
1671872719,674,572,102,36,13,https://www.intensivregister.de/api/public/reporting/laendertabelle
1671876324,674,571,103,37,13,https://www.intensivregister.de/api/public/reporting/laendertabelle
1671926719,674,572,102,37,12,https://www.intensivregister.de/api/public/reporting/laendertabelle
1671944719,674,573,101,37,12,https://www.intensivregister.de/api/public/reporting/laendertabelle
1671948323,674,564,110,37,13,https://www.intensivregister.de/api/public/reporting/laendertabelle
1671951922,673,558,115,37,13,https://www.intensivregister.de/api/public/reporting/laendertabelle
1671959129,673,558,115,36,13,https://www.intensivregister.de/api/public/reporting/laendertabelle
1671969930,664,553,111,36,13,https://www.intensivregister.de/api/public/reporting/laendertabelle
1672013119,664,549,115,36,13,https://www.intensivregister.de/api/public/reporting/laendertabelle
1672034723,667,551,116,36,15,https://www.intensivregister.de/api/public/reporting/laendertabelle
1672038323,666,547,119,34,15,https://www.intensivregister.de/api/public/reporting/laendertabelle
1672041929,666,551,115,34,16,https://www.intensivregister.de/api/public/reporting/laendertabelle
1672045519,666,551,115,33,16,https://www.intensivregister.de/api/public/reporting/laendertabelle
1672049123,666,551,115,36,17,https://www.intensivregister.de/api/public/reporting/laendertabelle
1672095923,666,548,118,36,18,https://www.intensivregister.de/api/public/reporting/laendertabelle
1672099523,667,549,118,36,18,https://www.intensivregister.de/api/public/reporting/laendertabelle
1672117523,667,557,110,37,20,https://www.intensivregister.de/api/public/reporting/laendertabelle
1672121123,667,556,111,39,18,https://www.intensivregister.de/api/public/reporting/laendertabelle
1672124730,664,560,104,40,18,https://www.intensivregister.de/api/public/reporting/laendertabelle
1672128324,664,557,107,38,18,https://www.intensivregister.de/api/public/reporting/laendertabelle
1672131920,664,552,112,37,17,https://www.intensivregister.de/api/public/reporting/laendertabelle
1672189520,664,551,113,37,17,https://www.intensivregister.de/api/public/reporting/laendertabelle
1672200323,664,550,114,37,17,https://www.intensivregister.de/api/public/reporting/laendertabelle
1672203922,664,549,115,38,16,https://www.intensivregister.de/api/public/reporting/laendertabelle
1672207523,661,546,115,34,15,https://www.intensivregister.de/api/public/reporting/laendertabelle
1672211123,661,544,117,33,15,https://www.intensivregister.de/api/public/reporting/laendertabelle
1672218323,661,543,118,33,15,https://www.intensivregister.de/api/public/reporting/laendertabelle
1672221920,661,543,118,34,16,https://www.intensivregister.de/api/public/reporting/laendertabelle
1672268720,661,544,117,36,18,https://www.intensivregister.de/api/public/reporting/laendertabelle
1672272323,661,545,116,36,18,https://www.intensivregister.de/api/public/reporting/laendertabelle
1672283129,660,544,116,36,18,https://www.intensivregister.de/api/public/reporting/laendertabelle
1672286719,660,543,117,36,18,https://www.intensivregister.de/api/public/reporting/laendertabelle
1672290330,660,541,119,41,18,https://www.intensivregister.de/api/public/reporting/laendertabelle
1672293930,655,535,120,40,18,https://www.intensivregister.de/api/public/reporting/laendertabelle
1672297524,655,535,120,41,18,https://www.intensivregister.de/api/public/reporting/laendertabelle
1672301130,655,538,117,40,18,https://www.intensivregister.de/api/public/reporting/laendertabelle
1672308329,655,540,115,34,14,https://www.intensivregister.de/api/public/reporting/laendertabelle
1672355123,655,541,114,33,14,https://www.intensivregister.de/api/public/reporting/laendertabelle
1672358719,655,541,114,32,13,https://www.intensivregister.de/api/public/reporting/laendertabelle
1672362323,655,542,113,32,13,https://www.intensivregister.de/api/public/reporting/laendertabelle
1672373123,655,544,111,33,13,https://www.intensivregister.de/api/public/reporting/laendertabelle
1672380331,655,552,103,32,13,https://www.intensivregister.de/api/public/reporting/laendertabelle
1672383919,655,544,111,36,13,https://www.intensivregister.de/api/public/reporting/laendertabelle
1672387523,655,545,110,37,13,https://www.intensivregister.de/api/public/reporting/laendertabelle
1672394723,659,549,110,35,13,https://www.intensivregister.de/api/public/reporting/laendertabelle
1672441530,659,554,105,35,13,https://www.intensivregister.de/api/public/reporting/laendertabelle
1672459519,659,555,104,35,13,https://www.intensivregister.de/api/public/reporting/laendertabelle
1672463123,659,554,105,35,13,https://www.intensivregister.de/api/public/reporting/laendertabelle
1672466731,657,540,117,37,14,https://www.intensivregister.de/api/public/reporting/laendertabelle
1672470331,658,539,119,36,14,https://www.intensivregister.de/api/public/reporting/laendertabelle
1672473924,658,545,113,36,14,https://www.intensivregister.de/api/public/reporting/laendertabelle
1672477523,658,543,115,35,14,https://www.intensivregister.de/api/public/reporting/laendertabelle
1672481130,658,538,120,36,14,https://www.intensivregister.de/api/public/reporting/laendertabelle
1672531523,658,537,121,36,14,https://www.intensivregister.de/api/public/reporting/laendertabelle
1672535119,658,536,122,36,14,https://www.intensivregister.de/api/public/reporting/laendertabelle
1672545919,658,533,125,36,14,https://www.intensivregister.de/api/public/reporting/laendertabelle
1672549519,663,540,123,36,14,https://www.intensivregister.de/api/public/reporting/laendertabelle
1672553119,663,540,123,37,14,https://www.intensivregister.de/api/public/reporting/laendertabelle
1672556719,660,539,121,36,13,https://www.intensivregister.de/api/public/reporting/laendertabelle
1672560323,660,541,119,36,13,https://www.intensivregister.de/api/public/reporting/laendertabelle
1672563923,660,541,119,39,15,https://www.intensivregister.de/api/public/reporting/laendertabelle
1672567519,660,537,123,38,15,https://www.intensivregister.de/api/public/reporting/laendertabelle
1672632330,660,538,122,38,16,https://www.intensivregister.de/api/public/reporting/laendertabelle
1672635923,666,540,126,35,15,https://www.intensivregister.de/api/public/reporting/laendertabelle
1672639519,667,548,119,37,15,https://www.intensivregister.de/api/public/reporting/laendertabelle
1672643130,667,552,115,36,15,https://www.intensivregister.de/api/public/reporting/laendertabelle
1672650329,667,549,118,35,13,https://www.intensivregister.de/api/public/reporting/laendertabelle
1672657530,667,546,121,35,13,https://www.intensivregister.de/api/public/reporting/laendertabelle
1672700723,667,548,119,35,13,https://www.intensivregister.de/api/public/reporting/laendertabelle
1672718723,668,550,118,34,13,https://www.intensivregister.de/api/public/reporting/laendertabelle
1672722330,668,553,115,33,11,https://www.intensivregister.de/api/public/reporting/laendertabelle
1672725923,668,541,127,31,11,https://www.intensivregister.de/api/public/reporting/laendertabelle
1672729522,672,549,123,29,10,https://www.intensivregister.de/api/public/reporting/laendertabelle
1672733124,674,561,113,32,10,https://www.intensivregister.de/api/public/reporting/laendertabelle
1672740323,674,563,111,32,10,https://www.intensivregister.de/api/public/reporting/laendertabelle
1672754720,683,565,118,32,10,https://www.intensivregister.de/api/public/reporting/laendertabelle
1672790724,683,567,116,32,10,https://www.intensivregister.de/api/public/reporting/laendertabelle
1672805122,686,570,116,31,10,https://www.intensivregister.de/api/public/reporting/laendertabelle
1672808730,689,578,111,29,9,https://www.intensivregister.de/api/public/reporting/laendertabelle
1672812330,690,576,114,29,9,https://www.intensivregister.de/api/public/reporting/laendertabelle
1672815920,691,581,110,29,9,https://www.intensivregister.de/api/public/reporting/laendertabelle
1672819520,691,579,112,28,8,https://www.intensivregister.de/api/public/reporting/laendertabelle
1672873525,691,575,116,28,8,https://www.intensivregister.de/api/public/reporting/laendertabelle
1672891516,691,574,117,28,8,https://www.intensivregister.de/api/public/reporting/laendertabelle
1672895125,693,584,109,28,7,https://www.intensivregister.de/api/public/reporting/laendertabelle
1672898715,693,585,108,29,7,https://www.intensivregister.de/api/public/reporting/laendertabelle
1672902325,693,581,112,28,7,https://www.intensivregister.de/api/public/reporting/laendertabelle
1672905916,693,582,111,27,7,https://www.intensivregister.de/api/public/reporting/laendertabelle
1672970716,693,579,114,27,7,https://www.intensivregister.de/api/public/reporting/laendertabelle
1672974325,693,581,112,27,7,https://www.intensivregister.de/api/public/reporting/laendertabelle
1672977926,693,583,110,27,7,https://www.intensivregister.de/api/public/reporting/laendertabelle
1672981516,696,583,113,26,7,https://www.intensivregister.de/api/public/reporting/laendertabelle
1672985126,696,583,113,27,7,https://www.intensivregister.de/api/public/reporting/laendertabelle
1672988727,702,590,112,29,8,https://www.intensivregister.de/api/public/reporting/laendertabelle
1672992325,702,588,114,30,8,https://www.intensivregister.de/api/public/reporting/laendertabelle
1672995917,702,587,115,30,8,https://www.intensivregister.de/api/public/reporting/laendertabelle
1673003115,701,588,113,30,8,https://www.intensivregister.de/api/public/reporting/laendertabelle
1673006726,699,588,111,30,8,https://www.intensivregister.de/api/public/reporting/laendertabelle
1673046325,698,590,108,30,8,https://www.intensivregister.de/api/public/reporting/laendertabelle
1673064315,698,590,108,29,8,https://www.intensivregister.de/api/public/reporting/laendertabelle
1673067916,697,589,108,29,8,https://www.intensivregister.de/api/public/reporting/laendertabelle
1673071515,697,591,106,29,8,https://www.intensivregister.de/api/public/reporting/laendertabelle
1673075116,697,587,110,30,10,https://www.intensivregister.de/api/public/reporting/laendertabelle
1673078725,698,586,112,32,9,https://www.intensivregister.de/api/public/reporting/laendertabelle
1673082315,694,587,107,33,9,https://www.intensivregister.de/api/public/reporting/laendertabelle
1673132715,694,585,109,33,9,https://www.intensivregister.de/api/public/reporting/laendertabelle
1673150715,694,583,111,33,9,https://www.intensivregister.de/api/public/reporting/laendertabelle
1673154316,694,583,111,34,9,https://www.intensivregister.de/api/public/reporting/laendertabelle
1673161516,691,578,113,32,8,https://www.intensivregister.de/api/public/reporting/laendertabelle
1673165115,691,579,112,33,10,https://www.intensivregister.de/api/public/reporting/laendertabelle
1673168716,691,570,121,33,10,https://www.intensivregister.de/api/public/reporting/laendertabelle
1673215525,691,568,123,33,10,https://www.intensivregister.de/api/public/reporting/laendertabelle
1673219125,691,569,122,33,10,https://www.intensivregister.de/api/public/reporting/laendertabelle
1673233515,693,571,122,33,10,https://www.intensivregister.de/api/public/reporting/laendertabelle
1673240725,694,566,128,31,10,https://www.intensivregister.de/api/public/reporting/laendertabelle
1673244318,694,567,127,31,10,https://www.intensivregister.de/api/public/reporting/laendertabelle
1673247915,694,568,126,31,11,https://www.intensivregister.de/api/public/reporting/laendertabelle
1673258716,694,569,125,31,11,https://www.intensivregister.de/api/public/reporting/laendertabelle
1673265915,696,569,127,31,11,https://www.intensivregister.de/api/public/reporting/laendertabelle
1673305515,696,571,125,32,11,https://www.intensivregister.de/api/public/reporting/laendertabelle
1673316315,696,574,122,32,11,https://www.intensivregister.de/api/public/reporting/laendertabelle
1673323525,696,572,124,32,11,https://www.intensivregister.de/api/public/reporting/laendertabelle
1673327125,702,585,117,33,12,https://www.intensivregister.de/api/public/reporting/laendertabelle
1673330725,701,586,115,32,12,https://www.intensivregister.de/api/public/reporting/laendertabelle
1673334316,701,586,115,31,11,https://www.intensivregister.de/api/public/reporting/laendertabelle
1673337916,701,581,120,30,12,https://www.intensivregister.de/api/public/reporting/laendertabelle
1673388316,701,579,122,30,12,https://www.intensivregister.de/api/public/reporting/laendertabelle
1673391925,701,580,121,30,12,https://www.intensivregister.de/api/public/reporting/laendertabelle
1673402725,701,580,121,29,12,https://www.intensivregister.de/api/public/reporting/laendertabelle
1673406316,707,582,125,28,11,https://www.intensivregister.de/api/public/reporting/laendertabelle
1673409916,707,581,126,28,11,https://www.intensivregister.de/api/public/reporting/laendertabelle
1673413516,706,582,124,28,13,https://www.intensivregister.de/api/public/reporting/laendertabelle
1673417116,705,586,119,29,13,https://www.intensivregister.de/api/public/reporting/laendertabelle
1673420716,705,586,119,30,13,https://www.intensivregister.de/api/public/reporting/laendertabelle
1673431516,705,588,117,31,13,https://www.intensivregister.de/api/public/reporting/laendertabelle
1673485515,705,587,118,31,13,https://www.intensivregister.de/api/public/reporting/laendertabelle
1673492715,705,586,119,31,13,https://www.intensivregister.de/api/public/reporting/laendertabelle
1673499926,709,591,118,31,13,https://www.intensivregister.de/api/public/reporting/laendertabelle
1673503516,709,591,118,30,11,https://www.intensivregister.de/api/public/reporting/laendertabelle
1673507115,709,590,119,29,11,https://www.intensivregister.de/api/public/reporting/laendertabelle
1673514316,710,590,120,29,11,https://www.intensivregister.de/api/public/reporting/laendertabelle
1673564715,710,593,117,29,11,https://www.intensivregister.de/api/public/reporting/laendertabelle
1673579125,710,596,114,29,11,https://www.intensivregister.de/api/public/reporting/laendertabelle
1673586326,708,594,114,30,10,https://www.intensivregister.de/api/public/reporting/laendertabelle
1673589916,708,595,113,31,9,https://www.intensivregister.de/api/public/reporting/laendertabelle
1673593515,707,599,108,31,9,https://www.intensivregister.de/api/public/reporting/laendertabelle
1673647525,707,597,110,31,9,https://www.intensivregister.de/api/public/reporting/laendertabelle
1673661915,707,598,109,31,9,https://www.intensivregister.de/api/public/reporting/laendertabelle
1673672715,699,598,101,30,9,https://www.intensivregister.de/api/public/reporting/laendertabelle
1673676316,700,593,107,32,9,https://www.intensivregister.de/api/public/reporting/laendertabelle
1673679925,698,594,104,32,9,https://www.intensivregister.de/api/public/reporting/laendertabelle
1673683515,695,588,107,29,10,https://www.intensivregister.de/api/public/reporting/laendertabelle
1673737525,695,585,110,29,10,https://www.intensivregister.de/api/public/reporting/laendertabelle
1673741115,695,583,112,29,10,https://www.intensivregister.de/api/public/reporting/laendertabelle
1673751915,696,586,110,29,10,https://www.intensivregister.de/api/public/reporting/laendertabelle
1673755515,696,585,111,29,10,https://www.intensivregister.de/api/public/reporting/laendertabelle
1673759116,696,580,116,29,10,https://www.intensivregister.de/api/public/reporting/laendertabelle
1673762716,698,567,131,28,10,https://www.intensivregister.de/api/public/reporting/laendertabelle
1673766325,690,561,129,24,10,https://www.intensivregister.de/api/public/reporting/laendertabelle
1673769925,690,551,139,27,12,https://www.intensivregister.de/api/public/reporting/laendertabelle
1673773516,690,552,138,27,12,https://www.intensivregister.de/api/public/reporting/laendertabelle
1673784325,693,553,140,27,12,https://www.intensivregister.de/api/public/reporting/laendertabelle
1673823925,693,551,142,27,12,https://www.intensivregister.de/api/public/reporting/laendertabelle
1673841915,693,552,141,27,12,https://www.intensivregister.de/api/public/reporting/laendertabelle
1673845525,693,542,151,25,10,https://www.intensivregister.de/api/public/reporting/laendertabelle
1673849125,697,545,152,24,9,https://www.intensivregister.de/api/public/reporting/laendertabelle
1673852715,697,541,156,26,8,https://www.intensivregister.de/api/public/reporting/laendertabelle
1673885126,697,543,154,26,8,https://www.intensivregister.de/api/public/reporting/laendertabelle
1673910325,697,546,151,26,8,https://www.intensivregister.de/api/public/reporting/laendertabelle
1673924725,697,551,146,26,8,https://www.intensivregister.de/api/public/reporting/laendertabelle
1673928325,696,550,146,26,8,https://www.intensivregister.de/api/public/reporting/laendertabelle
1673931915,705,580,125,26,9,https://www.intensivregister.de/api/public/reporting/laendertabelle
1673935516,705,585,120,26,9,https://www.intensivregister.de/api/public/reporting/laendertabelle
1673939116,707,587,120,26,9,https://www.intensivregister.de/api/public/reporting/laendertabelle
1673942717,707,584,123,24,9,https://www.intensivregister.de/api/public/reporting/laendertabelle
1673946316,709,595,114,24,9,https://www.intensivregister.de/api/public/reporting/laendertabelle
1674003925,709,591,118,24,9,https://www.intensivregister.de/api/public/reporting/laendertabelle
1674014715,712,592,120,24,9,https://www.intensivregister.de/api/public/reporting/laendertabelle
1674018317,715,587,128,23,8,https://www.intensivregister.de/api/public/reporting/laendertabelle
1674021916,715,592,123,23,8,https://www.intensivregister.de/api/public/reporting/laendertabelle
1674025526,708,594,114,23,8,https://www.intensivregister.de/api/public/reporting/laendertabelle
1674029126,711,592,119,22,8,https://www.intensivregister.de/api/public/reporting/laendertabelle
1674086716,711,591,120,24,10,https://www.intensivregister.de/api/public/reporting/laendertabelle
1674101115,711,593,118,24,10,https://www.intensivregister.de/api/public/reporting/laendertabelle
1674104715,715,585,130,25,13,https://www.intensivregister.de/api/public/reporting/laendertabelle
1674108325,715,581,134,25,15,https://www.intensivregister.de/api/public/reporting/laendertabelle
1674111916,715,581,134,26,15,https://www.intensivregister.de/api/public/reporting/laendertabelle
1674115526,715,584,131,26,15,https://www.intensivregister.de/api/public/reporting/laendertabelle
1674122716,715,582,133,26,15,https://www.intensivregister.de/api/public/reporting/laendertabelle
1674169515,713,582,131,26,15,https://www.intensivregister.de/api/public/reporting/laendertabelle
1674173115,713,581,132,26,15,https://www.intensivregister.de/api/public/reporting/laendertabelle
1674180325,713,585,128,25,14,https://www.intensivregister.de/api/public/reporting/laendertabelle
1674191115,713,585,128,21,9,https://www.intensivregister.de/api/public/reporting/laendertabelle
1674194726,709,579,130,21,9,https://www.intensivregister.de/api/public/reporting/laendertabelle
1674198325,709,574,135,21,8,https://www.intensivregister.de/api/public/reporting/laendertabelle
1674205515,709,575,134,20,7,https://www.intensivregister.de/api/public/reporting/laendertabelle
1674209126,709,573,136,20,7,https://www.intensivregister.de/api/public/reporting/laendertabelle
1674241516,709,575,134,20,7,https://www.intensivregister.de/api/public/reporting/laendertabelle
1674255916,709,574,135,20,7,https://www.intensivregister.de/api/public/reporting/laendertabelle
1674259525,709,572,137,20,7,https://www.intensivregister.de/api/public/reporting/laendertabelle
1674263115,709,570,139,20,7,https://www.intensivregister.de/api/public/reporting/laendertabelle
1674266729,709,571,138,20,7,https://www.intensivregister.de/api/public/reporting/laendertabelle
1674273926,709,569,140,20,7,https://www.intensivregister.de/api/public/reporting/laendertabelle
1674277516,709,568,141,19,7,https://www.intensivregister.de/api/public/reporting/laendertabelle
1674281115,699,553,146,18,7,https://www.intensivregister.de/api/public/reporting/laendertabelle
1674284715,700,551,149,16,6,https://www.intensivregister.de/api/public/reporting/laendertabelle
1674288315,700,549,151,17,6,https://www.intensivregister.de/api/public/reporting/laendertabelle
1674299116,700,557,143,18,7,https://www.intensivregister.de/api/public/reporting/laendertabelle
1674338716,702,555,147,18,7,https://www.intensivregister.de/api/public/reporting/laendertabelle
1674363915,702,554,148,18,7,https://www.intensivregister.de/api/public/reporting/laendertabelle
1674367516,697,549,148,18,7,https://www.intensivregister.de/api/public/reporting/laendertabelle
1674371125,696,552,144,18,8,https://www.intensivregister.de/api/public/reporting/laendertabelle
1674374715,696,549,147,18,8,https://www.intensivregister.de/api/public/reporting/laendertabelle
1674378315,696,550,146,18,8,https://www.intensivregister.de/api/public/reporting/laendertabelle
1674381915,696,544,152,18,8,https://www.intensivregister.de/api/public/reporting/laendertabelle
1674428715,696,543,153,18,8,https://www.intensivregister.de/api/public/reporting/laendertabelle
1674443125,696,542,154,17,8,https://www.intensivregister.de/api/public/reporting/laendertabelle
1674450315,696,546,150,18,8,https://www.intensivregister.de/api/public/reporting/laendertabelle
1674453926,696,539,157,18,8,https://www.intensivregister.de/api/public/reporting/laendertabelle
1674457515,694,530,164,15,7,https://www.intensivregister.de/api/public/reporting/laendertabelle
1674482726,704,535,169,15,7,https://www.intensivregister.de/api/public/reporting/laendertabelle
1674515115,704,534,170,15,7,https://www.intensivregister.de/api/public/reporting/laendertabelle
1674533115,708,541,167,14,6,https://www.intensivregister.de/api/public/reporting/laendertabelle
1674536725,714,549,165,13,6,https://www.intensivregister.de/api/public/reporting/laendertabelle
1674540315,716,565,151,13,6,https://www.intensivregister.de/api/public/reporting/laendertabelle
1674547516,716,566,150,13,6,https://www.intensivregister.de/api/public/reporting/laendertabelle
1674601515,716,566,150,12,5,https://www.intensivregister.de/api/public/reporting/laendertabelle
1674605125,716,563,153,12,5,https://www.intensivregister.de/api/public/reporting/laendertabelle
1674619515,716,560,156,12,5,https://www.intensivregister.de/api/public/reporting/laendertabelle
1674623115,721,565,156,11,6,https://www.intensivregister.de/api/public/reporting/laendertabelle
1674626716,721,564,157,9,6,https://www.intensivregister.de/api/public/reporting/laendertabelle
1674630316,721,567,154,9,6,https://www.intensivregister.de/api/public/reporting/laendertabelle
1674633915,722,567,155,9,6,https://www.intensivregister.de/api/public/reporting/laendertabelle
1674637516,722,566,156,9,6,https://www.intensivregister.de/api/public/reporting/laendertabelle
1674691515,722,567,155,9,6,https://www.intensivregister.de/api/public/reporting/laendertabelle
1674695125,723,569,154,9,6,https://www.intensivregister.de/api/public/reporting/laendertabelle
1674709525,721,567,154,11,6,https://www.intensivregister.de/api/public/reporting/laendertabelle
1674713116,717,569,148,11,6,https://www.intensivregister.de/api/public/reporting/laendertabelle
1674716716,717,572,145,12,6,https://www.intensivregister.de/api/public/reporting/laendertabelle
1674723916,718,576,142,12,6,https://www.intensivregister.de/api/public/reporting/laendertabelle
1674731125,718,579,139,13,7,https://www.intensivregister.de/api/public/reporting/laendertabelle
1674741915,718,580,138,14,7,https://www.intensivregister.de/api/public/reporting/laendertabelle
1674756316,718,582,136,14,7,https://www.intensivregister.de/api/public/reporting/laendertabelle
1674777915,718,585,133,15,8,https://www.intensivregister.de/api/public/reporting/laendertabelle
1674788715,718,588,130,15,8,https://www.intensivregister.de/api/public/reporting/laendertabelle
1674792323,718,586,132,15,8,https://www.intensivregister.de/api/public/reporting/laendertabelle
1674795915,719,597,122,15,7,https://www.intensivregister.de/api/public/reporting/laendertabelle
1674799525,713,596,117,15,7,https://www.intensivregister.de/api/public/reporting/laendertabelle
1674803126,713,593,120,15,7,https://www.intensivregister.de/api/public/reporting/laendertabelle
1674806715,713,590,123,15,7,https://www.intensivregister.de/api/public/reporting/laendertabelle
1674857115,712,590,122,15,7,https://www.intensivregister.de/api/public/reporting/laendertabelle
1674860725,712,588,124,14,6,https://www.intensivregister.de/api/public/reporting/laendertabelle
1674875115,712,589,123,14,6,https://www.intensivregister.de/api/public/reporting/laendertabelle
1674882316,713,587,126,14,6,https://www.intensivregister.de/api/public/reporting/laendertabelle
1674885925,711,583,128,13,6,https://www.intensivregister.de/api/public/reporting/laendertabelle
1674889516,707,576,131,17,6,https://www.intensivregister.de/api/public/reporting/laendertabelle
1674893116,707,571,136,16,6,https://www.intensivregister.de/api/public/reporting/laendertabelle
1674896715,707,572,135,15,6,https://www.intensivregister.de/api/public/reporting/laendertabelle
1674900326,706,569,137,15,6,https://www.intensivregister.de/api/public/reporting/laendertabelle
1674968715,706,566,140,15,6,https://www.intensivregister.de/api/public/reporting/laendertabelle
1674972316,702,552,150,15,6,https://www.intensivregister.de/api/public/reporting/laendertabelle
1674975915,698,537,161,13,6,https://www.intensivregister.de/api/public/reporting/laendertabelle
1674979516,698,531,167,13,7,https://www.intensivregister.de/api/public/reporting/laendertabelle
1674986726,698,532,166,14,7,https://www.intensivregister.de/api/public/reporting/laendertabelle
1675037114,698,533,165,14,7,https://www.intensivregister.de/api/public/reporting/laendertabelle
1675040716,698,534,164,14,7,https://www.intensivregister.de/api/public/reporting/laendertabelle
1675044327,698,535,163,14,7,https://www.intensivregister.de/api/public/reporting/laendertabelle
1675051516,698,536,162,14,7,https://www.intensivregister.de/api/public/reporting/laendertabelle
1675055116,698,538,160,14,7,https://www.intensivregister.de/api/public/reporting/laendertabelle
1675058715,702,537,165,15,7,https://www.intensivregister.de/api/public/reporting/laendertabelle
1675062317,702,540,162,17,7,https://www.intensivregister.de/api/public/reporting/laendertabelle
1675065915,702,542,160,16,7,https://www.intensivregister.de/api/public/reporting/laendertabelle
1675083925,702,543,159,16,7,https://www.intensivregister.de/api/public/reporting/laendertabelle
1675127116,702,544,158,16,7,https://www.intensivregister.de/api/public/reporting/laendertabelle
1675137915,703,541,162,16,7,https://www.intensivregister.de/api/public/reporting/laendertabelle
1675141525,707,557,150,16,7,https://www.intensivregister.de/api/public/reporting/laendertabelle
1675145115,707,564,143,16,6,https://www.intensivregister.de/api/public/reporting/laendertabelle
1675148715,712,578,134,17,6,https://www.intensivregister.de/api/public/reporting/laendertabelle
1675152315,713,580,133,18,6,https://www.intensivregister.de/api/public/reporting/laendertabelle
1675206315,713,584,129,18,6,https://www.intensivregister.de/api/public/reporting/laendertabelle
1675227916,717,592,125,17,5,https://www.intensivregister.de/api/public/reporting/laendertabelle
1675231515,717,586,131,17,5,https://www.intensivregister.de/api/public/reporting/laendertabelle
1675235115,712,588,124,15,5,https://www.intensivregister.de/api/public/reporting/laendertabelle
1675245916,711,590,121,15,5,https://www.intensivregister.de/api/public/reporting/laendertabelle
1675292725,711,589,122,15,5,https://www.intensivregister.de/api/public/reporting/laendertabelle
1675296315,711,586,125,15,5,https://www.intensivregister.de/api/public/reporting/laendertabelle
1675310715,711,580,131,15,5,https://www.intensivregister.de/api/public/reporting/laendertabelle
1675314317,708,587,121,15,5,https://www.intensivregister.de/api/public/reporting/laendertabelle
1675317925,710,585,125,15,5,https://www.intensivregister.de/api/public/reporting/laendertabelle
1675321518,710,600,110,16,5,https://www.intensivregister.de/api/public/reporting/laendertabelle
1675332316,710,602,108,16,5,https://www.intensivregister.de/api/public/reporting/laendertabelle
1675335915,710,599,111,16,5,https://www.intensivregister.de/api/public/reporting/laendertabelle
1675397125,710,598,112,16,5,https://www.intensivregister.de/api/public/reporting/laendertabelle
1675400715,711,590,121,17,5,https://www.intensivregister.de/api/public/reporting/laendertabelle
1675404316,711,581,130,17,5,https://www.intensivregister.de/api/public/reporting/laendertabelle
1675407916,711,582,129,18,5,https://www.intensivregister.de/api/public/reporting/laendertabelle
1675476318,709,582,127,18,5,https://www.intensivregister.de/api/public/reporting/laendertabelle
1675487115,709,581,128,18,5,https://www.intensivregister.de/api/public/reporting/laendertabelle
1675490715,702,597,105,18,5,https://www.intensivregister.de/api/public/reporting/laendertabelle
1675494326,697,588,109,15,5,https://www.intensivregister.de/api/public/reporting/laendertabelle
1675501515,697,583,114,14,5,https://www.intensivregister.de/api/public/reporting/laendertabelle
1675512326,697,587,110,14,5,https://www.intensivregister.de/api/public/reporting/laendertabelle
1675515926,697,587,110,15,5,https://www.intensivregister.de/api/public/reporting/laendertabelle
1675559117,697,581,116,15,5,https://www.intensivregister.de/api/public/reporting/laendertabelle
1675562717,697,582,115,15,5,https://www.intensivregister.de/api/public/reporting/laendertabelle
1675573526,697,580,117,19,5,https://www.intensivregister.de/api/public/reporting/laendertabelle
1675577117,691,567,124,19,5,https://www.intensivregister.de/api/public/reporting/laendertabelle
1675580726,690,564,126,18,5,https://www.intensivregister.de/api/public/reporting/laendertabelle
1675584315,691,560,131,21,5,https://www.intensivregister.de/api/public/reporting/laendertabelle
1675587915,691,557,134,21,5,https://www.intensivregister.de/api/public/reporting/laendertabelle
1675641915,691,556,135,21,5,https://www.intensivregister.de/api/public/reporting/laendertabelle
1675652715,691,557,134,21,5,https://www.intensivregister.de/api/public/reporting/laendertabelle
1675659915,694,561,133,20,5,https://www.intensivregister.de/api/public/reporting/laendertabelle
1675663516,694,565,129,20,5,https://www.intensivregister.de/api/public/reporting/laendertabelle
1675667116,692,567,125,15,5,https://www.intensivregister.de/api/public/reporting/laendertabelle
1675670715,692,564,128,13,5,https://www.intensivregister.de/api/public/reporting/laendertabelle
1675674317,692,564,128,14,5,https://www.intensivregister.de/api/public/reporting/laendertabelle
1675721116,692,563,129,14,5,https://www.intensivregister.de/api/public/reporting/laendertabelle
1675724717,692,565,127,14,5,https://www.intensivregister.de/api/public/reporting/laendertabelle
1675731925,693,567,126,14,5,https://www.intensivregister.de/api/public/reporting/laendertabelle
1675742716,689,563,126,14,5,https://www.intensivregister.de/api/public/reporting/laendertabelle
1675746325,697,579,118,14,4,https://www.intensivregister.de/api/public/reporting/laendertabelle
1675749916,701,582,119,16,4,https://www.intensivregister.de/api/public/reporting/laendertabelle
1675753515,701,580,121,17,5,https://www.intensivregister.de/api/public/reporting/laendertabelle
1675757115,701,583,118,16,5,https://www.intensivregister.de/api/public/reporting/laendertabelle
1675764326,701,581,120,16,5,https://www.intensivregister.de/api/public/reporting/laendertabelle
1675814715,701,578,123,16,5,https://www.intensivregister.de/api/public/reporting/laendertabelle
1675829126,702,581,121,18,6,https://www.intensivregister.de/api/public/reporting/laendertabelle
1675832715,701,577,124,17,6,https://www.intensivregister.de/api/public/reporting/laendertabelle
1675836317,701,577,124,20,6,https://www.intensivregister.de/api/public/reporting/laendertabelle
1675839916,702,581,121,19,6,https://www.intensivregister.de/api/public/reporting/laendertabelle
1675850717,703,582,121,19,6,https://www.intensivregister.de/api/public/reporting/laendertabelle
1675897530,703,577,126,19,6,https://www.intensivregister.de/api/public/reporting/laendertabelle
1675919124,701,578,123,19,5,https://www.intensivregister.de/api/public/reporting/laendertabelle
1675922730,701,581,120,20,5,https://www.intensivregister.de/api/public/reporting/laendertabelle
1675926323,701,580,121,20,5,https://www.intensivregister.de/api/public/reporting/laendertabelle
1675929930,701,581,120,20,5,https://www.intensivregister.de/api/public/reporting/laendertabelle
1675933520,701,582,119,20,5,https://www.intensivregister.de/api/public/reporting/laendertabelle
1676001919,702,585,117,20,5,https://www.intensivregister.de/api/public/reporting/laendertabelle
1676005523,705,595,110,24,5,https://www.intensivregister.de/api/public/reporting/laendertabelle
1676009120,705,592,113,24,6,https://www.intensivregister.de/api/public/reporting/laendertabelle
1676012719,704,587,117,22,6,https://www.intensivregister.de/api/public/reporting/laendertabelle
1676016323,702,590,112,22,6,https://www.intensivregister.de/api/public/reporting/laendertabelle
1676019930,702,589,113,22,6,https://www.intensivregister.de/api/public/reporting/laendertabelle
1676073919,702,590,112,22,6,https://www.intensivregister.de/api/public/reporting/laendertabelle
1676077531,702,588,114,22,6,https://www.intensivregister.de/api/public/reporting/laendertabelle
1676081131,702,589,113,22,6,https://www.intensivregister.de/api/public/reporting/laendertabelle
1676091922,702,586,116,21,6,https://www.intensivregister.de/api/public/reporting/laendertabelle
1676095523,701,583,118,19,6,https://www.intensivregister.de/api/public/reporting/laendertabelle
1676099120,701,581,120,20,6,https://www.intensivregister.de/api/public/reporting/laendertabelle
1676102731,697,573,124,18,6,https://www.intensivregister.de/api/public/reporting/laendertabelle
1676106331,697,572,125,18,5,https://www.intensivregister.de/api/public/reporting/laendertabelle
1676156730,697,571,126,18,5,https://www.intensivregister.de/api/public/reporting/laendertabelle
1676178330,692,568,124,20,6,https://www.intensivregister.de/api/public/reporting/laendertabelle
1676181930,692,551,141,21,6,https://www.intensivregister.de/api/public/reporting/laendertabelle
1676185519,692,548,144,19,6,https://www.intensivregister.de/api/public/reporting/laendertabelle
1676189119,692,545,147,20,6,https://www.intensivregister.de/api/public/reporting/laendertabelle
1676192729,692,539,153,20,6,https://www.intensivregister.de/api/public/reporting/laendertabelle
1676243123,692,538,154,20,6,https://www.intensivregister.de/api/public/reporting/laendertabelle
1676246720,692,536,156,20,6,https://www.intensivregister.de/api/public/reporting/laendertabelle
1676264723,692,555,137,20,6,https://www.intensivregister.de/api/public/reporting/laendertabelle
1676268330,692,553,139,21,6,https://www.intensivregister.de/api/public/reporting/laendertabelle
1676271923,692,546,146,21,6,https://www.intensivregister.de/api/public/reporting/laendertabelle
1676275530,692,547,145,21,6,https://www.intensivregister.de/api/public/reporting/laendertabelle
1676282720,692,548,144,22,6,https://www.intensivregister.de/api/public/reporting/laendertabelle
1676297119,692,548,144,23,7,https://www.intensivregister.de/api/public/reporting/laendertabelle
1676307924,695,552,143,23,7,https://www.intensivregister.de/api/public/reporting/laendertabelle
1676333124,695,554,141,23,7,https://www.intensivregister.de/api/public/reporting/laendertabelle
1676351130,695,566,129,24,7,https://www.intensivregister.de/api/public/reporting/laendertabelle
1676354730,700,568,132,23,7,https://www.intensivregister.de/api/public/reporting/laendertabelle
1676358324,700,567,133,26,8,https://www.intensivregister.de/api/public/reporting/laendertabelle
1676361925,700,564,136,26,8,https://www.intensivregister.de/api/public/reporting/laendertabelle
1676369120,700,563,137,26,8,https://www.intensivregister.de/api/public/reporting/laendertabelle
1676415915,700,564,136,26,8,https://www.intensivregister.de/api/public/reporting/laendertabelle
1676433916,700,563,137,26,8,https://www.intensivregister.de/api/public/reporting/laendertabelle
1676437515,700,559,141,24,8,https://www.intensivregister.de/api/public/reporting/laendertabelle
1676441116,700,562,138,24,8,https://www.intensivregister.de/api/public/reporting/laendertabelle
1676444726,700,570,130,24,8,https://www.intensivregister.de/api/public/reporting/laendertabelle
1676505915,700,572,128,24,8,https://www.intensivregister.de/api/public/reporting/laendertabelle
1676520317,700,573,127,23,8,https://www.intensivregister.de/api/public/reporting/laendertabelle
1676523915,712,580,132,24,9,https://www.intensivregister.de/api/public/reporting/laendertabelle
1676527526,712,585,127,25,9,https://www.intensivregister.de/api/public/reporting/laendertabelle
1676531115,712,593,119,24,9,https://www.intensivregister.de/api/public/reporting/laendertabelle
1676534715,712,594,118,31,12,https://www.intensivregister.de/api/public/reporting/laendertabelle
1676538326,712,595,117,31,12,https://www.intensivregister.de/api/public/reporting/laendertabelle
1676599525,713,598,115,32,12,https://www.intensivregister.de/api/public/reporting/laendertabelle
1676603125,713,600,113,32,12,https://www.intensivregister.de/api/public/reporting/laendertabelle
1676610326,713,599,114,40,13,https://www.intensivregister.de/api/public/reporting/laendertabelle
1676613916,715,603,112,35,12,https://www.intensivregister.de/api/public/reporting/laendertabelle
1676617525,715,607,108,38,12,https://www.intensivregister.de/api/public/reporting/laendertabelle
1676621115,715,605,110,37,12,https://www.intensivregister.de/api/public/reporting/laendertabelle
1676624716,715,603,112,38,13,https://www.intensivregister.de/api/public/reporting/laendertabelle
1676635525,715,601,114,38,13,https://www.intensivregister.de/api/public/reporting/laendertabelle
1676678726,715,602,113,38,13,https://www.intensivregister.de/api/public/reporting/laendertabelle
1676696716,715,601,114,36,12,https://www.intensivregister.de/api/public/reporting/laendertabelle
1676700315,715,588,127,35,11,https://www.intensivregister.de/api/public/reporting/laendertabelle
1676703926,712,582,130,38,13,https://www.intensivregister.de/api/public/reporting/laendertabelle
1676707526,710,582,128,40,14,https://www.intensivregister.de/api/public/reporting/laendertabelle
1676711115,709,582,127,37,14,https://www.intensivregister.de/api/public/reporting/laendertabelle
1676714715,709,582,127,36,13,https://www.intensivregister.de/api/public/reporting/laendertabelle
1676757916,709,581,128,36,13,https://www.intensivregister.de/api/public/reporting/laendertabelle
1676761517,709,574,135,36,13,https://www.intensivregister.de/api/public/reporting/laendertabelle
1676765116,709,573,136,36,14,https://www.intensivregister.de/api/public/reporting/laendertabelle
1676783116,709,572,137,36,14,https://www.intensivregister.de/api/public/reporting/laendertabelle
1676786715,705,561,144,37,15,https://www.intensivregister.de/api/public/reporting/laendertabelle
1676790315,705,561,144,35,15,https://www.intensivregister.de/api/public/reporting/laendertabelle
1676793915,705,561,144,36,15,https://www.intensivregister.de/api/public/reporting/laendertabelle
1676801116,705,562,143,36,15,https://www.intensivregister.de/api/public/reporting/laendertabelle
1676855116,705,565,140,36,15,https://www.intensivregister.de/api/public/reporting/laendertabelle
1676869516,704,571,133,34,13,https://www.intensivregister.de/api/public/reporting/laendertabelle
1676873115,708,584,124,33,13,https://www.intensivregister.de/api/public/reporting/laendertabelle
1676876715,706,585,121,34,15,https://www.intensivregister.de/api/public/reporting/laendertabelle
1676880326,705,583,122,34,15,https://www.intensivregister.de/api/public/reporting/laendertabelle
1676887515,705,579,126,35,15,https://www.intensivregister.de/api/public/reporting/laendertabelle
1676934315,706,578,128,35,15,https://www.intensivregister.de/api/public/reporting/laendertabelle
1676937915,706,577,129,35,15,https://www.intensivregister.de/api/public/reporting/laendertabelle
1676952326,706,579,127,35,15,https://www.intensivregister.de/api/public/reporting/laendertabelle
1676955926,723,590,133,32,15,https://www.intensivregister.de/api/public/reporting/laendertabelle
1676959526,725,594,131,33,15,https://www.intensivregister.de/api/public/reporting/laendertabelle
1676963116,725,595,130,35,15,https://www.intensivregister.de/api/public/reporting/laendertabelle
1676966715,725,590,135,35,15,https://www.intensivregister.de/api/public/reporting/laendertabelle
1676970315,725,593,132,35,15,https://www.intensivregister.de/api/public/reporting/laendertabelle
1677038715,725,589,136,35,14,https://www.intensivregister.de/api/public/reporting/laendertabelle
1677042315,724,594,130,33,13,https://www.intensivregister.de/api/public/reporting/laendertabelle
1677045917,724,602,122,35,14,https://www.intensivregister.de/api/public/reporting/laendertabelle
1677049517,723,606,117,35,14,https://www.intensivregister.de/api/public/reporting/laendertabelle
1677056716,723,607,116,35,14,https://www.intensivregister.de/api/public/reporting/laendertabelle
1677060316,723,608,115,35,14,https://www.intensivregister.de/api/public/reporting/laendertabelle
1677107116,723,605,118,35,14,https://www.intensivregister.de/api/public/reporting/laendertabelle
1677117916,723,608,115,35,14,https://www.intensivregister.de/api/public/reporting/laendertabelle
1677125116,725,598,127,34,14,https://www.intensivregister.de/api/public/reporting/laendertabelle
1677128717,722,590,132,33,13,https://www.intensivregister.de/api/public/reporting/laendertabelle
1677132316,721,588,133,32,12,https://www.intensivregister.de/api/public/reporting/laendertabelle
1677135916,709,589,120,32,11,https://www.intensivregister.de/api/public/reporting/laendertabelle
1677139517,709,592,117,30,11,https://www.intensivregister.de/api/public/reporting/laendertabelle
1677146716,709,593,116,30,11,https://www.intensivregister.de/api/public/reporting/laendertabelle
1686163715,-1,-1,-1,-1,-1,https://www.intensivregister.de/api/public/reporting/laendertabelle
1686164715,683,522,161,3,0,https://www.intensivregister.de/api/public/reporting/laendertabelle
1686175515,683,525,158,3,0,https://www.intensivregister.de/api/public/reporting/laendertabelle
1686189915,687,530,157,3,0,https://www.intensivregister.de/api/public/reporting/laendertabelle
1686193515,687,534,153,4,0,https://www.intensivregister.de/api/public/reporting/laendertabelle
1686197115,688,536,152,5,0,https://www.intensivregister.de/api/public/reporting/laendertabelle
1686200715,684,533,151,5,0,https://www.intensivregister.de/api/public/reporting/laendertabelle
1686207915,684,531,153,5,0,https://www.intensivregister.de/api/public/reporting/laendertabelle
1686211516,684,533,151,5,0,https://www.intensivregister.de/api/public/reporting/laendertabelle
1686258315,684,535,149,5,0,https://www.intensivregister.de/api/public/reporting/laendertabelle
1686261915,684,536,148,5,0,https://www.intensivregister.de/api/public/reporting/laendertabelle
1686265516,684,537,147,5,0,https://www.intensivregister.de/api/public/reporting/laendertabelle
1686272714,684,540,144,5,0,https://www.intensivregister.de/api/public/reporting/laendertabelle
1686276315,684,541,143,5,0,https://www.intensivregister.de/api/public/reporting/laendertabelle
1686279926,685,557,128,5,0,https://www.intensivregister.de/api/public/reporting/laendertabelle
1686283517,685,554,131,5,0,https://www.intensivregister.de/api/public/reporting/laendertabelle
1686287117,683,548,135,5,0,https://www.intensivregister.de/api/public/reporting/laendertabelle
1686297916,683,551,132,5,0,https://www.intensivregister.de/api/public/reporting/laendertabelle
1686344715,683,550,133,5,0,https://www.intensivregister.de/api/public/reporting/laendertabelle
1686355515,683,553,130,5,0,https://www.intensivregister.de/api/public/reporting/laendertabelle
1686366315,681,550,131,5,0,https://www.intensivregister.de/api/public/reporting/laendertabelle
1686369915,681,541,140,5,0,https://www.intensivregister.de/api/public/reporting/laendertabelle
1686373515,681,539,142,6,0,https://www.intensivregister.de/api/public/reporting/laendertabelle
1686377115,682,540,142,5,0,https://www.intensivregister.de/api/public/reporting/laendertabelle
1686380715,682,536,146,5,0,https://www.intensivregister.de/api/public/reporting/laendertabelle
1686431115,679,535,144,5,0,https://www.intensivregister.de/api/public/reporting/laendertabelle
1686434715,679,533,146,5,0,https://www.intensivregister.de/api/public/reporting/laendertabelle
1686452715,679,529,150,5,0,https://www.intensivregister.de/api/public/reporting/laendertabelle
1686456315,679,531,148,5,0,https://www.intensivregister.de/api/public/reporting/laendertabelle
1686459915,675,526,149,5,0,https://www.intensivregister.de/api/public/reporting/laendertabelle
1686463515,675,522,153,5,0,https://www.intensivregister.de/api/public/reporting/laendertabelle
1686467115,675,523,152,5,0,https://www.intensivregister.de/api/public/reporting/laendertabelle
1686517515,675,524,151,5,0,https://www.intensivregister.de/api/public/reporting/laendertabelle
1686539115,675,515,160,6,0,https://www.intensivregister.de/api/public/reporting/laendertabelle
1686542716,675,511,164,6,0,https://www.intensivregister.de/api/public/reporting/laendertabelle
1686546315,668,490,178,6,0,https://www.intensivregister.de/api/public/reporting/laendertabelle
1686549915,668,493,175,6,0,https://www.intensivregister.de/api/public/reporting/laendertabelle
1686553516,668,497,171,6,0,https://www.intensivregister.de/api/public/reporting/laendertabelle
1686560716,672,506,166,6,0,https://www.intensivregister.de/api/public/reporting/laendertabelle
1686603915,672,510,162,6,0,https://www.intensivregister.de/api/public/reporting/laendertabelle
1686621915,684,525,159,6,0,https://www.intensivregister.de/api/public/reporting/laendertabelle
1686625515,689,548,141,6,0,https://www.intensivregister.de/api/public/reporting/laendertabelle
1686629115,689,551,138,6,0,https://www.intensivregister.de/api/public/reporting/laendertabelle
1686632715,689,553,136,6,0,https://www.intensivregister.de/api/public/reporting/laendertabelle
1686639916,689,554,135,6,0,https://www.intensivregister.de/api/public/reporting/laendertabelle
1686643516,689,558,131,6,0,https://www.intensivregister.de/api/public/reporting/laendertabelle
1686690315,689,559,130,6,0,https://www.intensivregister.de/api/public/reporting/laendertabelle
1686701115,689,558,131,6,0,https://www.intensivregister.de/api/public/reporting/laendertabelle
1686708315,689,559,130,6,0,https://www.intensivregister.de/api/public/reporting/laendertabelle
1686711915,689,562,127,4,0,https://www.intensivregister.de/api/public/reporting/laendertabelle
1686715515,689,566,123,4,0,https://www.intensivregister.de/api/public/reporting/laendertabelle
1686719115,687,570,117,4,0,https://www.intensivregister.de/api/public/reporting/laendertabelle
1686722715,687,569,118,4,0,https://www.intensivregister.de/api/public/reporting/laendertabelle
1686794716,687,570,117,4,0,https://www.intensivregister.de/api/public/reporting/laendertabelle
1686798316,685,564,121,4,0,https://www.intensivregister.de/api/public/reporting/laendertabelle
1686801916,687,567,120,4,0,https://www.intensivregister.de/api/public/reporting/laendertabelle
1686805516,685,565,120,4,0,https://www.intensivregister.de/api/public/reporting/laendertabelle
1686812716,685,566,119,4,0,https://www.intensivregister.de/api/public/reporting/laendertabelle
1686816316,685,564,121,4,0,https://www.intensivregister.de/api/public/reporting/laendertabelle
1686819916,685,565,120,4,0,https://www.intensivregister.de/api/public/reporting/laendertabelle
1686863115,685,562,123,4,0,https://www.intensivregister.de/api/public/reporting/laendertabelle
1686866715,685,565,120,4,0,https://www.intensivregister.de/api/public/reporting/laendertabelle
1686870315,685,566,119,4,0,https://www.intensivregister.de/api/public/reporting/laendertabelle
1686877519,685,563,122,4,0,https://www.intensivregister.de/api/public/reporting/laendertabelle
1686881121,685,564,121,4,0,https://www.intensivregister.de/api/public/reporting/laendertabelle
1686884728,689,565,124,4,0,https://www.intensivregister.de/api/public/reporting/laendertabelle
1686888324,688,558,130,4,0,https://www.intensivregister.de/api/public/reporting/laendertabelle
1686891916,688,556,132,4,0,https://www.intensivregister.de/api/public/reporting/laendertabelle
1686949516,688,555,133,4,0,https://www.intensivregister.de/api/public/reporting/laendertabelle
1686953115,690,558,132,4,0,https://www.intensivregister.de/api/public/reporting/laendertabelle
1686967515,690,565,125,4,0,https://www.intensivregister.de/api/public/reporting/laendertabelle
1686971115,690,566,124,4,0,https://www.intensivregister.de/api/public/reporting/laendertabelle
1686974715,682,547,135,3,0,https://www.intensivregister.de/api/public/reporting/laendertabelle
1686978315,680,537,143,3,1,https://www.intensivregister.de/api/public/reporting/laendertabelle
1686981915,680,536,144,4,1,https://www.intensivregister.de/api/public/reporting/laendertabelle
1686989115,680,537,143,3,1,https://www.intensivregister.de/api/public/reporting/laendertabelle
1687046715,680,535,145,3,1,https://www.intensivregister.de/api/public/reporting/laendertabelle
1687053914,680,536,144,3,1,https://www.intensivregister.de/api/public/reporting/laendertabelle
1687057515,680,528,152,3,1,https://www.intensivregister.de/api/public/reporting/laendertabelle
1687061115,680,522,158,3,1,https://www.intensivregister.de/api/public/reporting/laendertabelle
1687064715,679,524,155,3,1,https://www.intensivregister.de/api/public/reporting/laendertabelle
1687068315,679,522,157,3,1,https://www.intensivregister.de/api/public/reporting/laendertabelle
1687071915,678,517,161,3,1,https://www.intensivregister.de/api/public/reporting/laendertabelle
1687075515,675,508,167,3,1,https://www.intensivregister.de/api/public/reporting/laendertabelle
1687125915,675,509,166,3,1,https://www.intensivregister.de/api/public/reporting/laendertabelle
1687136715,675,508,167,3,1,https://www.intensivregister.de/api/public/reporting/laendertabelle
1687140316,675,513,162,3,1,https://www.intensivregister.de/api/public/reporting/laendertabelle
1687143916,673,514,159,3,1,https://www.intensivregister.de/api/public/reporting/laendertabelle
1687147515,672,519,153,2,1,https://www.intensivregister.de/api/public/reporting/laendertabelle
1687151115,672,520,152,2,1,https://www.intensivregister.de/api/public/reporting/laendertabelle
1687154716,672,521,151,2,1,https://www.intensivregister.de/api/public/reporting/laendertabelle
1687158316,672,519,153,1,0,https://www.intensivregister.de/api/public/reporting/laendertabelle
1687223115,672,523,149,1,0,https://www.intensivregister.de/api/public/reporting/laendertabelle
1687226715,672,526,146,1,0,https://www.intensivregister.de/api/public/reporting/laendertabelle
1687230315,674,530,144,2,0,https://www.intensivregister.de/api/public/reporting/laendertabelle
1687233915,680,534,146,3,0,https://www.intensivregister.de/api/public/reporting/laendertabelle
1687237515,682,542,140,3,0,https://www.intensivregister.de/api/public/reporting/laendertabelle
1687241115,682,544,138,3,0,https://www.intensivregister.de/api/public/reporting/laendertabelle
1687244715,682,546,136,3,0,https://www.intensivregister.de/api/public/reporting/laendertabelle
1687295114,682,547,135,3,0,https://www.intensivregister.de/api/public/reporting/laendertabelle
1687313114,682,546,136,3,0,https://www.intensivregister.de/api/public/reporting/laendertabelle
1687316715,687,566,121,3,1,https://www.intensivregister.de/api/public/reporting/laendertabelle
1687320315,689,561,128,3,1,https://www.intensivregister.de/api/public/reporting/laendertabelle
1687331115,689,563,126,5,1,https://www.intensivregister.de/api/public/reporting/laendertabelle
1687334715,690,564,126,5,1,https://www.intensivregister.de/api/public/reporting/laendertabelle
1687399515,690,560,130,5,1,https://www.intensivregister.de/api/public/reporting/laendertabelle
1687403116,683,540,143,5,1,https://www.intensivregister.de/api/public/reporting/laendertabelle
1687406715,683,537,146,5,1,https://www.intensivregister.de/api/public/reporting/laendertabelle
1687410315,683,534,149,5,1,https://www.intensivregister.de/api/public/reporting/laendertabelle
1687413915,683,533,150,5,1,https://www.intensivregister.de/api/public/reporting/laendertabelle
1687417515,683,534,149,5,1,https://www.intensivregister.de/api/public/reporting/laendertabelle
1687467914,683,537,146,5,1,https://www.intensivregister.de/api/public/reporting/laendertabelle
1687482315,683,534,149,5,1,https://www.intensivregister.de/api/public/reporting/laendertabelle
1687485915,683,533,150,5,1,https://www.intensivregister.de/api/public/reporting/laendertabelle
1687489515,684,530,154,5,1,https://www.intensivregister.de/api/public/reporting/laendertabelle
1687493115,682,524,158,4,1,https://www.intensivregister.de/api/public/reporting/laendertabelle
1687496715,682,526,156,4,1,https://www.intensivregister.de/api/public/reporting/laendertabelle
1687500315,682,529,153,4,1,https://www.intensivregister.de/api/public/reporting/laendertabelle
1687503926,682,529,153,3,1,https://www.intensivregister.de/api/public/reporting/laendertabelle
1687554315,682,533,149,3,1,https://www.intensivregister.de/api/public/reporting/laendertabelle
1687572315,682,532,150,3,1,https://www.intensivregister.de/api/public/reporting/laendertabelle
1687579515,683,521,162,3,1,https://www.intensivregister.de/api/public/reporting/laendertabelle
1687583115,683,519,164,2,0,https://www.intensivregister.de/api/public/reporting/laendertabelle
1687586715,678,522,156,2,0,https://www.intensivregister.de/api/public/reporting/laendertabelle
1687593915,678,524,154,2,0,https://www.intensivregister.de/api/public/reporting/laendertabelle
1687615515,678,526,152,2,0,https://www.intensivregister.de/api/public/reporting/laendertabelle
1687640714,678,523,155,2,0,https://www.intensivregister.de/api/public/reporting/laendertabelle
1687644315,678,520,158,2,0,https://www.intensivregister.de/api/public/reporting/laendertabelle
1687662315,678,524,154,2,0,https://www.intensivregister.de/api/public/reporting/laendertabelle
1687665916,674,522,152,2,0,https://www.intensivregister.de/api/public/reporting/laendertabelle
1687669515,674,519,155,2,0,https://www.intensivregister.de/api/public/reporting/laendertabelle
1687673115,669,508,161,3,1,https://www.intensivregister.de/api/public/reporting/laendertabelle
1687687515,669,507,162,3,1,https://www.intensivregister.de/api/public/reporting/laendertabelle
1687727116,669,510,159,3,1,https://www.intensivregister.de/api/public/reporting/laendertabelle
1687734315,669,512,157,3,1,https://www.intensivregister.de/api/public/reporting/laendertabelle
1687745115,669,514,155,3,1,https://www.intensivregister.de/api/public/reporting/laendertabelle
1687748715,673,518,155,3,1,https://www.intensivregister.de/api/public/reporting/laendertabelle
1687752318,675,519,156,3,1,https://www.intensivregister.de/api/public/reporting/laendertabelle
1687755917,675,517,158,3,1,https://www.intensivregister.de/api/public/reporting/laendertabelle
1687766715,681,527,154,4,1,https://www.intensivregister.de/api/public/reporting/laendertabelle
1687773916,681,529,152,4,1,https://www.intensivregister.de/api/public/reporting/laendertabelle
1687809916,681,531,150,4,1,https://www.intensivregister.de/api/public/reporting/laendertabelle
1687813516,681,530,151,4,1,https://www.intensivregister.de/api/public/reporting/laendertabelle
1687831516,681,533,148,4,1,https://www.intensivregister.de/api/public/reporting/laendertabelle
1687835115,685,540,145,4,1,https://www.intensivregister.de/api/public/reporting/laendertabelle
1687838715,685,545,140,4,1,https://www.intensivregister.de/api/public/reporting/laendertabelle
1687842315,685,542,143,4,1,https://www.intensivregister.de/api/public/reporting/laendertabelle
1687849518,685,543,142,4,1,https://www.intensivregister.de/api/public/reporting/laendertabelle
1687899916,685,542,143,4,1,https://www.intensivregister.de/api/public/reporting/laendertabelle
1687907116,685,541,144,4,1,https://www.intensivregister.de/api/public/reporting/laendertabelle
1687910716,685,543,142,4,1,https://www.intensivregister.de/api/public/reporting/laendertabelle
1687917916,685,545,140,4,1,https://www.intensivregister.de/api/public/reporting/laendertabelle
1687921516,684,548,136,4,1,https://www.intensivregister.de/api/public/reporting/laendertabelle
1687925116,684,550,134,4,1,https://www.intensivregister.de/api/public/reporting/laendertabelle
1687928716,684,555,129,4,1,https://www.intensivregister.de/api/public/reporting/laendertabelle
1687932317,684,553,131,4,1,https://www.intensivregister.de/api/public/reporting/laendertabelle
1687989917,684,552,132,4,1,https://www.intensivregister.de/api/public/reporting/laendertabelle
1688004316,684,548,136,4,1,https://www.intensivregister.de/api/public/reporting/laendertabelle
1688007917,684,543,141,4,1,https://www.intensivregister.de/api/public/reporting/laendertabelle
1688011516,684,542,142,4,1,https://www.intensivregister.de/api/public/reporting/laendertabelle
1688094317,684,538,146,4,1,https://www.intensivregister.de/api/public/reporting/laendertabelle
1688097917,687,537,150,4,1,https://www.intensivregister.de/api/public/reporting/laendertabelle
1688101517,687,539,148,4,1,https://www.intensivregister.de/api/public/reporting/laendertabelle
1688105117,687,540,147,4,1,https://www.intensivregister.de/api/public/reporting/laendertabelle
1688108720,689,541,148,4,1,https://www.intensivregister.de/api/public/reporting/laendertabelle
1688112317,689,545,144,4,1,https://www.intensivregister.de/api/public/reporting/laendertabelle
1688155517,689,544,145,4,1,https://www.intensivregister.de/api/public/reporting/laendertabelle
1688159117,689,546,143,4,1,https://www.intensivregister.de/api/public/reporting/laendertabelle
1688177116,689,543,146,4,1,https://www.intensivregister.de/api/public/reporting/laendertabelle
1688180717,689,538,151,4,1,https://www.intensivregister.de/api/public/reporting/laendertabelle
1688184317,688,530,158,4,1,https://www.intensivregister.de/api/public/reporting/laendertabelle
1688187917,675,513,162,3,1,https://www.intensivregister.de/api/public/reporting/laendertabelle
1688191517,675,509,166,3,1,https://www.intensivregister.de/api/public/reporting/laendertabelle
1688198717,674,510,164,3,1,https://www.intensivregister.de/api/public/reporting/laendertabelle
1688245516,674,502,172,3,1,https://www.intensivregister.de/api/public/reporting/laendertabelle
1688267117,674,498,176,3,1,https://www.intensivregister.de/api/public/reporting/laendertabelle
1688270717,673,499,174,3,1,https://www.intensivregister.de/api/public/reporting/laendertabelle
1688277917,673,500,173,3,1,https://www.intensivregister.de/api/public/reporting/laendertabelle
1688328317,673,501,172,3,1,https://www.intensivregister.de/api/public/reporting/laendertabelle
1688335516,673,500,173,3,1,https://www.intensivregister.de/api/public/reporting/laendertabelle
1688349916,673,501,172,3,1,https://www.intensivregister.de/api/public/reporting/laendertabelle
1688353517,674,514,160,3,1,https://www.intensivregister.de/api/public/reporting/laendertabelle
1688357117,677,507,170,3,1,https://www.intensivregister.de/api/public/reporting/laendertabelle
1688360717,677,503,174,3,1,https://www.intensivregister.de/api/public/reporting/laendertabelle
1688364317,679,503,176,3,1,https://www.intensivregister.de/api/public/reporting/laendertabelle
1688421917,679,507,172,3,1,https://www.intensivregister.de/api/public/reporting/laendertabelle
1688425517,679,506,173,3,1,https://www.intensivregister.de/api/public/reporting/laendertabelle
1688436317,680,508,172,3,1,https://www.intensivregister.de/api/public/reporting/laendertabelle
1688439916,680,515,165,3,1,https://www.intensivregister.de/api/public/reporting/laendertabelle
1688443517,680,518,162,3,1,https://www.intensivregister.de/api/public/reporting/laendertabelle
1688447116,678,527,151,4,1,https://www.intensivregister.de/api/public/reporting/laendertabelle
1688504717,677,527,150,4,1,https://www.intensivregister.de/api/public/reporting/laendertabelle
1688508317,677,529,148,4,1,https://www.intensivregister.de/api/public/reporting/laendertabelle
1688522717,676,530,146,4,1,https://www.intensivregister.de/api/public/reporting/laendertabelle
1688526317,678,542,136,4,1,https://www.intensivregister.de/api/public/reporting/laendertabelle
1688529917,685,541,144,4,1,https://www.intensivregister.de/api/public/reporting/laendertabelle
1688533517,685,539,146,4,1,https://www.intensivregister.de/api/public/reporting/laendertabelle
1688540718,685,537,148,4,1,https://www.intensivregister.de/api/public/reporting/laendertabelle
1688591116,685,536,149,4,1,https://www.intensivregister.de/api/public/reporting/laendertabelle
1688601916,686,537,149,4,1,https://www.intensivregister.de/api/public/reporting/laendertabelle
1688609116,687,537,150,4,1,https://www.intensivregister.de/api/public/reporting/laendertabelle
1688612717,681,541,140,4,0,https://www.intensivregister.de/api/public/reporting/laendertabelle
1688616317,681,543,138,4,0,https://www.intensivregister.de/api/public/reporting/laendertabelle
1688619917,681,542,139,5,0,https://www.intensivregister.de/api/public/reporting/laendertabelle
1688627117,681,544,137,5,0,https://www.intensivregister.de/api/public/reporting/laendertabelle
1688677517,681,540,141,5,0,https://www.intensivregister.de/api/public/reporting/laendertabelle
1688681117,681,538,143,5,0,https://www.intensivregister.de/api/public/reporting/laendertabelle
1688699117,681,541,140,4,0,https://www.intensivregister.de/api/public/reporting/laendertabelle
1688706316,681,542,139,3,0,https://www.intensivregister.de/api/public/reporting/laendertabelle
1688709917,677,540,137,3,0,https://www.intensivregister.de/api/public/reporting/laendertabelle
1688713516,677,544,133,3,0,https://www.intensivregister.de/api/public/reporting/laendertabelle
1688720717,678,543,135,3,0,https://www.intensivregister.de/api/public/reporting/laendertabelle
1688763927,678,544,134,3,0,https://www.intensivregister.de/api/public/reporting/laendertabelle
1688778317,678,542,136,3,0,https://www.intensivregister.de/api/public/reporting/laendertabelle
1688785517,678,543,135,3,0,https://www.intensivregister.de/api/public/reporting/laendertabelle
1688789117,677,543,134,3,0,https://www.intensivregister.de/api/public/reporting/laendertabelle
1688792717,675,539,136,3,0,https://www.intensivregister.de/api/public/reporting/laendertabelle
1688796317,675,536,139,2,0,https://www.intensivregister.de/api/public/reporting/laendertabelle
1688850316,674,531,143,2,0,https://www.intensivregister.de/api/public/reporting/laendertabelle
1688871917,674,525,149,2,0,https://www.intensivregister.de/api/public/reporting/laendertabelle
1688875517,674,503,171,2,0,https://www.intensivregister.de/api/public/reporting/laendertabelle
1688879117,674,490,184,2,0,https://www.intensivregister.de/api/public/reporting/laendertabelle
1688882717,674,487,187,2,0,https://www.intensivregister.de/api/public/reporting/laendertabelle
1688889917,674,485,189,2,0,https://www.intensivregister.de/api/public/reporting/laendertabelle
1688893519,674,484,190,2,0,https://www.intensivregister.de/api/public/reporting/laendertabelle
1688925917,674,482,192,2,0,https://www.intensivregister.de/api/public/reporting/laendertabelle
1688936717,674,481,193,2,0,https://www.intensivregister.de/api/public/reporting/laendertabelle
1688940317,674,482,192,2,0,https://www.intensivregister.de/api/public/reporting/laendertabelle
1688954717,674,481,193,2,0,https://www.intensivregister.de/api/public/reporting/laendertabelle
1688958317,674,484,190,2,0,https://www.intensivregister.de/api/public/reporting/laendertabelle
1688961917,660,482,178,2,0,https://www.intensivregister.de/api/public/reporting/laendertabelle
1688965517,660,483,177,2,0,https://www.intensivregister.de/api/public/reporting/laendertabelle
1688969117,660,484,176,2,0,https://www.intensivregister.de/api/public/reporting/laendertabelle
1688972718,662,486,176,2,0,https://www.intensivregister.de/api/public/reporting/laendertabelle
1689019516,663,487,176,2,0,https://www.intensivregister.de/api/public/reporting/laendertabelle
1689023116,663,490,173,2,0,https://www.intensivregister.de/api/public/reporting/laendertabelle
1689030316,663,493,170,2,0,https://www.intensivregister.de/api/public/reporting/laendertabelle
1689041116,666,498,168,2,0,https://www.intensivregister.de/api/public/reporting/laendertabelle
1689044717,676,528,148,2,0,https://www.intensivregister.de/api/public/reporting/laendertabelle
1689048316,676,533,143,2,0,https://www.intensivregister.de/api/public/reporting/laendertabelle
1689051916,676,536,140,2,0,https://www.intensivregister.de/api/public/reporting/laendertabelle
1689055517,676,537,139,2,0,https://www.intensivregister.de/api/public/reporting/laendertabelle
1689109517,676,536,140,2,0,https://www.intensivregister.de/api/public/reporting/laendertabelle
1689123917,676,533,143,2,0,https://www.intensivregister.de/api/public/reporting/laendertabelle
1689127516,675,533,142,2,0,https://www.intensivregister.de/api/public/reporting/laendertabelle
1689131116,675,542,133,2,0,https://www.intensivregister.de/api/public/reporting/laendertabelle
1689134716,679,543,136,2,0,https://www.intensivregister.de/api/public/reporting/laendertabelle
1689138316,680,546,134,2,0,https://www.intensivregister.de/api/public/reporting/laendertabelle
1689195916,680,548,132,2,0,https://www.intensivregister.de/api/public/reporting/laendertabelle
1689213916,681,552,129,2,0,https://www.intensivregister.de/api/public/reporting/laendertabelle
1689217516,681,551,130,2,0,https://www.intensivregister.de/api/public/reporting/laendertabelle
1689221117,680,546,134,2,0,https://www.intensivregister.de/api/public/reporting/laendertabelle
1689224717,680,547,133,2,0,https://www.intensivregister.de/api/public/reporting/laendertabelle
1689253516,680,548,132,2,0,https://www.intensivregister.de/api/public/reporting/laendertabelle
1689282316,680,549,131,2,0,https://www.intensivregister.de/api/public/reporting/laendertabelle
1689300316,675,542,133,2,0,https://www.intensivregister.de/api/public/reporting/laendertabelle
1689303917,676,554,122,2,0,https://www.intensivregister.de/api/public/reporting/laendertabelle
1689307527,678,555,123,2,0,https://www.intensivregister.de/api/public/reporting/laendertabelle
1689311116,678,556,122,2,0,https://www.intensivregister.de/api/public/reporting/laendertabelle
1689314716,678,555,123,2,0,https://www.intensivregister.de/api/public/reporting/laendertabelle
1689318316,680,554,126,2,0,https://www.intensivregister.de/api/public/reporting/laendertabelle
1689368717,680,548,132,2,0,https://www.intensivregister.de/api/public/reporting/laendertabelle
1689375916,680,549,131,2,0,https://www.intensivregister.de/api/public/reporting/laendertabelle
1689379516,680,546,134,2,0,https://www.intensivregister.de/api/public/reporting/laendertabelle
1689390316,680,543,137,2,0,https://www.intensivregister.de/api/public/reporting/laendertabelle
1689393917,680,540,140,2,0,https://www.intensivregister.de/api/public/reporting/laendertabelle
1689397517,676,533,143,2,0,https://www.intensivregister.de/api/public/reporting/laendertabelle
1689401116,676,526,150,2,0,https://www.intensivregister.de/api/public/reporting/laendertabelle
1689404717,676,525,151,2,0,https://www.intensivregister.de/api/public/reporting/laendertabelle
1689455117,676,526,150,2,0,https://www.intensivregister.de/api/public/reporting/laendertabelle
1689476717,676,523,153,2,0,https://www.intensivregister.de/api/public/reporting/laendertabelle
1689480317,674,517,157,2,0,https://www.intensivregister.de/api/public/reporting/laendertabelle
1689483916,663,504,159,3,0,https://www.intensivregister.de/api/public/reporting/laendertabelle
1689487516,663,502,161,3,0,https://www.intensivregister.de/api/public/reporting/laendertabelle
1689491117,662,499,163,3,0,https://www.intensivregister.de/api/public/reporting/laendertabelle
1689541516,662,502,160,3,0,https://www.intensivregister.de/api/public/reporting/laendertabelle
1689545117,662,503,159,3,0,https://www.intensivregister.de/api/public/reporting/laendertabelle
1689559516,662,501,161,3,0,https://www.intensivregister.de/api/public/reporting/laendertabelle
1689563117,661,509,152,3,0,https://www.intensivregister.de/api/public/reporting/laendertabelle
1689566717,662,503,159,3,0,https://www.intensivregister.de/api/public/reporting/laendertabelle
1689570317,658,507,151,3,0,https://www.intensivregister.de/api/public/reporting/laendertabelle
1689573917,658,508,150,3,0,https://www.intensivregister.de/api/public/reporting/laendertabelle
1689627916,658,512,146,3,0,https://www.intensivregister.de/api/public/reporting/laendertabelle
1689631516,658,511,147,3,0,https://www.intensivregister.de/api/public/reporting/laendertabelle
1689649516,668,530,138,3,0,https://www.intensivregister.de/api/public/reporting/laendertabelle
1689653116,668,542,126,3,0,https://www.intensivregister.de/api/public/reporting/laendertabelle
1689656718,668,541,127,3,0,https://www.intensivregister.de/api/public/reporting/laendertabelle
1689660319,670,540,130,3,0,https://www.intensivregister.de/api/public/reporting/laendertabelle
1689663917,670,541,129,3,0,https://www.intensivregister.de/api/public/reporting/laendertabelle
1689667517,671,540,131,3,0,https://www.intensivregister.de/api/public/reporting/laendertabelle
1689714317,671,538,133,3,0,https://www.intensivregister.de/api/public/reporting/laendertabelle
1689717917,671,543,128,3,0,https://www.intensivregister.de/api/public/reporting/laendertabelle
1689732317,671,547,124,3,0,https://www.intensivregister.de/api/public/reporting/laendertabelle
1689735917,673,546,127,3,0,https://www.intensivregister.de/api/public/reporting/laendertabelle
1689739517,670,538,132,3,0,https://www.intensivregister.de/api/public/reporting/laendertabelle
1689743118,672,543,129,3,0,https://www.intensivregister.de/api/public/reporting/laendertabelle
1689746718,672,544,128,4,0,https://www.intensivregister.de/api/public/reporting/laendertabelle
1689800717,672,543,129,4,0,https://www.intensivregister.de/api/public/reporting/laendertabelle
1689804317,672,540,132,4,0,https://www.intensivregister.de/api/public/reporting/laendertabelle
1689822317,673,539,134,4,0,https://www.intensivregister.de/api/public/reporting/laendertabelle
1689825918,673,542,131,4,0,https://www.intensivregister.de/api/public/reporting/laendertabelle
1689829518,673,541,132,4,0,https://www.intensivregister.de/api/public/reporting/laendertabelle
1689833118,673,541,132,3,0,https://www.intensivregister.de/api/public/reporting/laendertabelle
1689897918,673,543,130,3,0,https://www.intensivregister.de/api/public/reporting/laendertabelle
1689905117,673,544,129,3,0,https://www.intensivregister.de/api/public/reporting/laendertabelle
1689908717,672,547,125,3,0,https://www.intensivregister.de/api/public/reporting/laendertabelle
1689912318,670,547,123,2,0,https://www.intensivregister.de/api/public/reporting/laendertabelle
1689915918,669,548,121,2,0,https://www.intensivregister.de/api/public/reporting/laendertabelle
1689919518,669,550,119,2,0,https://www.intensivregister.de/api/public/reporting/laendertabelle
1689973518,649,530,119,2,0,https://www.intensivregister.de/api/public/reporting/laendertabelle
1689977117,649,527,122,2,0,https://www.intensivregister.de/api/public/reporting/laendertabelle
1689995117,644,515,129,2,0,https://www.intensivregister.de/api/public/reporting/laendertabelle
1689998717,647,511,136,2,0,https://www.intensivregister.de/api/public/reporting/laendertabelle
1690002317,647,505,142,2,0,https://www.intensivregister.de/api/public/reporting/laendertabelle
1690005917,647,504,143,2,0,https://www.intensivregister.de/api/public/reporting/laendertabelle
1690009517,647,500,147,2,0,https://www.intensivregister.de/api/public/reporting/laendertabelle
1690020317,647,498,149,2,0,https://www.intensivregister.de/api/public/reporting/laendertabelle
1690059917,647,499,148,2,0,https://www.intensivregister.de/api/public/reporting/laendertabelle
1690081517,648,499,149,2,0,https://www.intensivregister.de/api/public/reporting/laendertabelle
1690085117,666,514,152,2,0,https://www.intensivregister.de/api/public/reporting/laendertabelle
1690088717,666,512,154,2,0,https://www.intensivregister.de/api/public/reporting/laendertabelle
1690092317,666,507,159,2,0,https://www.intensivregister.de/api/public/reporting/laendertabelle
1690095917,666,508,158,2,0,https://www.intensivregister.de/api/public/reporting/laendertabelle
1690099517,665,511,154,2,0,https://www.intensivregister.de/api/public/reporting/laendertabelle
1690149917,665,508,157,2,0,https://www.intensivregister.de/api/public/reporting/laendertabelle
1690164317,665,502,163,2,0,https://www.intensivregister.de/api/public/reporting/laendertabelle
1690167918,665,510,155,3,0,https://www.intensivregister.de/api/public/reporting/laendertabelle
1690171518,662,510,152,3,0,https://www.intensivregister.de/api/public/reporting/laendertabelle
1690175117,662,506,156,3,0,https://www.intensivregister.de/api/public/reporting/laendertabelle
1690178718,665,507,158,3,0,https://www.intensivregister.de/api/public/reporting/laendertabelle
1690232716,665,509,156,3,0,https://www.intensivregister.de/api/public/reporting/laendertabelle
1690250717,653,509,144,3,0,https://www.intensivregister.de/api/public/reporting/laendertabelle
1690254317,642,503,139,3,0,https://www.intensivregister.de/api/public/reporting/laendertabelle
1690257917,647,508,139,2,0,https://www.intensivregister.de/api/public/reporting/laendertabelle
1690261516,647,518,129,2,0,https://www.intensivregister.de/api/public/reporting/laendertabelle
1690268716,647,519,128,2,0,https://www.intensivregister.de/api/public/reporting/laendertabelle
1690319117,647,520,127,2,0,https://www.intensivregister.de/api/public/reporting/laendertabelle
1690340717,666,547,119,2,0,https://www.intensivregister.de/api/public/reporting/laendertabelle
1690344317,666,543,123,2,0,https://www.intensivregister.de/api/public/reporting/laendertabelle
1690351517,666,544,122,2,0,https://www.intensivregister.de/api/public/reporting/laendertabelle
1690405517,666,546,120,2,0,https://www.intensivregister.de/api/public/reporting/laendertabelle
1690409116,666,545,121,2,0,https://www.intensivregister.de/api/public/reporting/laendertabelle
1690412717,666,544,122,2,0,https://www.intensivregister.de/api/public/reporting/laendertabelle
1690423517,666,543,123,2,0,https://www.intensivregister.de/api/public/reporting/laendertabelle
1690427117,660,536,124,2,0,https://www.intensivregister.de/api/public/reporting/laendertabelle
1690430717,660,545,115,2,0,https://www.intensivregister.de/api/public/reporting/laendertabelle
1690434317,660,543,117,2,0,https://www.intensivregister.de/api/public/reporting/laendertabelle
1690491917,661,544,117,2,0,https://www.intensivregister.de/api/public/reporting/laendertabelle
1690513516,665,536,129,2,0,https://www.intensivregister.de/api/public/reporting/laendertabelle
1690517117,663,534,129,2,0,https://www.intensivregister.de/api/public/reporting/laendertabelle
1690520716,663,532,131,2,0,https://www.intensivregister.de/api/public/reporting/laendertabelle
1690524316,661,532,129,1,0,https://www.intensivregister.de/api/public/reporting/laendertabelle
1690574717,661,531,130,1,0,https://www.intensivregister.de/api/public/reporting/laendertabelle
1690596316,661,528,133,1,0,https://www.intensivregister.de/api/public/reporting/laendertabelle
1690599917,661,529,132,1,0,https://www.intensivregister.de/api/public/reporting/laendertabelle
1690603517,655,515,140,1,0,https://www.intensivregister.de/api/public/reporting/laendertabelle
1690607116,654,514,140,1,0,https://www.intensivregister.de/api/public/reporting/laendertabelle
1690610717,649,510,139,1,0,https://www.intensivregister.de/api/public/reporting/laendertabelle
1690614316,643,508,135,1,0,https://www.intensivregister.de/api/public/reporting/laendertabelle
1690617916,644,509,135,1,0,https://www.intensivregister.de/api/public/reporting/laendertabelle
1690661117,645,509,136,1,0,https://www.intensivregister.de/api/public/reporting/laendertabelle
1690664717,645,514,131,1,0,https://www.intensivregister.de/api/public/reporting/laendertabelle
1690675516,645,512,133,1,0,https://www.intensivregister.de/api/public/reporting/laendertabelle
1690682717,645,511,134,1,0,https://www.intensivregister.de/api/public/reporting/laendertabelle
1690689916,643,502,141,1,0,https://www.intensivregister.de/api/public/reporting/laendertabelle
1690693516,643,492,151,1,0,https://www.intensivregister.de/api/public/reporting/laendertabelle
1690700716,643,486,157,1,0,https://www.intensivregister.de/api/public/reporting/laendertabelle
1690707928,643,483,160,1,0,https://www.intensivregister.de/api/public/reporting/laendertabelle
1690751116,642,480,162,1,0,https://www.intensivregister.de/api/public/reporting/laendertabelle
1690769116,642,483,159,1,0,https://www.intensivregister.de/api/public/reporting/laendertabelle
1690772717,648,488,160,1,0,https://www.intensivregister.de/api/public/reporting/laendertabelle
1690776317,651,491,160,1,0,https://www.intensivregister.de/api/public/reporting/laendertabelle
1690779917,651,490,161,1,0,https://www.intensivregister.de/api/public/reporting/laendertabelle
1690787117,651,492,159,1,0,https://www.intensivregister.de/api/public/reporting/laendertabelle
1690833916,651,491,160,1,0,https://www.intensivregister.de/api/public/reporting/laendertabelle
1690837517,651,492,159,1,0,https://www.intensivregister.de/api/public/reporting/laendertabelle
1690841116,651,494,157,1,0,https://www.intensivregister.de/api/public/reporting/laendertabelle
1690855516,651,497,154,1,0,https://www.intensivregister.de/api/public/reporting/laendertabelle
1690859117,652,501,151,1,0,https://www.intensivregister.de/api/public/reporting/laendertabelle
1690862716,655,513,142,1,0,https://www.intensivregister.de/api/public/reporting/laendertabelle
1690866317,655,512,143,1,0,https://www.intensivregister.de/api/public/reporting/laendertabelle
1690869917,655,513,142,1,0,https://www.intensivregister.de/api/public/reporting/laendertabelle
1690880717,656,514,142,1,0,https://www.intensivregister.de/api/public/reporting/laendertabelle
1690923917,656,515,141,1,0,https://www.intensivregister.de/api/public/reporting/laendertabelle
1690931117,656,518,138,1,0,https://www.intensivregister.de/api/public/reporting/laendertabelle
1690945517,661,531,130,1,0,https://www.intensivregister.de/api/public/reporting/laendertabelle
1690949116,662,533,129,1,0,https://www.intensivregister.de/api/public/reporting/laendertabelle
1690952717,662,535,127,1,0,https://www.intensivregister.de/api/public/reporting/laendertabelle
1690963517,662,533,129,1,0,https://www.intensivregister.de/api/public/reporting/laendertabelle
1691013916,650,532,118,1,0,https://www.intensivregister.de/api/public/reporting/laendertabelle
1691031917,652,523,129,1,0,https://www.intensivregister.de/api/public/reporting/laendertabelle
1691035516,652,529,123,1,0,https://www.intensivregister.de/api/public/reporting/laendertabelle
1691039117,652,527,125,1,0,https://www.intensivregister.de/api/public/reporting/laendertabelle
1691042717,625,499,126,1,0,https://www.intensivregister.de/api/public/reporting/laendertabelle
1691075117,625,500,125,1,0,https://www.intensivregister.de/api/public/reporting/laendertabelle
1691114716,625,501,124,1,0,https://www.intensivregister.de/api/public/reporting/laendertabelle
1691118316,625,502,123,2,1,https://www.intensivregister.de/api/public/reporting/laendertabelle
1691121917,624,502,122,2,1,https://www.intensivregister.de/api/public/reporting/laendertabelle
1691132717,622,494,128,2,1,https://www.intensivregister.de/api/public/reporting/laendertabelle
1691157917,622,491,131,2,1,https://www.intensivregister.de/api/public/reporting/laendertabelle
1691183117,622,494,128,2,1,https://www.intensivregister.de/api/public/reporting/laendertabelle
1691186717,622,488,134,2,1,https://www.intensivregister.de/api/public/reporting/laendertabelle
1691208316,623,488,135,2,1,https://www.intensivregister.de/api/public/reporting/laendertabelle
1691211916,622,484,138,2,1,https://www.intensivregister.de/api/public/reporting/laendertabelle
1691215517,622,476,146,2,1,https://www.intensivregister.de/api/public/reporting/laendertabelle
1691219116,622,477,145,2,1,https://www.intensivregister.de/api/public/reporting/laendertabelle
1691244316,622,479,143,2,1,https://www.intensivregister.de/api/public/reporting/laendertabelle
1691273127,622,478,144,2,1,https://www.intensivregister.de/api/public/reporting/laendertabelle
1691283917,622,475,147,2,1,https://www.intensivregister.de/api/public/reporting/laendertabelle
1691291117,622,471,151,2,1,https://www.intensivregister.de/api/public/reporting/laendertabelle
1691294717,617,462,155,2,1,https://www.intensivregister.de/api/public/reporting/laendertabelle
1691298317,617,459,158,2,1,https://www.intensivregister.de/api/public/reporting/laendertabelle
1691301917,616,457,159,2,1,https://www.intensivregister.de/api/public/reporting/laendertabelle
1691305516,616,463,153,2,1,https://www.intensivregister.de/api/public/reporting/laendertabelle
1691309116,616,468,148,2,1,https://www.intensivregister.de/api/public/reporting/laendertabelle
1691355916,615,465,150,2,1,https://www.intensivregister.de/api/public/reporting/laendertabelle
1691359517,615,466,149,2,1,https://www.intensivregister.de/api/public/reporting/laendertabelle
1691381116,614,466,148,4,2,https://www.intensivregister.de/api/public/reporting/laendertabelle
1691384717,614,467,147,5,2,https://www.intensivregister.de/api/public/reporting/laendertabelle
1691449517,614,468,146,5,2,https://www.intensivregister.de/api/public/reporting/laendertabelle
1691463916,614,461,153,4,2,https://www.intensivregister.de/api/public/reporting/laendertabelle
1691467516,621,464,157,2,1,https://www.intensivregister.de/api/public/reporting/laendertabelle
1691471117,621,471,150,2,1,https://www.intensivregister.de/api/public/reporting/laendertabelle
1691474717,621,473,148,2,1,https://www.intensivregister.de/api/public/reporting/laendertabelle
1691532316,621,477,144,2,1,https://www.intensivregister.de/api/public/reporting/laendertabelle
1691543117,621,478,143,2,1,https://www.intensivregister.de/api/public/reporting/laendertabelle
1691550316,622,487,135,3,0,https://www.intensivregister.de/api/public/reporting/laendertabelle
1691568316,622,489,133,3,0,https://www.intensivregister.de/api/public/reporting/laendertabelle
1691618716,622,492,130,3,0,https://www.intensivregister.de/api/public/reporting/laendertabelle
1691625916,622,491,131,3,0,https://www.intensivregister.de/api/public/reporting/laendertabelle
1691633117,621,492,129,3,0,https://www.intensivregister.de/api/public/reporting/laendertabelle
1691636717,621,494,127,2,0,https://www.intensivregister.de/api/public/reporting/laendertabelle
1691640316,621,495,126,2,0,https://www.intensivregister.de/api/public/reporting/laendertabelle
1691650075,620,495,125,2,0,https://www.intensivregister.de/api/public/reporting/laendertabelle
1691701517,620,489,131,2,0,https://www.intensivregister.de/api/public/reporting/laendertabelle
1691715917,620,491,129,3,1,https://www.intensivregister.de/api/public/reporting/laendertabelle
1691719517,620,490,130,3,1,https://www.intensivregister.de/api/public/reporting/laendertabelle
1691723117,620,492,128,3,1,https://www.intensivregister.de/api/public/reporting/laendertabelle
1691726716,618,494,124,3,1,https://www.intensivregister.de/api/public/reporting/laendertabelle
1691730316,618,491,127,3,1,https://www.intensivregister.de/api/public/reporting/laendertabelle
1691737516,619,492,127,3,1,https://www.intensivregister.de/api/public/reporting/laendertabelle
1691787916,619,493,126,3,1,https://www.intensivregister.de/api/public/reporting/laendertabelle
1691791516,617,494,123,3,1,https://www.intensivregister.de/api/public/reporting/laendertabelle
1691809516,617,489,128,3,1,https://www.intensivregister.de/api/public/reporting/laendertabelle
1691813116,616,483,133,4,1,https://www.intensivregister.de/api/public/reporting/laendertabelle
1691816716,614,474,140,4,1,https://www.intensivregister.de/api/public/reporting/laendertabelle
1691820316,611,467,144,4,1,https://www.intensivregister.de/api/public/reporting/laendertabelle
1691823916,611,466,145,4,1,https://www.intensivregister.de/api/public/reporting/laendertabelle
1691831117,611,465,146,4,1,https://www.intensivregister.de/api/public/reporting/laendertabelle
1691874316,611,464,147,4,1,https://www.intensivregister.de/api/public/reporting/laendertabelle
1691877916,611,466,145,4,1,https://www.intensivregister.de/api/public/reporting/laendertabelle
1691888716,611,467,144,4,1,https://www.intensivregister.de/api/public/reporting/laendertabelle
1691899516,612,460,152,4,1,https://www.intensivregister.de/api/public/reporting/laendertabelle
1691903116,609,459,150,4,1,https://www.intensivregister.de/api/public/reporting/laendertabelle
1691906716,606,454,152,4,1,https://www.intensivregister.de/api/public/reporting/laendertabelle
1691960716,606,452,154,4,1,https://www.intensivregister.de/api/public/reporting/laendertabelle
1691978717,606,449,157,3,1,https://www.intensivregister.de/api/public/reporting/laendertabelle
1691982317,606,446,160,3,1,https://www.intensivregister.de/api/public/reporting/laendertabelle
1691985917,606,450,156,2,1,https://www.intensivregister.de/api/public/reporting/laendertabelle
1691989516,613,459,154,2,1,https://www.intensivregister.de/api/public/reporting/laendertabelle
1691993117,615,461,154,2,1,https://www.intensivregister.de/api/public/reporting/laendertabelle
1692047116,615,462,153,2,1,https://www.intensivregister.de/api/public/reporting/laendertabelle
1692068716,622,473,149,2,1,https://www.intensivregister.de/api/public/reporting/laendertabelle
1692072317,624,479,145,2,1,https://www.intensivregister.de/api/public/reporting/laendertabelle
1692075916,624,480,144,2,1,https://www.intensivregister.de/api/public/reporting/laendertabelle
1692079516,626,481,145,2,1,https://www.intensivregister.de/api/public/reporting/laendertabelle
1692133516,626,483,143,2,1,https://www.intensivregister.de/api/public/reporting/laendertabelle
1692137116,626,485,141,2,1,https://www.intensivregister.de/api/public/reporting/laendertabelle
1692155116,627,496,131,2,1,https://www.intensivregister.de/api/public/reporting/laendertabelle
1692158717,625,495,130,2,1,https://www.intensivregister.de/api/public/reporting/laendertabelle
1692165917,626,491,135,2,1,https://www.intensivregister.de/api/public/reporting/laendertabelle
1692219916,626,493,133,2,1,https://www.intensivregister.de/api/public/reporting/laendertabelle
1692223516,626,495,131,2,1,https://www.intensivregister.de/api/public/reporting/laendertabelle
1692227117,626,494,132,2,1,https://www.intensivregister.de/api/public/reporting/laendertabelle
1692241517,629,504,125,2,1,https://www.intensivregister.de/api/public/reporting/laendertabelle
1692245117,631,507,124,3,1,https://www.intensivregister.de/api/public/reporting/laendertabelle
1692248717,631,511,120,3,1,https://www.intensivregister.de/api/public/reporting/laendertabelle
1692252317,631,509,122,3,1,https://www.intensivregister.de/api/public/reporting/laendertabelle
1692306316,631,508,123,3,1,https://www.intensivregister.de/api/public/reporting/laendertabelle
1692309917,631,506,125,3,1,https://www.intensivregister.de/api/public/reporting/laendertabelle
1692313516,631,503,128,3,1,https://www.intensivregister.de/api/public/reporting/laendertabelle
1692317116,631,504,127,3,1,https://www.intensivregister.de/api/public/reporting/laendertabelle
1692324316,630,503,127,4,1,https://www.intensivregister.de/api/public/reporting/laendertabelle
1692327916,628,500,128,4,0,https://www.intensivregister.de/api/public/reporting/laendertabelle
1692331516,628,502,126,4,0,https://www.intensivregister.de/api/public/reporting/laendertabelle
1692335116,627,501,126,4,0,https://www.intensivregister.de/api/public/reporting/laendertabelle
1692342317,627,503,124,4,0,https://www.intensivregister.de/api/public/reporting/laendertabelle
1692345917,627,505,122,4,0,https://www.intensivregister.de/api/public/reporting/laendertabelle
1692392717,627,504,123,4,0,https://www.intensivregister.de/api/public/reporting/laendertabelle
1692396317,627,505,122,4,0,https://www.intensivregister.de/api/public/reporting/laendertabelle
1692399917,608,487,121,4,0,https://www.intensivregister.de/api/public/reporting/laendertabelle
1692403517,608,488,120,4,0,https://www.intensivregister.de/api/public/reporting/laendertabelle
1692414316,608,489,119,4,0,https://www.intensivregister.de/api/public/reporting/laendertabelle
1692417916,606,486,120,5,0,https://www.intensivregister.de/api/public/reporting/laendertabelle
1692421516,606,482,124,5,0,https://www.intensivregister.de/api/public/reporting/laendertabelle
1692425117,600,476,124,5,0,https://www.intensivregister.de/api/public/reporting/laendertabelle
1692428716,600,472,128,5,0,https://www.intensivregister.de/api/public/reporting/laendertabelle
1692479117,600,469,131,5,0,https://www.intensivregister.de/api/public/reporting/laendertabelle
1692482716,599,469,130,5,0,https://www.intensivregister.de/api/public/reporting/laendertabelle
1692486317,599,471,128,5,0,https://www.intensivregister.de/api/public/reporting/laendertabelle
1692500717,599,472,127,5,0,https://www.intensivregister.de/api/public/reporting/laendertabelle
1692504316,599,466,133,4,0,https://www.intensivregister.de/api/public/reporting/laendertabelle
1692507917,599,459,140,4,0,https://www.intensivregister.de/api/public/reporting/laendertabelle
1692511516,599,461,138,4,0,https://www.intensivregister.de/api/public/reporting/laendertabelle
1692515116,599,460,139,4,0,https://www.intensivregister.de/api/public/reporting/laendertabelle
1692518717,598,460,138,4,0,https://www.intensivregister.de/api/public/reporting/laendertabelle
1692569117,598,461,137,4,0,https://www.intensivregister.de/api/public/reporting/laendertabelle
1692579916,598,458,140,4,0,https://www.intensivregister.de/api/public/reporting/laendertabelle
1692587116,596,458,138,3,0,https://www.intensivregister.de/api/public/reporting/laendertabelle
1692590718,598,461,137,4,0,https://www.intensivregister.de/api/public/reporting/laendertabelle
1692594316,598,464,134,4,0,https://www.intensivregister.de/api/public/reporting/laendertabelle
1692669917,598,463,135,4,0,https://www.intensivregister.de/api/public/reporting/laendertabelle
1692673516,616,470,146,2,0,https://www.intensivregister.de/api/public/reporting/laendertabelle
1692677117,616,471,145,2,0,https://www.intensivregister.de/api/public/reporting/laendertabelle
1692680717,616,477,139,2,0,https://www.intensivregister.de/api/public/reporting/laendertabelle
1692684316,616,472,144,2,0,https://www.intensivregister.de/api/public/reporting/laendertabelle
1692691517,616,471,145,2,0,https://www.intensivregister.de/api/public/reporting/laendertabelle
1692702317,616,472,144,2,0,https://www.intensivregister.de/api/public/reporting/laendertabelle
1692738316,616,469,147,2,0,https://www.intensivregister.de/api/public/reporting/laendertabelle
1692759916,616,451,165,3,0,https://www.intensivregister.de/api/public/reporting/laendertabelle
1692763516,616,446,170,4,1,https://www.intensivregister.de/api/public/reporting/laendertabelle
1692767117,616,444,172,4,1,https://www.intensivregister.de/api/public/reporting/laendertabelle
1692785116,616,443,173,4,1,https://www.intensivregister.de/api/public/reporting/laendertabelle
1692824716,616,442,174,4,1,https://www.intensivregister.de/api/public/reporting/laendertabelle
1692846317,616,462,154,2,1,https://www.intensivregister.de/api/public/reporting/laendertabelle
1692849917,614,468,146,2,0,https://www.intensivregister.de/api/public/reporting/laendertabelle
1692853518,614,474,140,2,0,https://www.intensivregister.de/api/public/reporting/laendertabelle
1692857117,614,475,139,2,0,https://www.intensivregister.de/api/public/reporting/laendertabelle
1692864317,614,477,137,2,0,https://www.intensivregister.de/api/public/reporting/laendertabelle
1692932717,611,485,126,1,0,https://www.intensivregister.de/api/public/reporting/laendertabelle
1692936317,615,488,127,1,0,https://www.intensivregister.de/api/public/reporting/laendertabelle
1692943517,617,488,129,1,0,https://www.intensivregister.de/api/public/reporting/laendertabelle
1692947116,617,486,131,1,0,https://www.intensivregister.de/api/public/reporting/laendertabelle
1692950716,617,487,130,1,0,https://www.intensivregister.de/api/public/reporting/laendertabelle
1692997516,617,488,129,1,0,https://www.intensivregister.de/api/public/reporting/laendertabelle
1693001116,617,484,133,1,0,https://www.intensivregister.de/api/public/reporting/laendertabelle
1693019117,611,481,130,1,0,https://www.intensivregister.de/api/public/reporting/laendertabelle
1693022716,608,471,137,0,0,https://www.intensivregister.de/api/public/reporting/laendertabelle
1693026317,608,466,142,0,0,https://www.intensivregister.de/api/public/reporting/laendertabelle
1693029918,608,464,144,0,0,https://www.intensivregister.de/api/public/reporting/laendertabelle
1693033516,608,461,147,0,0,https://www.intensivregister.de/api/public/reporting/laendertabelle
1693037117,608,460,148,0,0,https://www.intensivregister.de/api/public/reporting/laendertabelle
1693098316,608,457,151,0,0,https://www.intensivregister.de/api/public/reporting/laendertabelle
1693105517,608,456,152,0,0,https://www.intensivregister.de/api/public/reporting/laendertabelle
1693109116,604,442,162,0,0,https://www.intensivregister.de/api/public/reporting/laendertabelle
1693112716,604,448,156,0,0,https://www.intensivregister.de/api/public/reporting/laendertabelle
1693116317,604,447,157,0,0,https://www.intensivregister.de/api/public/reporting/laendertabelle
1693130717,604,449,155,0,0,https://www.intensivregister.de/api/public/reporting/laendertabelle
1693170316,604,448,156,0,0,https://www.intensivregister.de/api/public/reporting/laendertabelle
1693191917,602,435,167,1,0,https://www.intensivregister.de/api/public/reporting/laendertabelle
1693195517,600,435,165,2,0,https://www.intensivregister.de/api/public/reporting/laendertabelle
1693199116,600,434,166,2,0,https://www.intensivregister.de/api/public/reporting/laendertabelle
1693202716,602,437,165,2,0,https://www.intensivregister.de/api/public/reporting/laendertabelle
1693206317,602,436,166,2,0,https://www.intensivregister.de/api/public/reporting/laendertabelle
1693256718,602,444,158,2,0,https://www.intensivregister.de/api/public/reporting/laendertabelle
1693260318,602,445,157,2,0,https://www.intensivregister.de/api/public/reporting/laendertabelle
1693271118,602,444,158,2,0,https://www.intensivregister.de/api/public/reporting/laendertabelle
1693278318,607,446,161,2,0,https://www.intensivregister.de/api/public/reporting/laendertabelle
1693281919,609,451,158,2,0,https://www.intensivregister.de/api/public/reporting/laendertabelle
1693285518,609,453,156,2,0,https://www.intensivregister.de/api/public/reporting/laendertabelle
1693296319,609,451,158,2,0,https://www.intensivregister.de/api/public/reporting/laendertabelle
1693343115,609,452,157,2,0,https://www.intensivregister.de/api/public/reporting/laendertabelle
1693361115,609,453,156,2,0,https://www.intensivregister.de/api/public/reporting/laendertabelle
1693364715,616,481,135,2,0,https://www.intensivregister.de/api/public/reporting/laendertabelle
1693368316,617,482,135,2,0,https://www.intensivregister.de/api/public/reporting/laendertabelle
1693371915,617,486,131,2,0,https://www.intensivregister.de/api/public/reporting/laendertabelle
1693375516,617,484,133,4,0,https://www.intensivregister.de/api/public/reporting/laendertabelle
1693382715,617,489,128,4,0,https://www.intensivregister.de/api/public/reporting/laendertabelle
1693429515,617,490,127,4,0,https://www.intensivregister.de/api/public/reporting/laendertabelle
1693436715,617,488,129,4,0,https://www.intensivregister.de/api/public/reporting/laendertabelle
1693447515,617,490,127,4,0,https://www.intensivregister.de/api/public/reporting/laendertabelle
1693451115,616,488,128,3,0,https://www.intensivregister.de/api/public/reporting/laendertabelle
1693454716,615,484,131,3,0,https://www.intensivregister.de/api/public/reporting/laendertabelle
1693458315,620,492,128,2,0,https://www.intensivregister.de/api/public/reporting/laendertabelle
1693465516,620,495,125,2,0,https://www.intensivregister.de/api/public/reporting/laendertabelle
1693469115,620,493,127,2,0,https://www.intensivregister.de/api/public/reporting/laendertabelle
1693515921,620,495,125,2,0,https://www.intensivregister.de/api/public/reporting/laendertabelle
1693533914,620,496,124,2,0,https://www.intensivregister.de/api/public/reporting/laendertabelle
1693537514,620,484,136,2,0,https://www.intensivregister.de/api/public/reporting/laendertabelle
1693541115,618,476,142,2,0,https://www.intensivregister.de/api/public/reporting/laendertabelle
1693544715,618,477,141,2,0,https://www.intensivregister.de/api/public/reporting/laendertabelle
1693551918,616,473,143,1,0,https://www.intensivregister.de/api/public/reporting/laendertabelle
1693598716,616,468,148,1,0,https://www.intensivregister.de/api/public/reporting/laendertabelle
1693602317,616,467,149,1,0,https://www.intensivregister.de/api/public/reporting/laendertabelle
1693605916,616,469,147,1,0,https://www.intensivregister.de/api/public/reporting/laendertabelle
1693620314,616,467,149,1,0,https://www.intensivregister.de/api/public/reporting/laendertabelle
1693623914,616,466,150,1,0,https://www.intensivregister.de/api/public/reporting/laendertabelle
1693627514,602,459,143,1,0,https://www.intensivregister.de/api/public/reporting/laendertabelle
1693631114,602,455,147,1,0,https://www.intensivregister.de/api/public/reporting/laendertabelle
1693634713,600,452,148,1,0,https://www.intensivregister.de/api/public/reporting/laendertabelle
1693663514,600,450,150,1,0,https://www.intensivregister.de/api/public/reporting/laendertabelle
1693688714,600,447,153,1,0,https://www.intensivregister.de/api/public/reporting/laendertabelle
1693710314,597,443,154,2,0,https://www.intensivregister.de/api/public/reporting/laendertabelle
1693713914,597,439,158,1,0,https://www.intensivregister.de/api/public/reporting/laendertabelle
1693717514,597,447,150,2,0,https://www.intensivregister.de/api/public/reporting/laendertabelle
1693771514,597,448,149,2,0,https://www.intensivregister.de/api/public/reporting/laendertabelle
1693793114,598,449,149,2,0,https://www.intensivregister.de/api/public/reporting/laendertabelle
1693796714,598,451,147,2,0,https://www.intensivregister.de/api/public/reporting/laendertabelle
1693800313,596,446,150,3,1,https://www.intensivregister.de/api/public/reporting/laendertabelle
1693803915,596,437,159,3,1,https://www.intensivregister.de/api/public/reporting/laendertabelle
1693811114,596,435,161,3,1,https://www.intensivregister.de/api/public/reporting/laendertabelle
1693861513,596,441,155,4,2,https://www.intensivregister.de/api/public/reporting/laendertabelle
1693883114,599,445,154,4,2,https://www.intensivregister.de/api/public/reporting/laendertabelle
1693886714,597,448,149,4,2,https://www.intensivregister.de/api/public/reporting/laendertabelle
1693890313,597,449,148,4,2,https://www.intensivregister.de/api/public/reporting/laendertabelle
1693893913,599,453,146,4,2,https://www.intensivregister.de/api/public/reporting/laendertabelle
1693897514,599,451,148,4,2,https://www.intensivregister.de/api/public/reporting/laendertabelle
1693947915,599,452,147,4,2,https://www.intensivregister.de/api/public/reporting/laendertabelle
1693951514,599,451,148,4,2,https://www.intensivregister.de/api/public/reporting/laendertabelle
1693962314,599,449,150,4,2,https://www.intensivregister.de/api/public/reporting/laendertabelle
1693969515,602,454,148,5,3,https://www.intensivregister.de/api/public/reporting/laendertabelle
1693973115,602,450,152,4,3,https://www.intensivregister.de/api/public/reporting/laendertabelle
1693976715,604,450,154,4,3,https://www.intensivregister.de/api/public/reporting/laendertabelle
1693980315,602,444,158,4,3,https://www.intensivregister.de/api/public/reporting/laendertabelle
1693987515,602,445,157,4,3,https://www.intensivregister.de/api/public/reporting/laendertabelle
1694034315,602,446,156,4,3,https://www.intensivregister.de/api/public/reporting/laendertabelle
1694041515,602,447,155,4,3,https://www.intensivregister.de/api/public/reporting/laendertabelle
1694055916,602,451,151,4,3,https://www.intensivregister.de/api/public/reporting/laendertabelle
1694059515,601,457,144,4,3,https://www.intensivregister.de/api/public/reporting/laendertabelle
1694063115,601,455,146,3,2,https://www.intensivregister.de/api/public/reporting/laendertabelle
1694073915,601,458,143,4,2,https://www.intensivregister.de/api/public/reporting/laendertabelle
1694127915,601,459,142,4,2,https://www.intensivregister.de/api/public/reporting/laendertabelle
1694138715,601,457,144,4,2,https://www.intensivregister.de/api/public/reporting/laendertabelle
1694142315,601,465,136,4,2,https://www.intensivregister.de/api/public/reporting/laendertabelle
1694145915,602,468,134,4,2,https://www.intensivregister.de/api/public/reporting/laendertabelle
1694149514,602,466,136,4,2,https://www.intensivregister.de/api/public/reporting/laendertabelle
1694153114,602,467,135,4,2,https://www.intensivregister.de/api/public/reporting/laendertabelle
1694163918,600,469,131,4,2,https://www.intensivregister.de/api/public/reporting/laendertabelle
1694207115,600,470,130,4,2,https://www.intensivregister.de/api/public/reporting/laendertabelle
1694232315,595,444,151,5,2,https://www.intensivregister.de/api/public/reporting/laendertabelle
1694235915,595,441,154,6,2,https://www.intensivregister.de/api/public/reporting/laendertabelle
1694239515,595,442,153,6,2,https://www.intensivregister.de/api/public/reporting/laendertabelle
1694243115,593,441,152,7,2,https://www.intensivregister.de/api/public/reporting/laendertabelle
1694293515,593,442,151,7,2,https://www.intensivregister.de/api/public/reporting/laendertabelle
1694300715,593,444,149,7,2,https://www.intensivregister.de/api/public/reporting/laendertabelle
1694311515,593,445,148,7,2,https://www.intensivregister.de/api/public/reporting/laendertabelle
1694315115,593,444,149,7,2,https://www.intensivregister.de/api/public/reporting/laendertabelle
1694318715,593,425,168,7,2,https://www.intensivregister.de/api/public/reporting/laendertabelle
1694322315,593,424,169,7,2,https://www.intensivregister.de/api/public/reporting/laendertabelle
1694325915,593,426,167,7,2,https://www.intensivregister.de/api/public/reporting/laendertabelle
1694333114,593,428,165,7,2,https://www.intensivregister.de/api/public/reporting/laendertabelle
1694379915,593,427,166,7,2,https://www.intensivregister.de/api/public/reporting/laendertabelle
1694397914,593,426,167,7,2,https://www.intensivregister.de/api/public/reporting/laendertabelle
1694401514,586,437,149,8,2,https://www.intensivregister.de/api/public/reporting/laendertabelle
1694405116,587,429,158,8,2,https://www.intensivregister.de/api/public/reporting/laendertabelle
1694408715,587,428,159,9,3,https://www.intensivregister.de/api/public/reporting/laendertabelle
1694412316,591,432,159,10,3,https://www.intensivregister.de/api/public/reporting/laendertabelle
1694419515,591,434,157,10,3,https://www.intensivregister.de/api/public/reporting/laendertabelle
1694466315,591,432,159,10,3,https://www.intensivregister.de/api/public/reporting/laendertabelle
1694480715,591,434,157,10,3,https://www.intensivregister.de/api/public/reporting/laendertabelle
1694484315,589,435,154,10,3,https://www.intensivregister.de/api/public/reporting/laendertabelle
1694487915,598,441,157,8,3,https://www.intensivregister.de/api/public/reporting/laendertabelle
1694491515,600,448,152,9,3,https://www.intensivregister.de/api/public/reporting/laendertabelle
1694495115,600,449,151,10,3,https://www.intensivregister.de/api/public/reporting/laendertabelle
1694502315,600,448,152,10,3,https://www.intensivregister.de/api/public/reporting/laendertabelle
1694552715,600,444,156,10,3,https://www.intensivregister.de/api/public/reporting/laendertabelle
1694577915,600,447,153,8,2,https://www.intensivregister.de/api/public/reporting/laendertabelle
1694581515,601,454,147,8,2,https://www.intensivregister.de/api/public/reporting/laendertabelle
1694585115,601,453,148,8,2,https://www.intensivregister.de/api/public/reporting/laendertabelle
1694639115,601,453,148,7,1,https://www.intensivregister.de/api/public/reporting/laendertabelle
1694649914,601,456,145,7,1,https://www.intensivregister.de/api/public/reporting/laendertabelle
1694657114,600,452,148,7,1,https://www.intensivregister.de/api/public/reporting/laendertabelle
1694660715,603,459,144,6,1,https://www.intensivregister.de/api/public/reporting/laendertabelle
1694664315,603,456,147,6,1,https://www.intensivregister.de/api/public/reporting/laendertabelle
1694667915,603,455,148,6,1,https://www.intensivregister.de/api/public/reporting/laendertabelle
1694675114,603,452,151,6,1,https://www.intensivregister.de/api/public/reporting/laendertabelle
1694729115,603,454,149,6,1,https://www.intensivregister.de/api/public/reporting/laendertabelle
1694732715,603,458,145,6,1,https://www.intensivregister.de/api/public/reporting/laendertabelle
1694743515,605,460,145,6,1,https://www.intensivregister.de/api/public/reporting/laendertabelle
1694747114,607,456,151,6,1,https://www.intensivregister.de/api/public/reporting/laendertabelle
1694750714,607,459,148,6,1,https://www.intensivregister.de/api/public/reporting/laendertabelle
1694754315,607,461,146,6,1,https://www.intensivregister.de/api/public/reporting/laendertabelle
1694761515,607,462,145,6,1,https://www.intensivregister.de/api/public/reporting/laendertabelle
1694768715,607,463,144,6,1,https://www.intensivregister.de/api/public/reporting/laendertabelle
1694779514,607,463,144,4,1,https://www.intensivregister.de/api/public/reporting/laendertabelle
1694811915,607,461,146,4,1,https://www.intensivregister.de/api/public/reporting/laendertabelle
1694815514,607,460,147,4,1,https://www.intensivregister.de/api/public/reporting/laendertabelle
1694833514,602,457,145,4,1,https://www.intensivregister.de/api/public/reporting/laendertabelle
1694837114,602,456,146,4,1,https://www.intensivregister.de/api/public/reporting/laendertabelle
1694840714,599,452,147,4,1,https://www.intensivregister.de/api/public/reporting/laendertabelle
1694844315,595,446,149,5,1,https://www.intensivregister.de/api/public/reporting/laendertabelle
1694855115,595,445,150,5,1,https://www.intensivregister.de/api/public/reporting/laendertabelle
1694898314,595,442,153,6,1,https://www.intensivregister.de/api/public/reporting/laendertabelle
1694905514,595,441,154,6,1,https://www.intensivregister.de/api/public/reporting/laendertabelle
1694916314,595,439,156,6,1,https://www.intensivregister.de/api/public/reporting/laendertabelle
1694919914,595,437,158,6,1,https://www.intensivregister.de/api/public/reporting/laendertabelle
1694923514,596,437,159,7,2,https://www.intensivregister.de/api/public/reporting/laendertabelle
1694934314,596,439,157,7,2,https://www.intensivregister.de/api/public/reporting/laendertabelle
1694945114,596,438,158,7,2,https://www.intensivregister.de/api/public/reporting/laendertabelle
1694984714,596,436,160,6,2,https://www.intensivregister.de/api/public/reporting/laendertabelle
1694995515,596,437,159,6,2,https://www.intensivregister.de/api/public/reporting/laendertabelle
1695006316,593,443,150,6,2,https://www.intensivregister.de/api/public/reporting/laendertabelle
1695009915,591,441,150,7,3,https://www.intensivregister.de/api/public/reporting/laendertabelle
1695013514,591,437,154,6,2,https://www.intensivregister.de/api/public/reporting/laendertabelle
1695020715,591,438,153,6,2,https://www.intensivregister.de/api/public/reporting/laendertabelle
1695024314,591,437,154,6,2,https://www.intensivregister.de/api/public/reporting/laendertabelle
1695071114,591,440,151,6,2,https://www.intensivregister.de/api/public/reporting/laendertabelle
1695074715,591,439,152,6,2,https://www.intensivregister.de/api/public/reporting/laendertabelle
1695089115,591,439,152,5,2,https://www.intensivregister.de/api/public/reporting/laendertabelle
1695092716,591,439,152,6,2,https://www.intensivregister.de/api/public/reporting/laendertabelle
1695096316,595,454,141,5,2,https://www.intensivregister.de/api/public/reporting/laendertabelle
1695099915,595,456,139,5,2,https://www.intensivregister.de/api/public/reporting/laendertabelle
1695103515,595,455,140,4,2,https://www.intensivregister.de/api/public/reporting/laendertabelle
1695117915,595,455,140,3,1,https://www.intensivregister.de/api/public/reporting/laendertabelle
1695125115,593,454,139,3,1,https://www.intensivregister.de/api/public/reporting/laendertabelle
1695157514,593,450,143,3,1,https://www.intensivregister.de/api/public/reporting/laendertabelle
1695175515,592,450,142,3,1,https://www.intensivregister.de/api/public/reporting/laendertabelle
1695182715,591,451,140,3,1,https://www.intensivregister.de/api/public/reporting/laendertabelle
1695186315,591,444,147,3,1,https://www.intensivregister.de/api/public/reporting/laendertabelle
1695189915,591,443,148,3,1,https://www.intensivregister.de/api/public/reporting/laendertabelle
1695193514,591,445,146,3,1,https://www.intensivregister.de/api/public/reporting/laendertabelle
1695243915,591,447,144,3,1,https://www.intensivregister.de/api/public/reporting/laendertabelle
1695261915,591,446,145,3,1,https://www.intensivregister.de/api/public/reporting/laendertabelle
1695265515,589,436,153,4,1,https://www.intensivregister.de/api/public/reporting/laendertabelle
1695269114,588,421,167,4,1,https://www.intensivregister.de/api/public/reporting/laendertabelle
1695272714,588,424,164,4,1,https://www.intensivregister.de/api/public/reporting/laendertabelle
1695276316,582,417,165,4,1,https://www.intensivregister.de/api/public/reporting/laendertabelle
1695279916,582,420,162,4,1,https://www.intensivregister.de/api/public/reporting/laendertabelle
1695330316,582,421,161,4,1,https://www.intensivregister.de/api/public/reporting/laendertabelle
1695341116,582,424,158,4,1,https://www.intensivregister.de/api/public/reporting/laendertabelle
1695351915,586,435,151,4,1,https://www.intensivregister.de/api/public/reporting/laendertabelle
1695355515,589,448,141,3,1,https://www.intensivregister.de/api/public/reporting/laendertabelle
1695359115,589,450,139,3,1,https://www.intensivregister.de/api/public/reporting/laendertabelle
1695362715,589,452,137,3,1,https://www.intensivregister.de/api/public/reporting/laendertabelle
1695369915,589,446,143,3,1,https://www.intensivregister.de/api/public/reporting/laendertabelle
1695413115,589,443,146,3,1,https://www.intensivregister.de/api/public/reporting/laendertabelle
1695441914,586,453,133,3,1,https://www.intensivregister.de/api/public/reporting/laendertabelle
1695445515,585,453,132,5,1,https://www.intensivregister.de/api/public/reporting/laendertabelle
1695452715,585,445,140,5,1,https://www.intensivregister.de/api/public/reporting/laendertabelle
1695524715,586,446,140,5,1,https://www.intensivregister.de/api/public/reporting/laendertabelle
1695528315,586,449,137,5,1,https://www.intensivregister.de/api/public/reporting/laendertabelle
1695531914,586,445,141,3,0,https://www.intensivregister.de/api/public/reporting/laendertabelle
1695535515,585,441,144,3,0,https://www.intensivregister.de/api/public/reporting/laendertabelle
1695539114,585,440,145,3,0,https://www.intensivregister.de/api/public/reporting/laendertabelle
1695542715,583,437,146,3,0,https://www.intensivregister.de/api/public/reporting/laendertabelle
1695589515,582,435,147,3,0,https://www.intensivregister.de/api/public/reporting/laendertabelle
1695603915,582,440,142,3,0,https://www.intensivregister.de/api/public/reporting/laendertabelle
1695607515,584,441,143,3,0,https://www.intensivregister.de/api/public/reporting/laendertabelle
1695611115,586,442,144,3,0,https://www.intensivregister.de/api/public/reporting/laendertabelle
1695614715,586,436,150,4,0,https://www.intensivregister.de/api/public/reporting/laendertabelle
1695618315,589,431,158,3,0,https://www.intensivregister.de/api/public/reporting/laendertabelle
1695621915,589,434,155,3,0,https://www.intensivregister.de/api/public/reporting/laendertabelle
1695625515,589,436,153,3,0,https://www.intensivregister.de/api/public/reporting/laendertabelle
1695629114,589,437,152,3,0,https://www.intensivregister.de/api/public/reporting/laendertabelle
1695675914,589,443,146,3,0,https://www.intensivregister.de/api/public/reporting/laendertabelle
1695679514,589,447,142,3,0,https://www.intensivregister.de/api/public/reporting/laendertabelle
1695693915,588,450,138,3,0,https://www.intensivregister.de/api/public/reporting/laendertabelle
1695697515,599,464,135,3,0,https://www.intensivregister.de/api/public/reporting/laendertabelle
1695701115,601,467,134,4,1,https://www.intensivregister.de/api/public/reporting/laendertabelle
1695704715,601,472,129,3,1,https://www.intensivregister.de/api/public/reporting/laendertabelle
1695708315,601,474,127,3,1,https://www.intensivregister.de/api/public/reporting/laendertabelle
1695711914,601,475,126,3,1,https://www.intensivregister.de/api/public/reporting/laendertabelle
1695758714,601,474,127,3,1,https://www.intensivregister.de/api/public/reporting/laendertabelle
1695762314,601,471,130,3,1,https://www.intensivregister.de/api/public/reporting/laendertabelle
1695773114,601,472,129,3,1,https://www.intensivregister.de/api/public/reporting/laendertabelle
1695783915,600,480,120,3,1,https://www.intensivregister.de/api/public/reporting/laendertabelle
1695787514,602,490,112,3,1,https://www.intensivregister.de/api/public/reporting/laendertabelle
1695791114,602,491,111,3,1,https://www.intensivregister.de/api/public/reporting/laendertabelle
1695794714,602,495,107,3,1,https://www.intensivregister.de/api/public/reporting/laendertabelle
1695798314,602,490,112,3,1,https://www.intensivregister.de/api/public/reporting/laendertabelle
1695848714,602,491,111,3,1,https://www.intensivregister.de/api/public/reporting/laendertabelle
1695855914,602,492,110,3,1,https://www.intensivregister.de/api/public/reporting/laendertabelle
1695870314,601,486,115,3,1,https://www.intensivregister.de/api/public/reporting/laendertabelle
1695873914,601,482,119,2,0,https://www.intensivregister.de/api/public/reporting/laendertabelle
1695877515,597,476,121,2,0,https://www.intensivregister.de/api/public/reporting/laendertabelle
1695881114,597,478,119,1,0,https://www.intensivregister.de/api/public/reporting/laendertabelle
1695888314,597,477,120,1,0,https://www.intensivregister.de/api/public/reporting/laendertabelle
1695935114,597,480,117,1,0,https://www.intensivregister.de/api/public/reporting/laendertabelle
1695956714,598,490,108,2,0,https://www.intensivregister.de/api/public/reporting/laendertabelle
1695960314,598,487,111,3,0,https://www.intensivregister.de/api/public/reporting/laendertabelle
1695963914,598,485,113,3,0,https://www.intensivregister.de/api/public/reporting/laendertabelle
1695971114,598,488,110,3,0,https://www.intensivregister.de/api/public/reporting/laendertabelle
1696007114,598,486,112,3,0,https://www.intensivregister.de/api/public/reporting/laendertabelle
1696021515,598,482,116,3,0,https://www.intensivregister.de/api/public/reporting/laendertabelle
1696043114,598,481,117,3,0,https://www.intensivregister.de/api/public/reporting/laendertabelle
1696046714,591,467,124,3,0,https://www.intensivregister.de/api/public/reporting/laendertabelle
1696050315,591,468,123,3,0,https://www.intensivregister.de/api/public/reporting/laendertabelle
1696053915,590,465,125,5,0,https://www.intensivregister.de/api/public/reporting/laendertabelle
1696057514,588,461,127,5,0,https://www.intensivregister.de/api/public/reporting/laendertabelle
1696115114,588,460,128,5,0,https://www.intensivregister.de/api/public/reporting/laendertabelle
1696118714,588,457,131,5,0,https://www.intensivregister.de/api/public/reporting/laendertabelle
1696129514,581,455,126,5,0,https://www.intensivregister.de/api/public/reporting/laendertabelle
1696133114,579,449,130,6,1,https://www.intensivregister.de/api/public/reporting/laendertabelle
1696136714,579,445,134,6,1,https://www.intensivregister.de/api/public/reporting/laendertabelle
1696140314,579,442,137,5,1,https://www.intensivregister.de/api/public/reporting/laendertabelle
1696143914,579,443,136,5,1,https://www.intensivregister.de/api/public/reporting/laendertabelle
1696194314,579,441,138,5,1,https://www.intensivregister.de/api/public/reporting/laendertabelle
1696197914,579,443,136,5,1,https://www.intensivregister.de/api/public/reporting/laendertabelle
1696208714,579,444,135,5,1,https://www.intensivregister.de/api/public/reporting/laendertabelle
1696215915,583,439,144,5,1,https://www.intensivregister.de/api/public/reporting/laendertabelle
1696219515,577,428,149,4,1,https://www.intensivregister.de/api/public/reporting/laendertabelle
1696223114,579,427,152,5,1,https://www.intensivregister.de/api/public/reporting/laendertabelle
1696226715,581,428,153,5,1,https://www.intensivregister.de/api/public/reporting/laendertabelle
1696230314,581,427,154,5,1,https://www.intensivregister.de/api/public/reporting/laendertabelle
1696233914,581,428,153,5,1,https://www.intensivregister.de/api/public/reporting/laendertabelle
1696237515,581,429,152,5,1,https://www.intensivregister.de/api/public/reporting/laendertabelle
1696280714,581,432,149,6,1,https://www.intensivregister.de/api/public/reporting/laendertabelle
1696284314,581,434,147,6,1,https://www.intensivregister.de/api/public/reporting/laendertabelle
1696302314,581,433,148,7,1,https://www.intensivregister.de/api/public/reporting/laendertabelle
1696305914,581,437,144,6,2,https://www.intensivregister.de/api/public/reporting/laendertabelle
1696309514,579,440,139,6,2,https://www.intensivregister.de/api/public/reporting/laendertabelle
1696313114,587,446,141,6,2,https://www.intensivregister.de/api/public/reporting/laendertabelle
1696316714,587,448,139,6,2,https://www.intensivregister.de/api/public/reporting/laendertabelle
1696331114,587,450,137,6,2,https://www.intensivregister.de/api/public/reporting/laendertabelle
1696367114,587,449,138,6,2,https://www.intensivregister.de/api/public/reporting/laendertabelle
1696385114,587,451,136,6,2,https://www.intensivregister.de/api/public/reporting/laendertabelle
1696388714,587,433,154,6,3,https://www.intensivregister.de/api/public/reporting/laendertabelle
1696392314,588,427,161,5,3,https://www.intensivregister.de/api/public/reporting/laendertabelle
1696395914,586,421,165,5,3,https://www.intensivregister.de/api/public/reporting/laendertabelle
1696453515,586,426,160,5,3,https://www.intensivregister.de/api/public/reporting/laendertabelle
1696460714,586,427,159,5,3,https://www.intensivregister.de/api/public/reporting/laendertabelle
1696475114,588,439,149,5,3,https://www.intensivregister.de/api/public/reporting/laendertabelle
1696478714,588,434,154,5,3,https://www.intensivregister.de/api/public/reporting/laendertabelle
1696482315,592,437,155,5,3,https://www.intensivregister.de/api/public/reporting/laendertabelle
1696485914,592,439,153,5,3,https://www.intensivregister.de/api/public/reporting/laendertabelle
1696489515,592,442,150,5,3,https://www.intensivregister.de/api/public/reporting/laendertabelle
1696493115,592,439,153,5,3,https://www.intensivregister.de/api/public/reporting/laendertabelle
1696536314,592,440,152,5,3,https://www.intensivregister.de/api/public/reporting/laendertabelle
1696539914,592,441,151,5,3,https://www.intensivregister.de/api/public/reporting/laendertabelle
1696543514,592,443,149,5,3,https://www.intensivregister.de/api/public/reporting/laendertabelle
1696561514,595,460,135,6,3,https://www.intensivregister.de/api/public/reporting/laendertabelle
1696565115,595,452,143,6,3,https://www.intensivregister.de/api/public/reporting/laendertabelle
1696568715,593,454,139,6,3,https://www.intensivregister.de/api/public/reporting/laendertabelle
1696572315,591,451,140,6,3,https://www.intensivregister.de/api/public/reporting/laendertabelle
1696575914,591,448,143,6,3,https://www.intensivregister.de/api/public/reporting/laendertabelle
1696579514,591,449,142,6,3,https://www.intensivregister.de/api/public/reporting/laendertabelle
1696593914,591,448,143,6,3,https://www.intensivregister.de/api/public/reporting/laendertabelle
1696626314,591,443,148,6,3,https://www.intensivregister.de/api/public/reporting/laendertabelle
1696644314,591,441,150,6,3,https://www.intensivregister.de/api/public/reporting/laendertabelle
1696647914,591,436,155,5,2,https://www.intensivregister.de/api/public/reporting/laendertabelle
1696651514,591,440,151,6,2,https://www.intensivregister.de/api/public/reporting/laendertabelle
1696655114,589,437,152,6,2,https://www.intensivregister.de/api/public/reporting/laendertabelle
1696658714,587,440,147,7,3,https://www.intensivregister.de/api/public/reporting/laendertabelle
1696665914,587,440,147,8,3,https://www.intensivregister.de/api/public/reporting/laendertabelle
1696712714,587,442,145,8,3,https://www.intensivregister.de/api/public/reporting/laendertabelle
1696737914,587,443,144,8,3,https://www.intensivregister.de/api/public/reporting/laendertabelle
1696741514,579,441,138,10,3,https://www.intensivregister.de/api/public/reporting/laendertabelle
1696745114,579,442,137,10,3,https://www.intensivregister.de/api/public/reporting/laendertabelle
1696748715,579,445,134,10,3,https://www.intensivregister.de/api/public/reporting/laendertabelle
1696802714,579,443,136,10,3,https://www.intensivregister.de/api/public/reporting/laendertabelle
1696806314,579,442,137,11,3,https://www.intensivregister.de/api/public/reporting/laendertabelle
1696817114,579,443,136,11,3,https://www.intensivregister.de/api/public/reporting/laendertabelle
1696820714,581,446,135,10,3,https://www.intensivregister.de/api/public/reporting/laendertabelle
1696824314,583,451,132,10,3,https://www.intensivregister.de/api/public/reporting/laendertabelle
1696827914,583,454,129,10,3,https://www.intensivregister.de/api/public/reporting/laendertabelle
1696831515,583,457,126,10,3,https://www.intensivregister.de/api/public/reporting/laendertabelle
1696842321,583,458,125,10,3,https://www.intensivregister.de/api/public/reporting/laendertabelle
1696885514,583,459,124,10,3,https://www.intensivregister.de/api/public/reporting/laendertabelle
1696907114,582,459,123,10,2,https://www.intensivregister.de/api/public/reporting/laendertabelle
1696910715,587,468,119,10,2,https://www.intensivregister.de/api/public/reporting/laendertabelle
1696914315,587,469,118,11,2,https://www.intensivregister.de/api/public/reporting/laendertabelle
1696917914,587,469,118,13,2,https://www.intensivregister.de/api/public/reporting/laendertabelle
1696925115,587,474,113,13,2,https://www.intensivregister.de/api/public/reporting/laendertabelle
1696979114,587,477,110,13,2,https://www.intensivregister.de/api/public/reporting/laendertabelle
1696993514,587,483,104,12,2,https://www.intensivregister.de/api/public/reporting/laendertabelle
1696997114,587,484,103,12,2,https://www.intensivregister.de/api/public/reporting/laendertabelle
1697000714,588,490,98,11,2,https://www.intensivregister.de/api/public/reporting/laendertabelle
1697004315,586,486,100,11,2,https://www.intensivregister.de/api/public/reporting/laendertabelle
1697011514,586,486,100,12,2,https://www.intensivregister.de/api/public/reporting/laendertabelle
1697061914,586,487,99,12,2,https://www.intensivregister.de/api/public/reporting/laendertabelle
1697072715,586,486,100,12,2,https://www.intensivregister.de/api/public/reporting/laendertabelle
1697079914,585,483,102,11,2,https://www.intensivregister.de/api/public/reporting/laendertabelle
1697083514,585,478,107,11,2,https://www.intensivregister.de/api/public/reporting/laendertabelle
1697087114,585,477,108,11,2,https://www.intensivregister.de/api/public/reporting/laendertabelle
1697090714,583,478,105,9,2,https://www.intensivregister.de/api/public/reporting/laendertabelle
1697094314,583,475,108,9,2,https://www.intensivregister.de/api/public/reporting/laendertabelle
1697097914,583,472,111,9,2,https://www.intensivregister.de/api/public/reporting/laendertabelle
1697112315,583,473,110,9,2,https://www.intensivregister.de/api/public/reporting/laendertabelle
1697126714,583,476,107,9,2,https://www.intensivregister.de/api/public/reporting/laendertabelle
1697141114,583,477,106,9,2,https://www.intensivregister.de/api/public/reporting/laendertabelle
1697151914,583,476,107,9,2,https://www.intensivregister.de/api/public/reporting/laendertabelle
1697162715,583,474,109,9,2,https://www.intensivregister.de/api/public/reporting/laendertabelle
1697166314,582,477,105,9,2,https://www.intensivregister.de/api/public/reporting/laendertabelle
1697169914,583,475,108,9,2,https://www.intensivregister.de/api/public/reporting/laendertabelle
1697173514,583,475,108,10,2,https://www.intensivregister.de/api/public/reporting/laendertabelle
1697177115,583,475,108,9,2,https://www.intensivregister.de/api/public/reporting/laendertabelle
1697180715,583,476,107,9,2,https://www.intensivregister.de/api/public/reporting/laendertabelle
1697231115,583,474,109,9,2,https://www.intensivregister.de/api/public/reporting/laendertabelle
1697245514,583,475,108,9,2,https://www.intensivregister.de/api/public/reporting/laendertabelle
1697256314,583,466,117,8,2,https://www.intensivregister.de/api/public/reporting/laendertabelle
1697259915,583,464,119,8,3,https://www.intensivregister.de/api/public/reporting/laendertabelle
1697263515,583,459,124,8,3,https://www.intensivregister.de/api/public/reporting/laendertabelle
1697270715,583,460,123,8,3,https://www.intensivregister.de/api/public/reporting/laendertabelle
1697321114,583,459,124,8,3,https://www.intensivregister.de/api/public/reporting/laendertabelle
1697335514,583,457,126,8,3,https://www.intensivregister.de/api/public/reporting/laendertabelle
1697339114,583,458,125,8,3,https://www.intensivregister.de/api/public/reporting/laendertabelle
1697342714,583,448,135,8,3,https://www.intensivregister.de/api/public/reporting/laendertabelle
1697346315,579,442,137,7,3,https://www.intensivregister.de/api/public/reporting/laendertabelle
1697349915,579,436,143,6,2,https://www.intensivregister.de/api/public/reporting/laendertabelle
1697353514,579,438,141,6,2,https://www.intensivregister.de/api/public/reporting/laendertabelle
1697357114,579,439,140,7,3,https://www.intensivregister.de/api/public/reporting/laendertabelle
1697400315,579,440,139,7,3,https://www.intensivregister.de/api/public/reporting/laendertabelle
1697403914,579,443,136,7,3,https://www.intensivregister.de/api/public/reporting/laendertabelle
1697421914,579,442,137,7,3,https://www.intensivregister.de/api/public/reporting/laendertabelle
1697425515,579,454,125,8,4,https://www.intensivregister.de/api/public/reporting/laendertabelle
1697429115,576,458,118,9,4,https://www.intensivregister.de/api/public/reporting/laendertabelle
1697432715,576,454,122,9,4,https://www.intensivregister.de/api/public/reporting/laendertabelle
1697436314,580,454,126,9,4,https://www.intensivregister.de/api/public/reporting/laendertabelle
1697439915,580,456,124,9,4,https://www.intensivregister.de/api/public/reporting/laendertabelle
1697461514,580,457,123,9,4,https://www.intensivregister.de/api/public/reporting/laendertabelle
1697497514,580,454,126,9,4,https://www.intensivregister.de/api/public/reporting/laendertabelle
1697511914,588,470,118,9,4,https://www.intensivregister.de/api/public/reporting/laendertabelle
1697515514,589,469,120,9,4,https://www.intensivregister.de/api/public/reporting/laendertabelle
1697519114,589,466,123,8,4,https://www.intensivregister.de/api/public/reporting/laendertabelle
1697522715,589,469,120,8,4,https://www.intensivregister.de/api/public/reporting/laendertabelle
1697533522,589,467,122,8,4,https://www.intensivregister.de/api/public/reporting/laendertabelle
1697576714,589,468,121,8,4,https://www.intensivregister.de/api/public/reporting/laendertabelle
1697594714,589,467,122,8,4,https://www.intensivregister.de/api/public/reporting/laendertabelle
1697598314,589,474,115,6,3,https://www.intensivregister.de/api/public/reporting/laendertabelle
1697601915,589,469,120,7,3,https://www.intensivregister.de/api/public/reporting/laendertabelle
1697605515,589,468,121,6,3,https://www.intensivregister.de/api/public/reporting/laendertabelle
1697609115,589,472,117,6,3,https://www.intensivregister.de/api/public/reporting/laendertabelle
1697612714,587,471,116,6,3,https://www.intensivregister.de/api/public/reporting/laendertabelle
1697616314,587,475,112,6,3,https://www.intensivregister.de/api/public/reporting/laendertabelle
1697663115,587,476,111,6,3,https://www.intensivregister.de/api/public/reporting/laendertabelle
1697681114,587,479,108,6,3,https://www.intensivregister.de/api/public/reporting/laendertabelle
1697684714,589,488,101,8,4,https://www.intensivregister.de/api/public/reporting/laendertabelle
1697688314,589,484,105,8,4,https://www.intensivregister.de/api/public/reporting/laendertabelle
1697691915,589,483,106,8,4,https://www.intensivregister.de/api/public/reporting/laendertabelle
1697695514,589,482,107,9,4,https://www.intensivregister.de/api/public/reporting/laendertabelle
1697699114,589,483,106,9,4,https://www.intensivregister.de/api/public/reporting/laendertabelle
1697749514,589,484,105,9,4,https://www.intensivregister.de/api/public/reporting/laendertabelle
1697753114,589,486,103,9,4,https://www.intensivregister.de/api/public/reporting/laendertabelle
1697756714,589,485,104,9,4,https://www.intensivregister.de/api/public/reporting/laendertabelle
1697771114,590,476,114,9,4,https://www.intensivregister.de/api/public/reporting/laendertabelle
1697774714,589,469,120,9,4,https://www.intensivregister.de/api/public/reporting/laendertabelle
1697778314,587,465,122,9,6,https://www.intensivregister.de/api/public/reporting/laendertabelle
1697781914,587,463,124,9,6,https://www.intensivregister.de/api/public/reporting/laendertabelle
1697785514,587,461,126,9,5,https://www.intensivregister.de/api/public/reporting/laendertabelle
1697810715,587,461,126,10,6,https://www.intensivregister.de/api/public/reporting/laendertabelle
1697835915,587,458,129,10,6,https://www.intensivregister.de/api/public/reporting/laendertabelle
1697839515,587,456,131,10,6,https://www.intensivregister.de/api/public/reporting/laendertabelle
1697861114,587,446,141,9,6,https://www.intensivregister.de/api/public/reporting/laendertabelle
1697864715,587,451,136,8,4,https://www.intensivregister.de/api/public/reporting/laendertabelle
1697868314,587,446,141,8,4,https://www.intensivregister.de/api/public/reporting/laendertabelle
1697871915,587,448,139,8,4,https://www.intensivregister.de/api/public/reporting/laendertabelle
1697875515,587,446,141,8,4,https://www.intensivregister.de/api/public/reporting/laendertabelle
1697925914,587,445,142,8,4,https://www.intensivregister.de/api/public/reporting/laendertabelle
1697943914,587,439,148,7,4,https://www.intensivregister.de/api/public/reporting/laendertabelle
1697947514,587,427,160,7,4,https://www.intensivregister.de/api/public/reporting/laendertabelle
1697951114,587,422,165,7,4,https://www.intensivregister.de/api/public/reporting/laendertabelle
1697954714,587,419,168,7,4,https://www.intensivregister.de/api/public/reporting/laendertabelle
1697958314,587,424,163,7,4,https://www.intensivregister.de/api/public/reporting/laendertabelle
1698008714,587,423,164,7,4,https://www.intensivregister.de/api/public/reporting/laendertabelle
1698030314,587,421,166,8,4,https://www.intensivregister.de/api/public/reporting/laendertabelle
1698033915,586,422,164,10,4,https://www.intensivregister.de/api/public/reporting/laendertabelle
1698037515,586,417,169,11,4,https://www.intensivregister.de/api/public/reporting/laendertabelle
1698041115,586,418,168,11,4,https://www.intensivregister.de/api/public/reporting/laendertabelle
1698044714,586,419,167,11,4,https://www.intensivregister.de/api/public/reporting/laendertabelle
1698048314,586,420,166,11,4,https://www.intensivregister.de/api/public/reporting/laendertabelle
1698084314,585,419,166,11,4,https://www.intensivregister.de/api/public/reporting/laendertabelle
1698091515,585,420,165,11,4,https://www.intensivregister.de/api/public/reporting/laendertabelle
1698116715,585,420,165,13,3,https://www.intensivregister.de/api/public/reporting/laendertabelle
1698120314,589,441,148,11,3,https://www.intensivregister.de/api/public/reporting/laendertabelle
1698123914,591,444,147,15,3,https://www.intensivregister.de/api/public/reporting/laendertabelle
1698127515,591,446,145,15,3,https://www.intensivregister.de/api/public/reporting/laendertabelle
1698131114,591,447,144,15,3,https://www.intensivregister.de/api/public/reporting/laendertabelle
1698167115,591,448,143,15,3,https://www.intensivregister.de/api/public/reporting/laendertabelle
1698185115,591,449,142,15,3,https://www.intensivregister.de/api/public/reporting/laendertabelle
1698199515,591,450,141,16,3,https://www.intensivregister.de/api/public/reporting/laendertabelle
1698203115,595,456,139,18,4,https://www.intensivregister.de/api/public/reporting/laendertabelle
1698206715,595,459,136,18,4,https://www.intensivregister.de/api/public/reporting/laendertabelle
1698210315,594,460,134,18,4,https://www.intensivregister.de/api/public/reporting/laendertabelle
1698217515,595,464,131,18,4,https://www.intensivregister.de/api/public/reporting/laendertabelle
1698267914,595,465,130,18,4,https://www.intensivregister.de/api/public/reporting/laendertabelle
1698271514,595,464,131,18,4,https://www.intensivregister.de/api/public/reporting/laendertabelle
1698278714,595,461,134,18,4,https://www.intensivregister.de/api/public/reporting/laendertabelle
1698289515,597,468,129,17,4,https://www.intensivregister.de/api/public/reporting/laendertabelle
1698293115,593,473,120,18,4,https://www.intensivregister.de/api/public/reporting/laendertabelle
1698296714,593,471,122,17,4,https://www.intensivregister.de/api/public/reporting/laendertabelle
1698300315,591,466,125,19,5,https://www.intensivregister.de/api/public/reporting/laendertabelle
1698303915,591,461,130,20,5,https://www.intensivregister.de/api/public/reporting/laendertabelle
1698307515,591,461,130,21,5,https://www.intensivregister.de/api/public/reporting/laendertabelle
1698336314,590,462,128,22,5,https://www.intensivregister.de/api/public/reporting/laendertabelle
1698354314,590,461,129,22,5,https://www.intensivregister.de/api/public/reporting/laendertabelle
1698372314,590,459,131,22,5,https://www.intensivregister.de/api/public/reporting/laendertabelle
1698375915,591,461,130,21,5,https://www.intensivregister.de/api/public/reporting/laendertabelle
1698379514,591,462,129,20,5,https://www.intensivregister.de/api/public/reporting/laendertabelle
1698383114,596,474,122,22,5,https://www.intensivregister.de/api/public/reporting/laendertabelle
1698386715,596,473,123,20,5,https://www.intensivregister.de/api/public/reporting/laendertabelle
1698390314,596,474,122,20,5,https://www.intensivregister.de/api/public/reporting/laendertabelle
1698440715,595,472,123,20,5,https://www.intensivregister.de/api/public/reporting/laendertabelle
1698455114,595,473,122,20,5,https://www.intensivregister.de/api/public/reporting/laendertabelle
1698458714,595,477,118,20,5,https://www.intensivregister.de/api/public/reporting/laendertabelle
1698462315,595,476,119,20,5,https://www.intensivregister.de/api/public/reporting/laendertabelle
1698465914,596,476,120,20,6,https://www.intensivregister.de/api/public/reporting/laendertabelle
1698469514,588,474,114,18,6,https://www.intensivregister.de/api/public/reporting/laendertabelle
1698473115,586,474,112,18,6,https://www.intensivregister.de/api/public/reporting/laendertabelle
1698476714,586,472,114,18,6,https://www.intensivregister.de/api/public/reporting/laendertabelle
1698480315,586,473,113,18,6,https://www.intensivregister.de/api/public/reporting/laendertabelle
1698483915,586,472,114,18,6,https://www.intensivregister.de/api/public/reporting/laendertabelle
1698527114,586,479,107,18,6,https://www.intensivregister.de/api/public/reporting/laendertabelle
1698541515,586,480,106,18,6,https://www.intensivregister.de/api/public/reporting/laendertabelle
1698548715,586,481,105,18,6,https://www.intensivregister.de/api/public/reporting/laendertabelle
1698555915,582,469,113,17,6,https://www.intensivregister.de/api/public/reporting/laendertabelle
1698559514,582,462,120,18,7,https://www.intensivregister.de/api/public/reporting/laendertabelle
1698563115,577,454,123,21,8,https://www.intensivregister.de/api/public/reporting/laendertabelle
1698566715,577,454,123,22,8,https://www.intensivregister.de/api/public/reporting/laendertabelle
1698573922,577,452,125,22,8,https://www.intensivregister.de/api/public/reporting/laendertabelle
1698620714,577,451,126,22,8,https://www.intensivregister.de/api/public/reporting/laendertabelle
1698624314,577,452,125,23,8,https://www.intensivregister.de/api/public/reporting/laendertabelle
1698642315,576,446,130,22,8,https://www.intensivregister.de/api/public/reporting/laendertabelle
1698645915,580,453,127,25,8,https://www.intensivregister.de/api/public/reporting/laendertabelle
1698649514,580,451,129,25,9,https://www.intensivregister.de/api/public/reporting/laendertabelle
1698653113,584,451,133,25,9,https://www.intensivregister.de/api/public/reporting/laendertabelle
1698656714,584,449,135,25,9,https://www.intensivregister.de/api/public/reporting/laendertabelle
1698660314,584,450,134,25,9,https://www.intensivregister.de/api/public/reporting/laendertabelle
1698728714,583,454,129,26,9,https://www.intensivregister.de/api/public/reporting/laendertabelle
1698732313,583,451,132,27,9,https://www.intensivregister.de/api/public/reporting/laendertabelle
1698735913,582,458,124,27,11,https://www.intensivregister.de/api/public/reporting/laendertabelle
1698739514,582,466,116,25,11,https://www.intensivregister.de/api/public/reporting/laendertabelle
1698743113,582,467,115,24,11,https://www.intensivregister.de/api/public/reporting/laendertabelle
1698789913,582,468,114,24,11,https://www.intensivregister.de/api/public/reporting/laendertabelle
1698793514,582,464,118,23,11,https://www.intensivregister.de/api/public/reporting/laendertabelle
1698811513,583,462,121,23,11,https://www.intensivregister.de/api/public/reporting/laendertabelle
1698815113,585,458,127,24,11,https://www.intensivregister.de/api/public/reporting/laendertabelle
1698818714,585,452,133,23,10,https://www.intensivregister.de/api/public/reporting/laendertabelle
1698822313,586,450,136,23,10,https://www.intensivregister.de/api/public/reporting/laendertabelle
1698825913,586,451,135,22,11,https://www.intensivregister.de/api/public/reporting/laendertabelle
1698829513,586,452,134,22,11,https://www.intensivregister.de/api/public/reporting/laendertabelle
1698879914,586,450,136,22,11,https://www.intensivregister.de/api/public/reporting/laendertabelle
1698887113,586,452,134,22,11,https://www.intensivregister.de/api/public/reporting/laendertabelle
1698897914,586,456,130,21,10,https://www.intensivregister.de/api/public/reporting/laendertabelle
1698901513,588,467,121,23,11,https://www.intensivregister.de/api/public/reporting/laendertabelle
1698905113,588,465,123,23,11,https://www.intensivregister.de/api/public/reporting/laendertabelle
1698908714,594,471,123,21,10,https://www.intensivregister.de/api/public/reporting/laendertabelle
1698912314,594,471,123,20,10,https://www.intensivregister.de/api/public/reporting/laendertabelle
1698915913,594,473,121,22,10,https://www.intensivregister.de/api/public/reporting/laendertabelle
1698930313,593,471,122,21,10,https://www.intensivregister.de/api/public/reporting/laendertabelle
1698966313,593,473,120,21,10,https://www.intensivregister.de/api/public/reporting/laendertabelle
1698969914,593,474,119,21,10,https://www.intensivregister.de/api/public/reporting/laendertabelle
1698987913,595,482,113,20,9,https://www.intensivregister.de/api/public/reporting/laendertabelle
1698991514,595,487,108,24,9,https://www.intensivregister.de/api/public/reporting/laendertabelle
1698995113,595,493,102,27,9,https://www.intensivregister.de/api/public/reporting/laendertabelle
1698998713,595,492,103,28,9,https://www.intensivregister.de/api/public/reporting/laendertabelle
1699005913,595,492,103,27,9,https://www.intensivregister.de/api/public/reporting/laendertabelle
1699045513,595,493,102,27,9,https://www.intensivregister.de/api/public/reporting/laendertabelle
1699052713,595,489,106,27,9,https://www.intensivregister.de/api/public/reporting/laendertabelle
1699074313,596,489,107,27,9,https://www.intensivregister.de/api/public/reporting/laendertabelle
1699077913,593,484,109,27,8,https://www.intensivregister.de/api/public/reporting/laendertabelle
1699081513,593,482,111,27,7,https://www.intensivregister.de/api/public/reporting/laendertabelle
1699085113,593,482,111,25,5,https://www.intensivregister.de/api/public/reporting/laendertabelle
1699088713,595,482,113,24,5,https://www.intensivregister.de/api/public/reporting/laendertabelle
1699092313,595,478,117,28,5,https://www.intensivregister.de/api/public/reporting/laendertabelle
1699110313,595,477,118,28,5,https://www.intensivregister.de/api/public/reporting/laendertabelle
1699139113,595,480,115,28,5,https://www.intensivregister.de/api/public/reporting/laendertabelle
1699160713,595,476,119,28,5,https://www.intensivregister.de/api/public/reporting/laendertabelle
1699164313,595,474,121,30,5,https://www.intensivregister.de/api/public/reporting/laendertabelle
1699167913,595,473,122,29,5,https://www.intensivregister.de/api/public/reporting/laendertabelle
1699171514,591,461,130,28,5,https://www.intensivregister.de/api/public/reporting/laendertabelle
1699175113,591,459,132,27,5,https://www.intensivregister.de/api/public/reporting/laendertabelle
1699178713,591,464,127,27,5,https://www.intensivregister.de/api/public/reporting/laendertabelle
1699214713,591,463,128,27,5,https://www.intensivregister.de/api/public/reporting/laendertabelle
1699221916,591,462,129,27,5,https://www.intensivregister.de/api/public/reporting/laendertabelle
1699243513,591,464,127,28,5,https://www.intensivregister.de/api/public/reporting/laendertabelle
1699247113,591,454,137,27,5,https://www.intensivregister.de/api/public/reporting/laendertabelle
1699250714,593,448,145,30,6,https://www.intensivregister.de/api/public/reporting/laendertabelle
1699254314,591,440,151,30,6,https://www.intensivregister.de/api/public/reporting/laendertabelle
1699257913,591,440,151,31,7,https://www.intensivregister.de/api/public/reporting/laendertabelle
1699261513,591,442,149,30,7,https://www.intensivregister.de/api/public/reporting/laendertabelle
1699268716,591,442,149,29,7,https://www.intensivregister.de/api/public/reporting/laendertabelle
1699275913,591,446,145,29,7,https://www.intensivregister.de/api/public/reporting/laendertabelle
1699311913,591,445,146,29,7,https://www.intensivregister.de/api/public/reporting/laendertabelle
1699329913,597,458,139,29,7,https://www.intensivregister.de/api/public/reporting/laendertabelle
1699333513,597,462,135,29,7,https://www.intensivregister.de/api/public/reporting/laendertabelle
1699337113,597,465,132,29,7,https://www.intensivregister.de/api/public/reporting/laendertabelle
1699340714,597,466,131,30,8,https://www.intensivregister.de/api/public/reporting/laendertabelle
1699344313,597,469,128,31,8,https://www.intensivregister.de/api/public/reporting/laendertabelle
1699347913,597,468,129,31,8,https://www.intensivregister.de/api/public/reporting/laendertabelle
1699351513,597,470,127,32,8,https://www.intensivregister.de/api/public/reporting/laendertabelle
1699401914,597,475,122,32,8,https://www.intensivregister.de/api/public/reporting/laendertabelle
1699412713,597,472,125,34,9,https://www.intensivregister.de/api/public/reporting/laendertabelle
1699419914,597,477,120,35,9,https://www.intensivregister.de/api/public/reporting/laendertabelle
1699423513,596,478,118,35,9,https://www.intensivregister.de/api/public/reporting/laendertabelle
1699427113,597,478,119,38,8,https://www.intensivregister.de/api/public/reporting/laendertabelle
1699430713,597,476,121,36,8,https://www.intensivregister.de/api/public/reporting/laendertabelle
1699437913,597,475,122,36,8,https://www.intensivregister.de/api/public/reporting/laendertabelle
1699484713,597,478,119,36,9,https://www.intensivregister.de/api/public/reporting/laendertabelle
1699502713,595,476,119,36,9,https://www.intensivregister.de/api/public/reporting/laendertabelle
1699506313,597,480,117,40,10,https://www.intensivregister.de/api/public/reporting/laendertabelle
1699509914,595,473,122,39,8,https://www.intensivregister.de/api/public/reporting/laendertabelle
1699513513,594,471,123,38,8,https://www.intensivregister.de/api/public/reporting/laendertabelle
1699520713,594,472,122,37,8,https://www.intensivregister.de/api/public/reporting/laendertabelle
1699524313,594,471,123,37,8,https://www.intensivregister.de/api/public/reporting/laendertabelle
1699571113,594,469,125,37,8,https://www.intensivregister.de/api/public/reporting/laendertabelle
1699589113,594,468,126,37,8,https://www.intensivregister.de/api/public/reporting/laendertabelle
1699592713,595,473,122,36,8,https://www.intensivregister.de/api/public/reporting/laendertabelle
1699596316,595,483,112,38,8,https://www.intensivregister.de/api/public/reporting/laendertabelle
1699599913,597,485,112,33,8,https://www.intensivregister.de/api/public/reporting/laendertabelle
1699603513,597,486,111,33,8,https://www.intensivregister.de/api/public/reporting/laendertabelle
1699607113,597,486,111,34,8,https://www.intensivregister.de/api/public/reporting/laendertabelle
1699657513,597,483,114,34,8,https://www.intensivregister.de/api/public/reporting/laendertabelle
1699661113,597,481,116,34,8,https://www.intensivregister.de/api/public/reporting/laendertabelle
1699682713,591,476,115,32,8,https://www.intensivregister.de/api/public/reporting/laendertabelle
1699686313,591,472,119,32,8,https://www.intensivregister.de/api/public/reporting/laendertabelle
1699689913,591,464,127,31,8,https://www.intensivregister.de/api/public/reporting/laendertabelle
1699693513,591,462,129,31,8,https://www.intensivregister.de/api/public/reporting/laendertabelle
1699718713,591,459,132,30,7,https://www.intensivregister.de/api/public/reporting/laendertabelle
1699743913,591,458,133,30,7,https://www.intensivregister.de/api/public/reporting/laendertabelle
1699765513,591,459,132,30,7,https://www.intensivregister.de/api/public/reporting/laendertabelle
1699769113,591,457,134,32,9,https://www.intensivregister.de/api/public/reporting/laendertabelle
1699772714,591,459,132,32,9,https://www.intensivregister.de/api/public/reporting/laendertabelle
1699776313,589,460,129,31,9,https://www.intensivregister.de/api/public/reporting/laendertabelle
1699779913,589,462,127,30,9,https://www.intensivregister.de/api/public/reporting/laendertabelle
1699783513,589,462,127,36,13,https://www.intensivregister.de/api/public/reporting/laendertabelle
1699794314,589,460,129,37,13,https://www.intensivregister.de/api/public/reporting/laendertabelle
1699848313,589,459,130,37,13,https://www.intensivregister.de/api/public/reporting/laendertabelle
1699851913,586,449,137,41,14,https://www.intensivregister.de/api/public/reporting/laendertabelle
1699855514,586,444,142,43,15,https://www.intensivregister.de/api/public/reporting/laendertabelle
1699859114,586,443,143,43,15,https://www.intensivregister.de/api/public/reporting/laendertabelle
1699869913,586,444,142,43,15,https://www.intensivregister.de/api/public/reporting/laendertabelle
1699920314,586,443,143,43,15,https://www.intensivregister.de/api/public/reporting/laendertabelle
1699923915,586,444,142,43,15,https://www.intensivregister.de/api/public/reporting/laendertabelle
1699934715,586,446,140,43,15,https://www.intensivregister.de/api/public/reporting/laendertabelle
1699938315,587,440,147,40,13,https://www.intensivregister.de/api/public/reporting/laendertabelle
1699941915,591,439,152,40,13,https://www.intensivregister.de/api/public/reporting/laendertabelle
1699945515,590,449,141,43,12,https://www.intensivregister.de/api/public/reporting/laendertabelle
1699949115,595,459,136,43,12,https://www.intensivregister.de/api/public/reporting/laendertabelle
1699952715,595,460,135,42,12,https://www.intensivregister.de/api/public/reporting/laendertabelle
1699999518,595,463,132,42,12,https://www.intensivregister.de/api/public/reporting/laendertabelle
1700003118,595,464,131,42,12,https://www.intensivregister.de/api/public/reporting/laendertabelle
1700006747,595,465,130,42,13,https://www.intensivregister.de/api/public/reporting/laendertabelle
1700021118,595,465,130,43,13,https://www.intensivregister.de/api/public/reporting/laendertabelle
1700024717,599,480,119,42,13,https://www.intensivregister.de/api/public/reporting/laendertabelle
1700028318,597,479,118,47,16,https://www.intensivregister.de/api/public/reporting/laendertabelle
1700031918,597,475,122,46,16,https://www.intensivregister.de/api/public/reporting/laendertabelle
1700035517,597,474,123,47,15,https://www.intensivregister.de/api/public/reporting/laendertabelle
1700042718,597,474,123,48,16,https://www.intensivregister.de/api/public/reporting/laendertabelle
