Datum,IntensivbettenGesamt,IntensivbettenBelegt,IntensivBettenFrei,COVID19FaelleAktuell,COVID19FaelleBeatmet,Quelle
1588248000,32821,19997,12824,2282,1587,https://diviexchange.z6.web.core.windows.net/laendertabelle1.svg
1588251600,32843,20005,12838,2282,1585,https://diviexchange.z6.web.core.windows.net/laendertabelle1.svg
1588255200,32853,19999,12854,2272,1584,https://diviexchange.z6.web.core.windows.net/laendertabelle1.svg
1588255200,32853,20007,12846,2274,1583,https://diviexchange.z6.web.core.windows.net/laendertabelle1.svg
1588262400,33051,20120,12931,2281,1592,https://diviexchange.z6.web.core.windows.net/laendertabelle1.svg
1588266000,33049,20109,12940,2280,1592,https://diviexchange.z6.web.core.windows.net/laendertabelle1.svg
1588269600,32988,20082,12906,2279,1592,https://diviexchange.z6.web.core.windows.net/laendertabelle1.svg
1588273200,32968,20073,12895,2278,1591,https://diviexchange.z6.web.core.windows.net/laendertabelle1.svg
1588276800,32960,20069,12891,2276,1590,https://diviexchange.z6.web.core.windows.net/laendertabelle1.svg
1588284000,32960,20069,12891,2273,1587,https://diviexchange.z6.web.core.windows.net/laendertabelle1.svg
1588287600,32944,20061,12883,2272,1586,https://diviexchange.z6.web.core.windows.net/laendertabelle1.svg
1588291200,32944,20065,12879,2273,1587,https://diviexchange.z6.web.core.windows.net/laendertabelle1.svg
1588294800,32944,20062,12882,2273,1587,https://diviexchange.z6.web.core.windows.net/laendertabelle1.svg
1588298400,32944,20065,12879,2269,1585,https://diviexchange.z6.web.core.windows.net/laendertabelle1.svg
1588302000,32946,20070,12876,2266,1584,https://diviexchange.z6.web.core.windows.net/laendertabelle1.svg
1588305600,32943,20066,12877,2265,1583,https://diviexchange.z6.web.core.windows.net/laendertabelle1.svg
1588309200,32970,20090,12880,2264,1581,https://diviexchange.z6.web.core.windows.net/laendertabelle1.svg
1588312800,32958,20024,12934,2253,1574,https://diviexchange.z6.web.core.windows.net/laendertabelle1.svg
1588316400,33064,20150,12914,2167,1554,https://diviexchange.z6.web.core.windows.net/laendertabelle1.svg
1588320000,33028,20114,12914,2157,1553,https://diviexchange.z6.web.core.windows.net/laendertabelle1.svg
1588323600,33027,20110,12917,2158,1556,https://diviexchange.z6.web.core.windows.net/laendertabelle1.svg
1588327200,33078,20123,12955,2167,1561,https://diviexchange.z6.web.core.windows.net/laendertabelle1.svg
1588330800,33088,20130,12958,2168,1559,https://diviexchange.z6.web.core.windows.net/laendertabelle1.svg
1588334400,33099,20132,12967,2167,1558,https://diviexchange.z6.web.core.windows.net/laendertabelle1.svg
1588338000,33098,20122,12976,2166,1556,https://diviexchange.z6.web.core.windows.net/laendertabelle1.svg
1588341600,33093,20113,12980,2160,1554,https://diviexchange.z6.web.core.windows.net/laendertabelle1.svg
1588345200,33093,20096,12997,2158,1554,https://diviexchange.z6.web.core.windows.net/laendertabelle1.svg
1588348800,33092,20098,12994,2160,1554,https://diviexchange.z6.web.core.windows.net/laendertabelle1.svg
1588352400,33088,20099,12989,2160,1554,https://diviexchange.z6.web.core.windows.net/laendertabelle1.svg
1588356000,33081,20092,12989,2159,1553,https://diviexchange.z6.web.core.windows.net/laendertabelle1.svg
1588359600,32987,20030,12957,2153,1552,https://diviexchange.z6.web.core.windows.net/laendertabelle1.svg
1588363200,32805,19937,12868,2134,1535,https://diviexchange.z6.web.core.windows.net/laendertabelle1.svg
1588366800,32797,19939,12858,2133,1535,https://diviexchange.z6.web.core.windows.net/laendertabelle1.svg
1588370400,32797,19936,12861,2133,1535,https://diviexchange.z6.web.core.windows.net/laendertabelle1.svg
1588374000,32783,19920,12863,2136,1536,https://diviexchange.z6.web.core.windows.net/laendertabelle1.svg
1588377600,32783,19919,12864,2136,1536,https://diviexchange.z6.web.core.windows.net/laendertabelle1.svg
1588381200,32765,19890,12875,2136,1535,https://diviexchange.z6.web.core.windows.net/laendertabelle1.svg
1588384800,32765,19887,12878,2136,1535,https://diviexchange.z6.web.core.windows.net/laendertabelle1.svg
1588388400,32762,19885,12877,2135,1535,https://diviexchange.z6.web.core.windows.net/laendertabelle1.svg
1588392000,32753,19864,12889,2136,1536,https://diviexchange.z6.web.core.windows.net/laendertabelle1.svg
1588395600,32781,19856,12925,2134,1533,https://diviexchange.z6.web.core.windows.net/laendertabelle1.svg
1588399200,32808,19788,13020,2120,1520,https://diviexchange.z6.web.core.windows.net/laendertabelle1.svg
1588402800,32801,19392,13409,2076,1497,https://diviexchange.z6.web.core.windows.net/laendertabelle1.svg
1588406400,32834,19366,13468,2073,1492,https://diviexchange.z6.web.core.windows.net/laendertabelle1.svg
1588410000,32863,19386,13477,2071,1489,https://diviexchange.z6.web.core.windows.net/laendertabelle1.svg
1588413600,32860,19381,13479,2069,1487,https://diviexchange.z6.web.core.windows.net/laendertabelle1.svg
1588417200,32863,19383,13480,2070,1488,https://diviexchange.z6.web.core.windows.net/laendertabelle1.svg
1588420800,32862,19386,13476,2070,1488,https://diviexchange.z6.web.core.windows.net/laendertabelle1.svg
1588424400,32862,19373,13489,2068,1487,https://diviexchange.z6.web.core.windows.net/laendertabelle1.svg
1588428000,32868,19360,13508,2068,1486,https://diviexchange.z6.web.core.windows.net/laendertabelle1.svg
1588431600,32872,19359,13513,2068,1486,https://diviexchange.z6.web.core.windows.net/laendertabelle1.svg
1588435200,32873,19351,13522,2068,1486,https://diviexchange.z6.web.core.windows.net/laendertabelle1.svg
1588438800,32851,19330,13521,2068,1486,https://diviexchange.z6.web.core.windows.net/laendertabelle1.svg
1588442400,32762,19277,13485,2062,1483,https://diviexchange.z6.web.core.windows.net/laendertabelle1.svg
1588446000,32585,19155,13430,2052,1479,https://diviexchange.z6.web.core.windows.net/laendertabelle1.svg
1588449600,32494,19088,13406,2050,1477,https://diviexchange.z6.web.core.windows.net/laendertabelle1.svg
1588453200,32410,19031,13379,2042,1472,https://diviexchange.z6.web.core.windows.net/laendertabelle1.svg
1588456800,32324,18994,13330,2033,1463,https://diviexchange.z6.web.core.windows.net/laendertabelle1.svg
1588460400,32309,18987,13322,2032,1462,https://diviexchange.z6.web.core.windows.net/laendertabelle1.svg
1588464000,32300,18986,13314,2032,1462,https://diviexchange.z6.web.core.windows.net/laendertabelle1.svg
1588467600,32277,18981,13296,2031,1463,https://diviexchange.z6.web.core.windows.net/laendertabelle1.svg
1588471200,32258,18972,13286,2041,1463,https://diviexchange.z6.web.core.windows.net/laendertabelle1.svg
1588474800,32159,18919,13240,2039,1461,https://diviexchange.z6.web.core.windows.net/laendertabelle1.svg
1588478400,31997,18823,13174,2027,1452,https://diviexchange.z6.web.core.windows.net/laendertabelle1.svg
1588482000,31995,18830,13165,2021,1448,https://diviexchange.z6.web.core.windows.net/laendertabelle1.svg
1588485600,31950,18845,13105,1989,1443,https://diviexchange.z6.web.core.windows.net/laendertabelle1.svg
1588489200,31988,18931,13057,1989,1426,https://diviexchange.z6.web.core.windows.net/laendertabelle1.svg
1588492800,32009,18980,13029,1990,1422,https://diviexchange.z6.web.core.windows.net/laendertabelle1.svg
1588496400,32025,19003,13022,1985,1420,https://diviexchange.z6.web.core.windows.net/laendertabelle1.svg
1588500000,32069,19020,13049,1984,1419,https://diviexchange.z6.web.core.windows.net/laendertabelle1.svg
1588503600,32119,19040,13079,1990,1426,https://diviexchange.z6.web.core.windows.net/laendertabelle1.svg
1588507200,32119,19041,13078,1990,1426,https://diviexchange.z6.web.core.windows.net/laendertabelle1.svg
1588510800,32119,19037,13082,1988,1422,https://diviexchange.z6.web.core.windows.net/laendertabelle1.svg
1588514400,32120,19018,13102,1991,1422,https://diviexchange.z6.web.core.windows.net/laendertabelle1.svg
1588518000,32120,19008,13112,1990,1422,https://diviexchange.z6.web.core.windows.net/laendertabelle1.svg
1588521600,32121,19002,13119,1989,1423,https://diviexchange.z6.web.core.windows.net/laendertabelle1.svg
1588525200,32121,19001,13120,1987,1421,https://diviexchange.z6.web.core.windows.net/laendertabelle1.svg
1588528800,32125,19000,13125,1987,1421,https://diviexchange.z6.web.core.windows.net/laendertabelle1.svg
1588532400,32048,18941,13107,1977,1410,https://diviexchange.z6.web.core.windows.net/laendertabelle1.svg
1588536000,32046,18941,13105,1977,1410,https://diviexchange.z6.web.core.windows.net/laendertabelle1.svg
1588539600,32046,18944,13102,1977,1410,https://diviexchange.z6.web.core.windows.net/laendertabelle1.svg
1588543200,31963,18915,13048,1974,1410,https://diviexchange.z6.web.core.windows.net/laendertabelle1.svg
1588546800,31963,18916,13047,1974,1410,https://diviexchange.z6.web.core.windows.net/laendertabelle1.svg
1588550400,31962,18915,13047,1974,1410,https://diviexchange.z6.web.core.windows.net/laendertabelle1.svg
1588554000,31932,18895,13037,1973,1409,https://diviexchange.z6.web.core.windows.net/laendertabelle1.svg
1588561200,31918,18881,13037,1973,1409,https://diviexchange.z6.web.core.windows.net/laendertabelle1.svg
1588564800,31914,18886,13028,1973,1408,https://diviexchange.z6.web.core.windows.net/laendertabelle1.svg
1588568400,31938,18949,12989,1975,1411,https://diviexchange.z6.web.core.windows.net/laendertabelle1.svg
1588572000,32063,18976,13087,1952,1403,https://diviexchange.z6.web.core.windows.net/laendertabelle1.svg
1588575600,32155,19087,13068,1963,1382,https://diviexchange.z6.web.core.windows.net/laendertabelle1.svg
1588579200,32244,19157,13087,1950,1368,https://diviexchange.z6.web.core.windows.net/laendertabelle1.svg
1588582800,32397,19185,13212,1967,1381,https://diviexchange.z6.web.core.windows.net/laendertabelle1.svg
1588586400,32603,19310,13293,1985,1394,https://diviexchange.z6.web.core.windows.net/laendertabelle1.svg
1588590000,32638,19318,13320,1991,1393,https://diviexchange.z6.web.core.windows.net/laendertabelle1.svg
1588593600,32666,19323,13343,1992,1397,https://diviexchange.z6.web.core.windows.net/laendertabelle1.svg
1588597200,32669,19321,13348,1990,1396,https://diviexchange.z6.web.core.windows.net/laendertabelle1.svg
1588604400,32694,19335,13359,1990,1395,https://diviexchange.z6.web.core.windows.net/laendertabelle1.svg
1588608000,32721,19332,13389,1986,1395,https://diviexchange.z6.web.core.windows.net/laendertabelle1.svg
1588611600,32721,19331,13390,1986,1395,https://diviexchange.z6.web.core.windows.net/laendertabelle1.svg
1588615200,32710,19324,13386,1986,1395,https://diviexchange.z6.web.core.windows.net/laendertabelle1.svg
1588618800,32705,19321,13384,1987,1396,https://diviexchange.z6.web.core.windows.net/laendertabelle1.svg
1588622400,32707,19326,13381,1986,1396,https://diviexchange.z6.web.core.windows.net/laendertabelle1.svg
1588626000,32720,19336,13384,1987,1397,https://diviexchange.z6.web.core.windows.net/laendertabelle1.svg
1588629600,32720,19339,13381,1987,1397,https://diviexchange.z6.web.core.windows.net/laendertabelle1.svg
1588633200,32709,19327,13382,1986,1396,https://diviexchange.z6.web.core.windows.net/laendertabelle1.svg
1588636800,32708,19327,13381,1986,1396,https://diviexchange.z6.web.core.windows.net/laendertabelle1.svg
1588640400,32707,19329,13378,1986,1396,https://diviexchange.z6.web.core.windows.net/laendertabelle1.svg
1588651200,32687,19333,13354,1986,1396,https://diviexchange.z6.web.core.windows.net/laendertabelle1.svg
1588654800,32723,19415,13308,1975,1387,https://diviexchange.z6.web.core.windows.net/laendertabelle1.svg
1588658400,32799,19606,13193,1958,1363,https://diviexchange.z6.web.core.windows.net/laendertabelle1.svg
1588662000,32752,19887,12865,1922,1339,https://diviexchange.z6.web.core.windows.net/laendertabelle1.svg
1588665600,32722,19970,12752,1907,1321,https://diviexchange.z6.web.core.windows.net/laendertabelle1.svg
1588669200,32734,19983,12751,1904,1320,https://diviexchange.z6.web.core.windows.net/laendertabelle1.svg
1588672800,32740,19994,12746,1904,1319,https://diviexchange.z6.web.core.windows.net/laendertabelle1.svg
1588676400,32714,19969,12745,1900,1316,https://diviexchange.z6.web.core.windows.net/laendertabelle1.svg
1588680000,32743,19996,12747,1915,1329,https://diviexchange.z6.web.core.windows.net/laendertabelle1.svg
1588683600,32753,19998,12755,1915,1329,https://diviexchange.z6.web.core.windows.net/laendertabelle1.svg
1588687200,32753,19996,12757,1913,1328,https://diviexchange.z6.web.core.windows.net/laendertabelle1.svg
1588690800,32753,19987,12766,1912,1328,https://diviexchange.z6.web.core.windows.net/laendertabelle1.svg
1588694400,32777,20000,12777,1919,1336,https://diviexchange.z6.web.core.windows.net/laendertabelle1.svg
1588698000,32763,20000,12763,1920,1337,https://diviexchange.z6.web.core.windows.net/laendertabelle1.svg
1588701600,32752,20001,12751,1920,1334,https://diviexchange.z6.web.core.windows.net/laendertabelle1.svg
1588705200,32728,19983,12745,1920,1334,https://diviexchange.z6.web.core.windows.net/laendertabelle1.svg
1588708800,32722,19973,12749,1920,1334,https://diviexchange.z6.web.core.windows.net/laendertabelle1.svg
1588712400,32722,19965,12757,1919,1334,https://diviexchange.z6.web.core.windows.net/laendertabelle1.svg
1588723200,32722,19969,12753,1919,1334,https://diviexchange.z6.web.core.windows.net/laendertabelle1.svg
1588734000,32722,19971,12751,1919,1334,https://diviexchange.z6.web.core.windows.net/laendertabelle1.svg
1588737600,32722,19970,12752,1919,1332,https://diviexchange.z6.web.core.windows.net/laendertabelle1.svg
1588741200,32712,19964,12748,1911,1326,https://diviexchange.z6.web.core.windows.net/laendertabelle1.svg
1588744800,32773,20131,12642,1887,1317,https://diviexchange.z6.web.core.windows.net/laendertabelle1.svg
1588748400,32774,20250,12524,1857,1278,https://diviexchange.z6.web.core.windows.net/laendertabelle1.svg
1588752000,32881,20371,12510,1856,1276,https://diviexchange.z6.web.core.windows.net/laendertabelle1.svg
1588755600,32890,20397,12493,1858,1279,https://diviexchange.z6.web.core.windows.net/laendertabelle1.svg
1588759200,32904,20427,12477,1853,1267,https://diviexchange.z6.web.core.windows.net/laendertabelle1.svg
1588762800,32903,20423,12480,1849,1264,https://diviexchange.z6.web.core.windows.net/laendertabelle1.svg
1588766400,32925,20447,12478,1861,1278,https://diviexchange.z6.web.core.windows.net/laendertabelle1.svg
1588770000,32920,20449,12471,1862,1278,https://diviexchange.z6.web.core.windows.net/laendertabelle1.svg
1588773600,32906,20453,12453,1863,1279,https://diviexchange.z6.web.core.windows.net/laendertabelle1.svg
1588777200,32913,20455,12458,1863,1279,https://diviexchange.z6.web.core.windows.net/laendertabelle1.svg
1588780800,32900,20438,12462,1860,1279,https://diviexchange.z6.web.core.windows.net/laendertabelle1.svg
1588784400,32900,20431,12469,1861,1279,https://diviexchange.z6.web.core.windows.net/laendertabelle1.svg
1588788000,32872,20418,12454,1860,1279,https://diviexchange.z6.web.core.windows.net/laendertabelle1.svg
1588791600,32852,20412,12440,1863,1279,https://diviexchange.z6.web.core.windows.net/laendertabelle1.svg
1588795200,32852,20404,12448,1862,1278,https://diviexchange.z6.web.core.windows.net/laendertabelle1.svg
1588798800,32829,20391,12438,1864,1278,https://diviexchange.z6.web.core.windows.net/laendertabelle1.svg
1588802400,32793,20369,12424,1859,1275,https://diviexchange.z6.web.core.windows.net/laendertabelle1.svg
1588806000,32793,20367,12426,1859,1275,https://diviexchange.z6.web.core.windows.net/laendertabelle1.svg
1588809600,32773,20365,12408,1858,1275,https://diviexchange.z6.web.core.windows.net/laendertabelle1.svg
1588816800,32774,20367,12407,1858,1275,https://diviexchange.z6.web.core.windows.net/laendertabelle1.svg
1588820400,32768,20364,12404,1858,1275,https://diviexchange.z6.web.core.windows.net/laendertabelle1.svg
1588824000,32769,20358,12411,1856,1273,https://diviexchange.z6.web.core.windows.net/laendertabelle1.svg
1588827600,32774,20387,12387,1867,1265,https://diviexchange.z6.web.core.windows.net/laendertabelle1.svg
1588831200,32858,20432,12426,1836,1236,https://diviexchange.z6.web.core.windows.net/laendertabelle1.svg
1588834800,32804,20390,12414,1794,1224,https://diviexchange.z6.web.core.windows.net/laendertabelle1.svg
1588838400,32836,20417,12419,1795,1223,https://diviexchange.z6.web.core.windows.net/laendertabelle1.svg
1588842000,32806,20379,12427,1792,1220,https://diviexchange.z6.web.core.windows.net/laendertabelle1.svg
1588845600,32807,20383,12424,1791,1220,https://diviexchange.z6.web.core.windows.net/laendertabelle1.svg
1588849200,32804,20373,12431,1791,1219,https://diviexchange.z6.web.core.windows.net/laendertabelle1.svg
1588852800,32828,20388,12440,1790,1218,https://diviexchange.z6.web.core.windows.net/laendertabelle1.svg
1588856400,32853,20427,12426,1804,1226,https://diviexchange.z6.web.core.windows.net/laendertabelle1.svg
1588860000,32846,20418,12428,1802,1224,https://diviexchange.z6.web.core.windows.net/laendertabelle1.svg
1588863600,32855,20415,12440,1799,1221,https://diviexchange.z6.web.core.windows.net/laendertabelle1.svg
1588867200,32852,20404,12448,1799,1221,https://diviexchange.z6.web.core.windows.net/laendertabelle1.svg
1588870800,32851,20391,12460,1799,1221,https://diviexchange.z6.web.core.windows.net/laendertabelle1.svg
1588874400,32856,20395,12461,1799,1220,https://diviexchange.z6.web.core.windows.net/laendertabelle1.svg
1588878000,32785,20350,12435,1799,1220,https://diviexchange.z6.web.core.windows.net/laendertabelle1.svg
1588881600,32785,20350,12435,1798,1220,https://diviexchange.z6.web.core.windows.net/laendertabelle1.svg
1588885200,32779,20345,12434,1798,1220,https://diviexchange.z6.web.core.windows.net/laendertabelle1.svg
1588888800,32779,20347,12432,1798,1220,https://diviexchange.z6.web.core.windows.net/laendertabelle1.svg
1588896000,32751,20329,12422,1798,1220,https://diviexchange.z6.web.core.windows.net/laendertabelle1.svg
1588906800,32749,20326,12423,1798,1220,https://diviexchange.z6.web.core.windows.net/laendertabelle1.svg
1588910400,32749,20328,12421,1794,1217,https://diviexchange.z6.web.core.windows.net/laendertabelle1.svg
1588914000,32732,20364,12368,1785,1212,https://diviexchange.z6.web.core.windows.net/laendertabelle1.svg
1588917600,32652,20356,12296,1759,1199,https://diviexchange.z6.web.core.windows.net/laendertabelle1.svg
1588921200,32741,20379,12362,1696,1161,https://diviexchange.z6.web.core.windows.net/laendertabelle1.svg
1588924800,32737,20386,12351,1701,1164,https://diviexchange.z6.web.core.windows.net/laendertabelle1.svg
1588932000,32793,20456,12337,1698,1160,https://diviexchange.z6.web.core.windows.net/laendertabelle1.svg
1588935600,32791,20457,12334,1696,1157,https://diviexchange.z6.web.core.windows.net/laendertabelle1.svg
1588939200,32791,20446,12345,1686,1152,https://diviexchange.z6.web.core.windows.net/laendertabelle1.svg
1588942800,32794,20455,12339,1686,1151,https://diviexchange.z6.web.core.windows.net/laendertabelle1.svg
1588946400,32787,20455,12332,1681,1146,https://diviexchange.z6.web.core.windows.net/laendertabelle1.svg
1588950000,32788,20461,12327,1682,1146,https://diviexchange.z6.web.core.windows.net/laendertabelle1.svg
1588957200,32728,20424,12304,1670,1137,https://diviexchange.z6.web.core.windows.net/laendertabelle1.svg
1588960800,32726,20425,12301,1670,1137,https://diviexchange.z6.web.core.windows.net/laendertabelle1.svg
1588964400,32711,20415,12296,1669,1137,https://diviexchange.z6.web.core.windows.net/laendertabelle1.svg
1588968000,32655,20395,12260,1669,1137,https://diviexchange.z6.web.core.windows.net/laendertabelle1.svg
1588971600,32579,20343,12236,1668,1136,https://diviexchange.z6.web.core.windows.net/laendertabelle1.svg
1588975200,32579,20341,12238,1667,1135,https://diviexchange.z6.web.core.windows.net/laendertabelle1.svg
1588978800,32579,20337,12242,1667,1135,https://diviexchange.z6.web.core.windows.net/laendertabelle1.svg
1588986000,32583,20338,12245,1667,1135,https://diviexchange.z6.web.core.windows.net/laendertabelle1.svg
1588989600,32582,20338,12244,1667,1135,https://diviexchange.z6.web.core.windows.net/laendertabelle1.svg
1588996800,32583,20333,12250,1666,1135,https://diviexchange.z6.web.core.windows.net/laendertabelle1.svg
1589000400,32587,20327,12260,1663,1131,https://diviexchange.z6.web.core.windows.net/laendertabelle1.svg
1589004000,32621,20235,12386,1663,1125,https://diviexchange.z6.web.core.windows.net/laendertabelle1.svg
1589007600,32619,20159,12460,1623,1105,https://diviexchange.z6.web.core.windows.net/laendertabelle1.svg
1589011200,32642,20177,12465,1621,1107,https://diviexchange.z6.web.core.windows.net/laendertabelle1.svg
1589014800,32657,20159,12498,1617,1107,https://diviexchange.z6.web.core.windows.net/laendertabelle1.svg
1589018400,32644,20156,12488,1618,1109,https://diviexchange.z6.web.core.windows.net/laendertabelle1.svg
1589022000,32643,20142,12501,1616,1109,https://diviexchange.z6.web.core.windows.net/laendertabelle1.svg
1589025600,32636,20142,12494,1615,1109,https://diviexchange.z6.web.core.windows.net/laendertabelle1.svg
1589029200,32629,20137,12492,1615,1109,https://diviexchange.z6.web.core.windows.net/laendertabelle1.svg
1589032800,32609,20123,12486,1616,1110,https://diviexchange.z6.web.core.windows.net/laendertabelle1.svg
1589036400,32609,20119,12490,1616,1110,https://diviexchange.z6.web.core.windows.net/laendertabelle1.svg
1589040000,32608,20109,12499,1616,1109,https://diviexchange.z6.web.core.windows.net/laendertabelle1.svg
1589043600,32598,20093,12505,1617,1109,https://diviexchange.z6.web.core.windows.net/laendertabelle1.svg
1589047200,32533,20055,12478,1611,1106,https://diviexchange.z6.web.core.windows.net/laendertabelle1.svg
1589050800,32532,20055,12477,1611,1106,https://diviexchange.z6.web.core.windows.net/laendertabelle1.svg
1589054400,32531,20058,12473,1611,1105,https://diviexchange.z6.web.core.windows.net/laendertabelle1.svg
1589058000,32556,20071,12485,1617,1109,https://diviexchange.z6.web.core.windows.net/laendertabelle1.svg
1589061600,32533,20061,12472,1617,1109,https://diviexchange.z6.web.core.windows.net/laendertabelle1.svg
1589065200,32485,20024,12461,1614,1108,https://diviexchange.z6.web.core.windows.net/laendertabelle1.svg
1589068800,32396,19953,12443,1599,1097,https://diviexchange.z6.web.core.windows.net/laendertabelle1.svg
1589072400,32391,19937,12454,1599,1097,https://diviexchange.z6.web.core.windows.net/laendertabelle1.svg
1589076000,32388,19933,12455,1599,1097,https://diviexchange.z6.web.core.windows.net/laendertabelle1.svg
1589079600,32389,19936,12453,1599,1097,https://diviexchange.z6.web.core.windows.net/laendertabelle1.svg
1589083200,32409,19957,12452,1599,1097,https://diviexchange.z6.web.core.windows.net/laendertabelle1.svg
1589086800,32392,19906,12486,1596,1093,https://diviexchange.z6.web.core.windows.net/laendertabelle1.svg
1589090400,32379,19788,12591,1589,1086,https://diviexchange.z6.web.core.windows.net/laendertabelle1.svg
1589094000,32265,19478,12787,1582,1070,https://diviexchange.z6.web.core.windows.net/laendertabelle1.svg
1589097600,32285,19455,12830,1588,1072,https://diviexchange.z6.web.core.windows.net/laendertabelle1.svg
1589101200,32297,19438,12859,1588,1071,https://diviexchange.z6.web.core.windows.net/laendertabelle1.svg
1589104800,32303,19435,12868,1589,1072,https://diviexchange.z6.web.core.windows.net/laendertabelle1.svg
1589108400,32296,19432,12864,1590,1072,https://diviexchange.z6.web.core.windows.net/laendertabelle1.svg
1589112000,32288,19424,12864,1589,1071,https://diviexchange.z6.web.core.windows.net/laendertabelle1.svg
1589115600,32288,19432,12856,1589,1071,https://diviexchange.z6.web.core.windows.net/laendertabelle1.svg
1589119200,32313,19448,12865,1602,1085,https://diviexchange.z6.web.core.windows.net/laendertabelle1.svg
1589122800,32312,19450,12862,1600,1084,https://diviexchange.z6.web.core.windows.net/laendertabelle1.svg
1589126400,32312,19443,12869,1600,1084,https://diviexchange.z6.web.core.windows.net/laendertabelle1.svg
1589130000,32304,19437,12867,1602,1084,https://diviexchange.z6.web.core.windows.net/laendertabelle1.svg
1589133600,32223,19392,12831,1601,1084,https://diviexchange.z6.web.core.windows.net/laendertabelle1.svg
1589137200,32068,19295,12773,1590,1076,https://diviexchange.z6.web.core.windows.net/laendertabelle1.svg
1589140800,32017,19273,12744,1590,1076,https://diviexchange.z6.web.core.windows.net/laendertabelle1.svg
1589144400,31991,19262,12729,1589,1076,https://diviexchange.z6.web.core.windows.net/laendertabelle1.svg
1589148000,31969,19244,12725,1589,1076,https://diviexchange.z6.web.core.windows.net/laendertabelle1.svg
1589151600,31970,19244,12726,1589,1076,https://diviexchange.z6.web.core.windows.net/laendertabelle1.svg
1589155200,31953,19234,12719,1588,1075,https://diviexchange.z6.web.core.windows.net/laendertabelle1.svg
1589158800,31900,19206,12694,1587,1074,https://diviexchange.z6.web.core.windows.net/laendertabelle1.svg
1589162400,31889,19197,12692,1586,1074,https://diviexchange.z6.web.core.windows.net/laendertabelle1.svg
1589166000,31887,19189,12698,1586,1074,https://diviexchange.z6.web.core.windows.net/laendertabelle1.svg
1589169600,31904,19194,12710,1586,1075,https://diviexchange.z6.web.core.windows.net/laendertabelle1.svg
1589173200,31897,19219,12678,1588,1077,https://diviexchange.z6.web.core.windows.net/laendertabelle1.svg
1589176800,31995,19288,12707,1581,1063,https://diviexchange.z6.web.core.windows.net/laendertabelle1.svg
1589180400,32169,19539,12630,1576,1059,https://diviexchange.z6.web.core.windows.net/laendertabelle1.svg
1589184000,32223,19567,12656,1579,1053,https://diviexchange.z6.web.core.windows.net/laendertabelle1.svg
1589187600,32202,19563,12639,1578,1051,https://diviexchange.z6.web.core.windows.net/laendertabelle1.svg
1589191200,32260,19610,12650,1584,1053,https://diviexchange.z6.web.core.windows.net/laendertabelle1.svg
1589194800,32239,19595,12644,1583,1052,https://diviexchange.z6.web.core.windows.net/laendertabelle1.svg
1589198400,32236,19596,12640,1584,1052,https://diviexchange.z6.web.core.windows.net/laendertabelle1.svg
1589202000,32230,19599,12631,1581,1051,https://diviexchange.z6.web.core.windows.net/laendertabelle1.svg
1589205600,32266,19610,12656,1585,1054,https://diviexchange.z6.web.core.windows.net/laendertabelle1.svg
1589209200,32370,19723,12647,1587,1054,https://diviexchange.z6.web.core.windows.net/laendertabelle1.svg
1589212800,32369,19720,12649,1586,1053,https://diviexchange.z6.web.core.windows.net/laendertabelle1.svg
1589216400,32407,19749,12658,1594,1060,https://diviexchange.z6.web.core.windows.net/laendertabelle1.svg
1589220000,32393,19742,12651,1593,1060,https://diviexchange.z6.web.core.windows.net/laendertabelle1.svg
1589223600,32390,19740,12650,1593,1060,https://diviexchange.z6.web.core.windows.net/laendertabelle1.svg
1589227200,32383,19726,12657,1590,1058,https://diviexchange.z6.web.core.windows.net/laendertabelle1.svg
1589230800,32372,19720,12652,1590,1058,https://diviexchange.z6.web.core.windows.net/laendertabelle1.svg
1589234400,32374,19719,12655,1589,1057,https://diviexchange.z6.web.core.windows.net/laendertabelle1.svg
1589238000,32379,19721,12658,1589,1057,https://diviexchange.z6.web.core.windows.net/laendertabelle1.svg
1589241600,32378,19722,12656,1589,1057,https://diviexchange.z6.web.core.windows.net/laendertabelle1.svg
1589256000,32381,19724,12657,1588,1056,https://diviexchange.z6.web.core.windows.net/laendertabelle1.svg
1589259600,32400,19769,12631,1574,1044,https://diviexchange.z6.web.core.windows.net/laendertabelle1.svg
1589263200,32373,19901,12472,1555,1027,https://diviexchange.z6.web.core.windows.net/laendertabelle1.svg
1589266800,32591,20221,12370,1509,1013,https://diviexchange.z6.web.core.windows.net/laendertabelle1.svg
1589270400,32660,20241,12419,1507,1005,https://diviexchange.z6.web.core.windows.net/laendertabelle1.svg
1589277600,32977,20556,12421,1508,1003,https://diviexchange.z6.web.core.windows.net/laendertabelle1.svg
1589284800,32995,20558,12437,1507,1002,https://diviexchange.z6.web.core.windows.net/laendertabelle1.svg
1589288400,33006,20553,12453,1504,999,https://diviexchange.z6.web.core.windows.net/laendertabelle1.svg
1589292000,33014,20550,12464,1504,999,https://diviexchange.z6.web.core.windows.net/laendertabelle1.svg
1589295600,33022,20553,12469,1503,998,https://diviexchange.z6.web.core.windows.net/laendertabelle1.svg
1589299200,33026,20543,12483,1502,998,https://diviexchange.z6.web.core.windows.net/laendertabelle1.svg
1589302800,33042,20560,12482,1500,997,https://diviexchange.z6.web.core.windows.net/laendertabelle1.svg
1589306400,33023,20548,12475,1497,996,https://diviexchange.z6.web.core.windows.net/laendertabelle1.svg
1589310000,33010,20538,12472,1494,993,https://diviexchange.z6.web.core.windows.net/laendertabelle1.svg
1589313600,32995,20528,12467,1494,993,https://diviexchange.z6.web.core.windows.net/laendertabelle1.svg
1589317200,32995,20537,12458,1493,992,https://diviexchange.z6.web.core.windows.net/laendertabelle1.svg
1589324400,32995,20536,12459,1493,992,https://diviexchange.z6.web.core.windows.net/laendertabelle1.svg
1589331600,32967,20506,12461,1493,992,https://diviexchange.z6.web.core.windows.net/laendertabelle1.svg
1589335200,32939,20482,12457,1481,980,https://diviexchange.z6.web.core.windows.net/laendertabelle1.svg
1589338800,32941,20484,12457,1482,980,https://diviexchange.z6.web.core.windows.net/laendertabelle1.svg
1589342400,32946,20511,12435,1482,980,https://diviexchange.z6.web.core.windows.net/laendertabelle1.svg
1589346000,32944,20499,12445,1479,976,https://diviexchange.z6.web.core.windows.net/laendertabelle1.svg
1589353200,32973,20736,12237,1450,959,https://diviexchange.z6.web.core.windows.net/laendertabelle1.svg
1589356800,32964,20780,12184,1404,953,https://diviexchange.z6.web.core.windows.net/laendertabelle1.svg
1589360400,32645,20477,12168,1402,951,https://diviexchange.z6.web.core.windows.net/laendertabelle1.svg
1589364000,32656,20497,12159,1398,950,https://diviexchange.z6.web.core.windows.net/laendertabelle1.svg
1589367600,32651,20489,12162,1395,948,https://diviexchange.z6.web.core.windows.net/laendertabelle1.svg
1589371200,32651,20482,12169,1395,948,https://diviexchange.z6.web.core.windows.net/laendertabelle1.svg
1589374800,32654,20478,12176,1395,947,https://diviexchange.z6.web.core.windows.net/laendertabelle1.svg
1589378400,32704,20497,12207,1393,946,https://diviexchange.z6.web.core.windows.net/laendertabelle1.svg
1589382000,32702,20493,12209,1393,945,https://diviexchange.z6.web.core.windows.net/laendertabelle1.svg
1589385600,32697,20486,12211,1390,943,https://diviexchange.z6.web.core.windows.net/laendertabelle1.svg
1589389200,32697,20486,12211,1391,943,https://diviexchange.z6.web.core.windows.net/laendertabelle1.svg
1589392800,32697,20489,12208,1391,943,https://diviexchange.z6.web.core.windows.net/laendertabelle1.svg
1589396400,32540,20380,12160,1379,937,https://diviexchange.z6.web.core.windows.net/laendertabelle1.svg
1589400000,32530,20373,12157,1378,936,https://diviexchange.z6.web.core.windows.net/laendertabelle1.svg
1589403600,32527,20372,12155,1378,936,https://diviexchange.z6.web.core.windows.net/laendertabelle1.svg
1589407200,32483,20334,12149,1373,934,https://diviexchange.z6.web.core.windows.net/laendertabelle1.svg
1589410800,32481,20332,12149,1374,934,https://diviexchange.z6.web.core.windows.net/laendertabelle1.svg
1589414400,32481,20338,12143,1374,934,https://diviexchange.z6.web.core.windows.net/laendertabelle1.svg
1589428800,32488,20346,12142,1375,934,https://diviexchange.z6.web.core.windows.net/laendertabelle1.svg
1589432400,32466,20361,12105,1353,924,https://diviexchange.z6.web.core.windows.net/laendertabelle1.svg
1589436000,32464,20298,12166,1337,904,https://diviexchange.z6.web.core.windows.net/laendertabelle1.svg
1589439600,32442,20189,12253,1314,878,https://diviexchange.z6.web.core.windows.net/laendertabelle1.svg
1589443200,32474,20236,12238,1327,876,https://diviexchange.z6.web.core.windows.net/laendertabelle1.svg
1589446800,32467,20223,12244,1320,874,https://diviexchange.z6.web.core.windows.net/laendertabelle1.svg
1589450400,32496,20235,12261,1321,871,https://diviexchange.z6.web.core.windows.net/laendertabelle1.svg
1589454000,32537,20268,12269,1321,871,https://diviexchange.z6.web.core.windows.net/laendertabelle1.svg
1589457600,32537,20268,12269,1317,869,https://diviexchange.z6.web.core.windows.net/laendertabelle1.svg
1589461200,32578,20308,12270,1317,870,https://diviexchange.z6.web.core.windows.net/laendertabelle1.svg
1589464800,32578,20304,12274,1316,869,https://diviexchange.z6.web.core.windows.net/laendertabelle1.svg
1589468400,32592,20310,12282,1316,868,https://diviexchange.z6.web.core.windows.net/laendertabelle1.svg
1589472000,32591,20307,12284,1316,868,https://diviexchange.z6.web.core.windows.net/laendertabelle1.svg
1589475600,32565,20296,12269,1316,867,https://diviexchange.z6.web.core.windows.net/laendertabelle1.svg
1589479200,32551,20288,12263,1317,867,https://diviexchange.z6.web.core.windows.net/laendertabelle1.svg
1589482800,32503,20256,12247,1317,867,https://diviexchange.z6.web.core.windows.net/laendertabelle1.svg
1589486400,32503,20257,12246,1317,867,https://diviexchange.z6.web.core.windows.net/laendertabelle1.svg
1589490000,32503,20259,12244,1317,867,https://diviexchange.z6.web.core.windows.net/laendertabelle1.svg
1589497200,32504,20256,12248,1317,867,https://diviexchange.z6.web.core.windows.net/laendertabelle1.svg
1589500800,32498,20251,12247,1317,867,https://diviexchange.z6.web.core.windows.net/laendertabelle1.svg
1589504400,32487,20246,12241,1317,867,https://diviexchange.z6.web.core.windows.net/laendertabelle1.svg
1589508000,32487,20247,12240,1317,867,https://diviexchange.z6.web.core.windows.net/laendertabelle1.svg
1589511600,32481,20247,12234,1317,867,https://diviexchange.z6.web.core.windows.net/laendertabelle1.svg
1589515200,32481,20251,12230,1317,867,https://diviexchange.z6.web.core.windows.net/laendertabelle1.svg
1589518800,32503,20266,12237,1333,868,https://diviexchange.z6.web.core.windows.net/laendertabelle1.svg
1589522400,32436,20343,12093,1299,844,https://diviexchange.z6.web.core.windows.net/laendertabelle1.svg
1589526000,32530,20565,11965,1251,835,https://diviexchange.z6.web.core.windows.net/laendertabelle1.svg
1589529600,32556,20604,11952,1244,824,https://diviexchange.z6.web.core.windows.net/laendertabelle1.svg
1589533200,32572,20630,11942,1243,824,https://diviexchange.z6.web.core.windows.net/laendertabelle1.svg
1589536800,32568,20630,11938,1243,824,https://diviexchange.z6.web.core.windows.net/laendertabelle1.svg
1589540400,32565,20634,11931,1242,825,https://diviexchange.z6.web.core.windows.net/laendertabelle1.svg
1589544000,32570,20646,11924,1242,824,https://diviexchange.z6.web.core.windows.net/laendertabelle1.svg
1589547600,32574,20648,11926,1242,825,https://diviexchange.z6.web.core.windows.net/laendertabelle1.svg
1589551200,32609,20666,11943,1241,825,https://diviexchange.z6.web.core.windows.net/laendertabelle1.svg
1589554800,32598,20646,11952,1241,824,https://diviexchange.z6.web.core.windows.net/laendertabelle1.svg
1589558400,32598,20642,11956,1240,824,https://diviexchange.z6.web.core.windows.net/laendertabelle1.svg
1589562000,32598,20635,11963,1240,824,https://diviexchange.z6.web.core.windows.net/laendertabelle1.svg
1589565600,32598,20637,11961,1240,824,https://diviexchange.z6.web.core.windows.net/laendertabelle1.svg
1589569200,32596,20639,11957,1240,824,https://diviexchange.z6.web.core.windows.net/laendertabelle1.svg
1589572800,32595,20638,11957,1240,824,https://diviexchange.z6.web.core.windows.net/laendertabelle1.svg
1589576400,32594,20639,11955,1240,824,https://diviexchange.z6.web.core.windows.net/laendertabelle1.svg
1589583600,32588,20643,11945,1240,823,https://diviexchange.z6.web.core.windows.net/laendertabelle1.svg
1589587200,32583,20631,11952,1240,823,https://diviexchange.z6.web.core.windows.net/laendertabelle1.svg
1589590800,32583,20638,11945,1239,823,https://diviexchange.z6.web.core.windows.net/laendertabelle1.svg
1589594400,32583,20637,11946,1239,823,https://diviexchange.z6.web.core.windows.net/laendertabelle1.svg
1589598000,32583,20639,11944,1239,823,https://diviexchange.z6.web.core.windows.net/laendertabelle1.svg
1589601600,32574,20628,11946,1237,823,https://diviexchange.z6.web.core.windows.net/laendertabelle1.svg
1589605200,32581,20629,11952,1220,821,https://diviexchange.z6.web.core.windows.net/laendertabelle1.svg
1589608800,32540,20538,12002,1207,823,https://diviexchange.z6.web.core.windows.net/laendertabelle1.svg
1589612400,32503,20335,12168,1193,810,https://diviexchange.z6.web.core.windows.net/laendertabelle1.svg
1589616000,32462,20337,12125,1189,807,https://diviexchange.z6.web.core.windows.net/laendertabelle1.svg
1589619600,32448,20310,12138,1189,806,https://diviexchange.z6.web.core.windows.net/laendertabelle1.svg
1589623200,32441,20307,12134,1184,804,https://diviexchange.z6.web.core.windows.net/laendertabelle1.svg
1589626800,32447,20306,12141,1184,804,https://diviexchange.z6.web.core.windows.net/laendertabelle1.svg
1589630400,32452,20293,12159,1184,804,https://diviexchange.z6.web.core.windows.net/laendertabelle1.svg
1589634000,32452,20283,12169,1183,804,https://diviexchange.z6.web.core.windows.net/laendertabelle1.svg
1589637600,32456,20284,12172,1183,804,https://diviexchange.z6.web.core.windows.net/laendertabelle1.svg
1589641200,32458,20287,12171,1183,804,https://diviexchange.z6.web.core.windows.net/laendertabelle1.svg
1589644800,32419,20265,12154,1183,804,https://diviexchange.z6.web.core.windows.net/laendertabelle1.svg
1589648400,32414,20264,12150,1183,804,https://diviexchange.z6.web.core.windows.net/laendertabelle1.svg
1589652000,32402,20261,12141,1184,804,https://diviexchange.z6.web.core.windows.net/laendertabelle1.svg
1589655600,32406,20265,12141,1185,804,https://diviexchange.z6.web.core.windows.net/laendertabelle1.svg
1589659200,32347,20244,12103,1185,804,https://diviexchange.z6.web.core.windows.net/laendertabelle1.svg
1589662800,32284,20194,12090,1184,803,https://diviexchange.z6.web.core.windows.net/laendertabelle1.svg
1589666400,32275,20191,12084,1184,803,https://diviexchange.z6.web.core.windows.net/laendertabelle1.svg
1589670000,32263,20168,12095,1184,803,https://diviexchange.z6.web.core.windows.net/laendertabelle1.svg
1589673600,32240,20156,12084,1183,803,https://diviexchange.z6.web.core.windows.net/laendertabelle1.svg
1589677200,32220,20137,12083,1183,803,https://diviexchange.z6.web.core.windows.net/laendertabelle1.svg
1589680800,32221,20135,12086,1182,803,https://diviexchange.z6.web.core.windows.net/laendertabelle1.svg
1589684400,32221,20134,12087,1182,804,https://diviexchange.z6.web.core.windows.net/laendertabelle1.svg
1589688000,32219,20134,12085,1183,804,https://diviexchange.z6.web.core.windows.net/laendertabelle1.svg
1589691600,32218,20088,12130,1183,804,https://diviexchange.z6.web.core.windows.net/laendertabelle1.svg
1589695200,32228,19997,12231,1173,799,https://diviexchange.z6.web.core.windows.net/laendertabelle1.svg
1589698800,32298,19716,12582,1139,779,https://diviexchange.z6.web.core.windows.net/laendertabelle1.svg
1589702400,32308,19700,12608,1133,773,https://diviexchange.z6.web.core.windows.net/laendertabelle1.svg
1589706000,32285,19685,12600,1136,773,https://diviexchange.z6.web.core.windows.net/laendertabelle1.svg
1589709600,32295,19685,12610,1137,771,https://diviexchange.z6.web.core.windows.net/laendertabelle1.svg
1589713200,32307,19687,12620,1137,771,https://diviexchange.z6.web.core.windows.net/laendertabelle1.svg
1589716800,32308,19686,12622,1137,771,https://diviexchange.z6.web.core.windows.net/laendertabelle1.svg
1589720400,32308,19685,12623,1137,771,https://diviexchange.z6.web.core.windows.net/laendertabelle1.svg
1589724000,32307,19683,12624,1137,770,https://diviexchange.z6.web.core.windows.net/laendertabelle1.svg
1589731200,32309,19685,12624,1137,770,https://diviexchange.z6.web.core.windows.net/laendertabelle1.svg
1589734800,32308,19685,12623,1137,770,https://diviexchange.z6.web.core.windows.net/laendertabelle1.svg
1589738400,32111,19545,12566,1131,765,https://diviexchange.z6.web.core.windows.net/laendertabelle1.svg
1589742000,31945,19446,12499,1121,758,https://diviexchange.z6.web.core.windows.net/laendertabelle1.svg
1589745600,31873,19404,12469,1120,757,https://diviexchange.z6.web.core.windows.net/laendertabelle1.svg
1589749200,31837,19386,12451,1120,757,https://diviexchange.z6.web.core.windows.net/laendertabelle1.svg
1589752800,31823,19375,12448,1120,757,https://diviexchange.z6.web.core.windows.net/laendertabelle1.svg
1589756400,31815,19379,12436,1120,757,https://diviexchange.z6.web.core.windows.net/laendertabelle1.svg
1589760000,31811,19377,12434,1119,757,https://diviexchange.z6.web.core.windows.net/laendertabelle1.svg
1589763600,31793,19366,12427,1120,757,https://diviexchange.z6.web.core.windows.net/laendertabelle1.svg
1589767200,31750,19336,12414,1119,757,https://diviexchange.z6.web.core.windows.net/laendertabelle1.svg
1589774400,31752,19336,12416,1121,757,https://diviexchange.z6.web.core.windows.net/laendertabelle1.svg
1589778000,31799,19359,12440,1119,754,https://diviexchange.z6.web.core.windows.net/laendertabelle1.svg
1589781600,31955,19446,12509,1127,749,https://diviexchange.z6.web.core.windows.net/laendertabelle1.svg
1589785200,32142,19555,12587,1129,739,https://diviexchange.z6.web.core.windows.net/laendertabelle1.svg
1589788800,32298,19675,12623,1141,744,https://diviexchange.z6.web.core.windows.net/laendertabelle1.svg
1589792400,32353,19713,12640,1142,741,https://diviexchange.z6.web.core.windows.net/laendertabelle1.svg
1589796000,32359,19729,12630,1139,740,https://diviexchange.z6.web.core.windows.net/laendertabelle1.svg
1589799600,32337,19703,12634,1138,740,https://diviexchange.z6.web.core.windows.net/laendertabelle1.svg
1589803200,32353,19717,12636,1138,740,https://diviexchange.z6.web.core.windows.net/laendertabelle1.svg
1589806800,32382,19723,12659,1139,741,https://diviexchange.z6.web.core.windows.net/laendertabelle1.svg
1589810400,32387,19730,12657,1138,741,https://diviexchange.z6.web.core.windows.net/laendertabelle1.svg
1589814000,32385,19725,12660,1138,741,https://diviexchange.z6.web.core.windows.net/laendertabelle1.svg
1589817600,32390,19736,12654,1135,741,https://diviexchange.z6.web.core.windows.net/laendertabelle1.svg
1589821200,32372,19728,12644,1136,741,https://diviexchange.z6.web.core.windows.net/laendertabelle1.svg
1589824800,32372,19724,12648,1136,741,https://diviexchange.z6.web.core.windows.net/laendertabelle1.svg
1589828400,32372,19725,12647,1136,741,https://diviexchange.z6.web.core.windows.net/laendertabelle1.svg
1589832000,32353,19715,12638,1134,739,https://diviexchange.z6.web.core.windows.net/laendertabelle1.svg
1589835600,32345,19711,12634,1134,739,https://diviexchange.z6.web.core.windows.net/laendertabelle1.svg
1589839200,32358,19715,12643,1134,739,https://diviexchange.z6.web.core.windows.net/laendertabelle1.svg
1589842800,32372,19724,12648,1133,739,https://diviexchange.z6.web.core.windows.net/laendertabelle1.svg
1589846400,32372,19728,12644,1133,739,https://diviexchange.z6.web.core.windows.net/laendertabelle1.svg
1589850000,32360,19720,12640,1133,739,https://diviexchange.z6.web.core.windows.net/laendertabelle1.svg
1589860800,32348,19722,12626,1132,739,https://diviexchange.z6.web.core.windows.net/laendertabelle1.svg
1589864400,32311,19761,12550,1134,735,https://diviexchange.z6.web.core.windows.net/laendertabelle1.svg
1589868000,32240,19873,12367,1119,716,https://diviexchange.z6.web.core.windows.net/laendertabelle1.svg
1589871600,32181,20207,11974,1097,704,https://diviexchange.z6.web.core.windows.net/laendertabelle1.svg
1589875200,32201,20284,11917,1100,702,https://diviexchange.z6.web.core.windows.net/laendertabelle1.svg
1589878800,32213,20300,11913,1102,702,https://diviexchange.z6.web.core.windows.net/laendertabelle1.svg
1589882400,32224,20315,11909,1100,702,https://diviexchange.z6.web.core.windows.net/laendertabelle1.svg
1589886000,32246,20325,11921,1100,703,https://diviexchange.z6.web.core.windows.net/laendertabelle1.svg
1589889600,32241,20328,11913,1099,702,https://diviexchange.z6.web.core.windows.net/laendertabelle1.svg
1589893200,32224,20302,11922,1100,702,https://diviexchange.z6.web.core.windows.net/laendertabelle1.svg
1589896800,32227,20299,11928,1097,700,https://diviexchange.z6.web.core.windows.net/laendertabelle1.svg
1589900400,32228,20300,11928,1097,700,https://diviexchange.z6.web.core.windows.net/laendertabelle1.svg
1589904000,32228,20309,11919,1097,700,https://diviexchange.z6.web.core.windows.net/laendertabelle1.svg
1589907600,32229,20310,11919,1098,701,https://diviexchange.z6.web.core.windows.net/laendertabelle1.svg
1589911200,32229,20307,11922,1098,701,https://diviexchange.z6.web.core.windows.net/laendertabelle1.svg
1589914800,32206,20292,11914,1098,701,https://diviexchange.z6.web.core.windows.net/laendertabelle1.svg
1589918400,32207,20287,11920,1098,701,https://diviexchange.z6.web.core.windows.net/laendertabelle1.svg
1589922000,32165,20251,11914,1094,697,https://diviexchange.z6.web.core.windows.net/laendertabelle1.svg
1589925600,32167,20251,11916,1094,697,https://diviexchange.z6.web.core.windows.net/laendertabelle1.svg
1589929200,32168,20253,11915,1094,697,https://diviexchange.z6.web.core.windows.net/laendertabelle1.svg
1589932800,32167,20255,11912,1094,697,https://diviexchange.z6.web.core.windows.net/laendertabelle1.svg
1589947200,32162,20247,11915,1093,697,https://diviexchange.z6.web.core.windows.net/laendertabelle1.svg
1589950800,32155,20256,11899,1086,690,https://diviexchange.z6.web.core.windows.net/laendertabelle1.svg
1589954400,32151,20311,11840,1060,676,https://diviexchange.z6.web.core.windows.net/laendertabelle1.svg
1589958000,32423,20550,11873,1038,665,https://diviexchange.z6.web.core.windows.net/laendertabelle1.svg
1589961600,32458,20589,11869,1040,665,https://diviexchange.z6.web.core.windows.net/laendertabelle1.svg
1589965200,32461,20588,11873,1035,661,https://diviexchange.z6.web.core.windows.net/laendertabelle1.svg
1589968800,32471,20594,11877,1033,660,https://diviexchange.z6.web.core.windows.net/laendertabelle1.svg
1589972400,32469,20591,11878,1035,662,https://diviexchange.z6.web.core.windows.net/laendertabelle1.svg
1589976000,32473,20589,11884,1033,660,https://diviexchange.z6.web.core.windows.net/laendertabelle1.svg
1589979600,32473,20582,11891,1033,660,https://diviexchange.z6.web.core.windows.net/laendertabelle1.svg
1589983200,32473,20573,11900,1033,660,https://diviexchange.z6.web.core.windows.net/laendertabelle1.svg
1589986800,32478,20568,11910,1029,661,https://diviexchange.z6.web.core.windows.net/laendertabelle1.svg
1589994000,32474,20565,11909,1029,661,https://diviexchange.z6.web.core.windows.net/laendertabelle1.svg
1589997600,32474,20568,11906,1028,659,https://diviexchange.z6.web.core.windows.net/laendertabelle1.svg
1590001200,32433,20547,11886,1028,659,https://diviexchange.z6.web.core.windows.net/laendertabelle1.svg
1590004800,32434,20552,11882,1028,659,https://diviexchange.z6.web.core.windows.net/laendertabelle1.svg
1590008400,32427,20549,11878,1028,659,https://diviexchange.z6.web.core.windows.net/laendertabelle1.svg
1590012000,32427,20554,11873,1027,659,https://diviexchange.z6.web.core.windows.net/laendertabelle1.svg
1590015600,32427,20559,11868,1026,659,https://diviexchange.z6.web.core.windows.net/laendertabelle1.svg
1590019200,32446,20567,11879,1026,659,https://diviexchange.z6.web.core.windows.net/laendertabelle1.svg
1590022800,32445,20571,11874,1026,659,https://diviexchange.z6.web.core.windows.net/laendertabelle1.svg
1590030000,32433,20561,11872,1026,659,https://diviexchange.z6.web.core.windows.net/laendertabelle1.svg
1590033600,32432,20560,11872,1024,659,https://diviexchange.z6.web.core.windows.net/laendertabelle1.svg
1590037200,32464,20549,11915,1021,657,https://diviexchange.z6.web.core.windows.net/laendertabelle1.svg
1590040800,32553,20576,11977,1018,652,https://diviexchange.z6.web.core.windows.net/laendertabelle1.svg
1590044400,32632,20689,11943,1018,636,https://diviexchange.z6.web.core.windows.net/laendertabelle1.svg
1590048000,32611,20686,11925,1019,635,https://diviexchange.z6.web.core.windows.net/laendertabelle1.svg
1590051600,32601,20663,11938,1014,636,https://diviexchange.z6.web.core.windows.net/laendertabelle1.svg
1590055200,32618,20670,11948,1014,636,https://diviexchange.z6.web.core.windows.net/laendertabelle1.svg
1590058800,32612,20669,11943,1013,634,https://diviexchange.z6.web.core.windows.net/laendertabelle1.svg
1590062400,32614,20655,11959,1010,633,https://diviexchange.z6.web.core.windows.net/laendertabelle1.svg
1590066000,32618,20659,11959,1010,633,https://diviexchange.z6.web.core.windows.net/laendertabelle1.svg
1590069600,32618,20631,11987,1009,633,https://diviexchange.z6.web.core.windows.net/laendertabelle1.svg
1590073200,32619,20627,11992,1010,632,https://diviexchange.z6.web.core.windows.net/laendertabelle1.svg
1590076800,32623,20621,12002,1009,632,https://diviexchange.z6.web.core.windows.net/laendertabelle1.svg
1590080400,32611,20613,11998,1009,632,https://diviexchange.z6.web.core.windows.net/laendertabelle1.svg
1590084000,32585,20599,11986,1009,632,https://diviexchange.z6.web.core.windows.net/laendertabelle1.svg
1590087600,32412,20488,11924,989,619,https://diviexchange.z6.web.core.windows.net/laendertabelle1.svg
1590091200,32348,20424,11924,978,613,https://diviexchange.z6.web.core.windows.net/laendertabelle1.svg
1590094800,32348,20423,11925,978,613,https://diviexchange.z6.web.core.windows.net/laendertabelle1.svg
1590098400,32337,20414,11923,978,613,https://diviexchange.z6.web.core.windows.net/laendertabelle1.svg
1590102000,32298,20384,11914,978,613,https://diviexchange.z6.web.core.windows.net/laendertabelle1.svg
1590105600,32295,20384,11911,978,613,https://diviexchange.z6.web.core.windows.net/laendertabelle1.svg
1590109200,32267,20364,11903,978,613,https://diviexchange.z6.web.core.windows.net/laendertabelle1.svg
1590116400,32267,20361,11906,978,613,https://diviexchange.z6.web.core.windows.net/laendertabelle1.svg
1590120000,32275,20361,11914,978,613,https://diviexchange.z6.web.core.windows.net/laendertabelle1.svg
1590123600,32251,20276,11975,967,609,https://diviexchange.z6.web.core.windows.net/laendertabelle1.svg
1590127200,32237,20107,12130,972,601,https://diviexchange.z6.web.core.windows.net/laendertabelle1.svg
1590130800,32285,19945,12340,965,596,https://diviexchange.z6.web.core.windows.net/laendertabelle1.svg
1590134400,32284,19920,12364,960,598,https://diviexchange.z6.web.core.windows.net/laendertabelle1.svg
1590138000,32279,19891,12388,958,597,https://diviexchange.z6.web.core.windows.net/laendertabelle1.svg
1590141600,32319,19913,12406,960,596,https://diviexchange.z6.web.core.windows.net/laendertabelle1.svg
1590145200,32467,20035,12432,965,600,https://diviexchange.z6.web.core.windows.net/laendertabelle1.svg
1590148800,32497,20047,12450,971,603,https://diviexchange.z6.web.core.windows.net/laendertabelle1.svg
1590152400,32508,20050,12458,970,602,https://diviexchange.z6.web.core.windows.net/laendertabelle1.svg
1590156000,32537,20057,12480,968,603,https://diviexchange.z6.web.core.windows.net/laendertabelle1.svg
1590159600,32543,20061,12482,964,602,https://diviexchange.z6.web.core.windows.net/laendertabelle1.svg
1590163200,32543,20064,12479,964,601,https://diviexchange.z6.web.core.windows.net/laendertabelle1.svg
1590166800,32510,20048,12462,964,601,https://diviexchange.z6.web.core.windows.net/laendertabelle1.svg
1590170400,32437,20001,12436,962,600,https://diviexchange.z6.web.core.windows.net/laendertabelle1.svg
1590174000,32296,19900,12396,958,598,https://diviexchange.z6.web.core.windows.net/laendertabelle1.svg
1590177600,32293,19900,12393,958,598,https://diviexchange.z6.web.core.windows.net/laendertabelle1.svg
1590181200,32277,19891,12386,958,598,https://diviexchange.z6.web.core.windows.net/laendertabelle1.svg
1590184800,32277,19889,12388,958,598,https://diviexchange.z6.web.core.windows.net/laendertabelle1.svg
1590188400,32277,19890,12387,957,597,https://diviexchange.z6.web.core.windows.net/laendertabelle1.svg
1590192000,32262,19881,12381,957,598,https://diviexchange.z6.web.core.windows.net/laendertabelle1.svg
1590195600,32242,19872,12370,957,598,https://diviexchange.z6.web.core.windows.net/laendertabelle1.svg
1590199200,32231,19868,12363,957,598,https://diviexchange.z6.web.core.windows.net/laendertabelle1.svg
1590202800,32218,19860,12358,957,598,https://diviexchange.z6.web.core.windows.net/laendertabelle1.svg
1590206400,32221,19862,12359,956,597,https://diviexchange.z6.web.core.windows.net/laendertabelle1.svg
1590210000,32204,19841,12363,958,598,https://diviexchange.z6.web.core.windows.net/laendertabelle1.svg
1590213600,32281,19961,12320,949,592,https://diviexchange.z6.web.core.windows.net/laendertabelle1.svg
1590217200,32340,20014,12326,919,579,https://diviexchange.z6.web.core.windows.net/laendertabelle1.svg
1590220800,32331,20027,12304,917,578,https://diviexchange.z6.web.core.windows.net/laendertabelle1.svg
1590224400,32347,20025,12322,917,580,https://diviexchange.z6.web.core.windows.net/laendertabelle1.svg
1590228000,32346,20016,12330,918,580,https://diviexchange.z6.web.core.windows.net/laendertabelle1.svg
1590231600,32334,20004,12330,920,581,https://diviexchange.z6.web.core.windows.net/laendertabelle1.svg
1590238800,32334,19991,12343,918,580,https://diviexchange.z6.web.core.windows.net/laendertabelle1.svg
1590242400,32342,19988,12354,918,580,https://diviexchange.z6.web.core.windows.net/laendertabelle1.svg
1590246000,32342,19985,12357,918,580,https://diviexchange.z6.web.core.windows.net/laendertabelle1.svg
1590249600,32346,19985,12361,918,580,https://diviexchange.z6.web.core.windows.net/laendertabelle1.svg
1590253200,32346,19988,12358,918,582,https://diviexchange.z6.web.core.windows.net/laendertabelle1.svg
1590256800,32342,19972,12370,918,582,https://diviexchange.z6.web.core.windows.net/laendertabelle1.svg
1590260400,32321,19953,12368,918,582,https://diviexchange.z6.web.core.windows.net/laendertabelle1.svg
1590264000,32335,19965,12370,919,583,https://diviexchange.z6.web.core.windows.net/laendertabelle1.svg
1590271200,32323,19960,12363,919,583,https://diviexchange.z6.web.core.windows.net/laendertabelle1.svg
1590274800,32316,19950,12366,919,582,https://diviexchange.z6.web.core.windows.net/laendertabelle1.svg
1590278400,32306,19948,12358,919,582,https://diviexchange.z6.web.core.windows.net/laendertabelle1.svg
1590282000,32298,19945,12353,918,582,https://diviexchange.z6.web.core.windows.net/laendertabelle1.svg
1590285600,32291,19926,12365,918,582,https://diviexchange.z6.web.core.windows.net/laendertabelle1.svg
1590289200,32291,19921,12370,918,582,https://diviexchange.z6.web.core.windows.net/laendertabelle1.svg
1590292800,32278,19907,12371,917,582,https://diviexchange.z6.web.core.windows.net/laendertabelle1.svg
1590296400,32271,19863,12408,915,577,https://diviexchange.z6.web.core.windows.net/laendertabelle1.svg
1590300000,32227,19781,12446,906,571,https://diviexchange.z6.web.core.windows.net/laendertabelle1.svg
1590303600,32167,19537,12630,891,563,https://diviexchange.z6.web.core.windows.net/laendertabelle1.svg
1590307200,32165,19513,12652,891,563,https://diviexchange.z6.web.core.windows.net/laendertabelle1.svg
1590310800,32189,19508,12681,888,562,https://diviexchange.z6.web.core.windows.net/laendertabelle1.svg
1590314400,32186,19505,12681,888,563,https://diviexchange.z6.web.core.windows.net/laendertabelle1.svg
1590318000,32164,19488,12676,888,563,https://diviexchange.z6.web.core.windows.net/laendertabelle1.svg
1590321600,32131,19453,12678,887,562,https://diviexchange.z6.web.core.windows.net/laendertabelle1.svg
1590325200,32137,19457,12680,887,562,https://diviexchange.z6.web.core.windows.net/laendertabelle1.svg
1590328800,32137,19447,12690,887,563,https://diviexchange.z6.web.core.windows.net/laendertabelle1.svg
1590332400,32142,19447,12695,887,563,https://diviexchange.z6.web.core.windows.net/laendertabelle1.svg
1590336000,32146,19452,12694,887,563,https://diviexchange.z6.web.core.windows.net/laendertabelle1.svg
1590339600,32146,19449,12697,887,563,https://diviexchange.z6.web.core.windows.net/laendertabelle1.svg
1590343200,32100,19418,12682,887,563,https://diviexchange.z6.web.core.windows.net/laendertabelle1.svg
1590346800,31967,19345,12622,883,563,https://diviexchange.z6.web.core.windows.net/laendertabelle1.svg
1590350400,31857,19266,12591,883,563,https://diviexchange.z6.web.core.windows.net/laendertabelle1.svg
1590354000,31653,19118,12535,874,553,https://diviexchange.z6.web.core.windows.net/laendertabelle1.svg
1590357600,31634,19103,12531,874,553,https://diviexchange.z6.web.core.windows.net/laendertabelle1.svg
1590361200,31633,19103,12530,874,553,https://diviexchange.z6.web.core.windows.net/laendertabelle1.svg
1590368400,31610,19088,12522,873,553,https://diviexchange.z6.web.core.windows.net/laendertabelle1.svg
1590372000,31603,19085,12518,873,553,https://diviexchange.z6.web.core.windows.net/laendertabelle1.svg
1590375600,31603,19086,12517,874,554,https://diviexchange.z6.web.core.windows.net/laendertabelle1.svg
1590379200,31607,19094,12513,871,552,https://diviexchange.z6.web.core.windows.net/laendertabelle1.svg
1590382800,31631,19063,12568,869,551,https://diviexchange.z6.web.core.windows.net/laendertabelle1.svg
1590386400,31869,19274,12595,874,558,https://diviexchange.z6.web.core.windows.net/laendertabelle1.svg
1590390000,32008,19370,12638,873,547,https://diviexchange.z6.web.core.windows.net/laendertabelle1.svg
1590393600,32217,19560,12657,878,555,https://diviexchange.z6.web.core.windows.net/laendertabelle1.svg
1590397200,32248,19586,12662,877,554,https://diviexchange.z6.web.core.windows.net/laendertabelle1.svg
1590400800,32252,19574,12678,875,555,https://diviexchange.z6.web.core.windows.net/laendertabelle1.svg
1590404400,32251,19580,12671,874,555,https://diviexchange.z6.web.core.windows.net/laendertabelle1.svg
1590408000,32258,19584,12674,874,555,https://diviexchange.z6.web.core.windows.net/laendertabelle1.svg
1590411600,32268,19578,12690,874,552,https://diviexchange.z6.web.core.windows.net/laendertabelle1.svg
1590415200,32259,19585,12674,873,551,https://diviexchange.z6.web.core.windows.net/laendertabelle1.svg
1590418800,32334,19634,12700,872,550,https://diviexchange.z6.web.core.windows.net/laendertabelle1.svg
1590422400,32337,19641,12696,872,550,https://diviexchange.z6.web.core.windows.net/laendertabelle1.svg
1590426000,32337,19640,12697,872,550,https://diviexchange.z6.web.core.windows.net/laendertabelle1.svg
1590429600,32337,19640,12697,871,549,https://diviexchange.z6.web.core.windows.net/laendertabelle1.svg
1590433200,32337,19639,12698,872,550,https://diviexchange.z6.web.core.windows.net/laendertabelle1.svg
1590436800,32314,19626,12688,870,548,https://diviexchange.z6.web.core.windows.net/laendertabelle1.svg
1590447600,32314,19618,12696,870,548,https://diviexchange.z6.web.core.windows.net/laendertabelle1.svg
1590451200,32315,19616,12699,871,549,https://diviexchange.z6.web.core.windows.net/laendertabelle1.svg
1590454800,32315,19617,12698,871,549,https://diviexchange.z6.web.core.windows.net/laendertabelle1.svg
1590462000,32325,19621,12704,871,549,https://diviexchange.z6.web.core.windows.net/laendertabelle1.svg
1590465600,32324,19630,12694,871,549,https://diviexchange.z6.web.core.windows.net/laendertabelle1.svg
1590469200,32326,19701,12625,861,547,https://diviexchange.z6.web.core.windows.net/laendertabelle1.svg
1590472800,32401,19872,12529,851,536,https://diviexchange.z6.web.core.windows.net/laendertabelle1.svg
1590476400,32405,20211,12194,824,529,https://diviexchange.z6.web.core.windows.net/laendertabelle1.svg
1590480000,32456,20285,12171,823,527,https://diviexchange.z6.web.core.windows.net/laendertabelle1.svg
1590483600,32488,20304,12184,824,526,https://diviexchange.z6.web.core.windows.net/laendertabelle1.svg
1590490800,32495,20316,12179,823,525,https://diviexchange.z6.web.core.windows.net/laendertabelle1.svg
1590494400,32497,20328,12169,824,526,https://diviexchange.z6.web.core.windows.net/laendertabelle1.svg
1590498000,32491,20323,12168,826,527,https://diviexchange.z6.web.core.windows.net/laendertabelle1.svg
1590501600,32491,20329,12162,825,527,https://diviexchange.z6.web.core.windows.net/laendertabelle1.svg
1590505200,32518,20353,12165,825,527,https://diviexchange.z6.web.core.windows.net/laendertabelle1.svg
1590508800,32536,20367,12169,825,527,https://diviexchange.z6.web.core.windows.net/laendertabelle1.svg
1590512400,32532,20365,12167,825,527,https://diviexchange.z6.web.core.windows.net/laendertabelle1.svg
1590516000,32532,20362,12170,824,527,https://diviexchange.z6.web.core.windows.net/laendertabelle1.svg
1590519600,32510,20351,12159,823,527,https://diviexchange.z6.web.core.windows.net/laendertabelle1.svg
1590523200,32498,20339,12159,823,527,https://diviexchange.z6.web.core.windows.net/laendertabelle1.svg
1590530400,32496,20339,12157,823,527,https://diviexchange.z6.web.core.windows.net/laendertabelle1.svg
1590534000,32495,20342,12153,823,527,https://diviexchange.z6.web.core.windows.net/laendertabelle1.svg
1590537600,32495,20345,12150,823,527,https://diviexchange.z6.web.core.windows.net/laendertabelle1.svg
1590544800,32495,20347,12148,823,527,https://diviexchange.z6.web.core.windows.net/laendertabelle1.svg
1590548400,32494,20345,12149,823,527,https://diviexchange.z6.web.core.windows.net/laendertabelle1.svg
1590552000,32470,20328,12142,822,526,https://diviexchange.z6.web.core.windows.net/laendertabelle1.svg
1590555600,32462,20356,12106,809,513,https://diviexchange.z6.web.core.windows.net/laendertabelle1.svg
1590559200,32524,20474,12050,803,503,https://diviexchange.z6.web.core.windows.net/laendertabelle1.svg
1590562800,32511,20641,11870,764,483,https://diviexchange.z6.web.core.windows.net/laendertabelle1.svg
1590566400,32528,20665,11863,762,480,https://diviexchange.z6.web.core.windows.net/laendertabelle1.svg
1590570000,32531,20675,11856,761,480,https://diviexchange.z6.web.core.windows.net/laendertabelle1.svg
1590573600,32537,20680,11857,758,477,https://diviexchange.z6.web.core.windows.net/laendertabelle1.svg
1590577200,32551,20694,11857,758,477,https://diviexchange.z6.web.core.windows.net/laendertabelle1.svg
1590580800,32550,20692,11858,756,476,https://diviexchange.z6.web.core.windows.net/laendertabelle1.svg
1590584400,32550,20689,11861,756,476,https://diviexchange.z6.web.core.windows.net/laendertabelle1.svg
1590588000,32550,20686,11864,757,476,https://diviexchange.z6.web.core.windows.net/laendertabelle1.svg
1590591600,32526,20677,11849,757,476,https://diviexchange.z6.web.core.windows.net/laendertabelle1.svg
1590595200,32528,20671,11857,757,476,https://diviexchange.z6.web.core.windows.net/laendertabelle1.svg
1590598800,32529,20673,11856,757,476,https://diviexchange.z6.web.core.windows.net/laendertabelle1.svg
1590602400,32517,20670,11847,757,476,https://diviexchange.z6.web.core.windows.net/laendertabelle1.svg
1590606000,32517,20668,11849,757,476,https://diviexchange.z6.web.core.windows.net/laendertabelle1.svg
1590609600,32517,20644,11873,756,475,https://diviexchange.z6.web.core.windows.net/laendertabelle1.svg
1590613200,32527,20648,11879,756,475,https://diviexchange.z6.web.core.windows.net/laendertabelle1.svg
1590620400,32527,20647,11880,756,475,https://diviexchange.z6.web.core.windows.net/laendertabelle1.svg
1590627600,32527,20651,11876,756,475,https://diviexchange.z6.web.core.windows.net/laendertabelle1.svg
1590634800,32493,20627,11866,756,475,https://diviexchange.z6.web.core.windows.net/laendertabelle1.svg
1590638400,32491,20633,11858,755,474,https://diviexchange.z6.web.core.windows.net/laendertabelle1.svg
1590642000,32506,20644,11862,757,471,https://diviexchange.z6.web.core.windows.net/laendertabelle1.svg
1590645600,32531,20670,11861,745,465,https://diviexchange.z6.web.core.windows.net/laendertabelle1.svg
1590649200,32505,20774,11731,744,453,https://diviexchange.z6.web.core.windows.net/laendertabelle1.svg
1590652800,32504,20769,11735,735,447,https://diviexchange.z6.web.core.windows.net/laendertabelle1.svg
1590656400,32504,20770,11734,734,447,https://diviexchange.z6.web.core.windows.net/laendertabelle1.svg
1590660000,32504,20769,11735,733,447,https://diviexchange.z6.web.core.windows.net/laendertabelle1.svg
1590663600,32501,20796,11705,736,447,https://diviexchange.z6.web.core.windows.net/laendertabelle1.svg
1590667200,32499,20781,11718,739,448,https://diviexchange.z6.web.core.windows.net/laendertabelle1.svg
1590670800,32529,20799,11730,739,448,https://diviexchange.z6.web.core.windows.net/laendertabelle1.svg
1590674400,32532,20791,11741,740,448,https://diviexchange.z6.web.core.windows.net/laendertabelle1.svg
1590678000,32547,20797,11750,740,447,https://diviexchange.z6.web.core.windows.net/laendertabelle1.svg
1590681600,32550,20797,11753,740,447,https://diviexchange.z6.web.core.windows.net/laendertabelle1.svg
1590685200,32550,20788,11762,740,447,https://diviexchange.z6.web.core.windows.net/laendertabelle1.svg
1590688800,32506,20771,11735,740,447,https://diviexchange.z6.web.core.windows.net/laendertabelle1.svg
1590692400,32503,20767,11736,740,447,https://diviexchange.z6.web.core.windows.net/laendertabelle1.svg
1590696000,32487,20762,11725,740,447,https://diviexchange.z6.web.core.windows.net/laendertabelle1.svg
1590699600,32465,20749,11716,740,447,https://diviexchange.z6.web.core.windows.net/laendertabelle1.svg
1590703200,32465,20757,11708,740,447,https://diviexchange.z6.web.core.windows.net/laendertabelle1.svg
1590706800,32443,20740,11703,737,447,https://diviexchange.z6.web.core.windows.net/laendertabelle1.svg
1590710400,32418,20719,11699,737,447,https://diviexchange.z6.web.core.windows.net/laendertabelle1.svg
1590714000,32408,20709,11699,737,447,https://diviexchange.z6.web.core.windows.net/laendertabelle1.svg
1590717600,32408,20710,11698,737,447,https://diviexchange.z6.web.core.windows.net/laendertabelle1.svg
1590721200,32408,20711,11697,737,447,https://diviexchange.z6.web.core.windows.net/laendertabelle1.svg
1590724800,32407,20706,11701,735,445,https://diviexchange.z6.web.core.windows.net/laendertabelle1.svg
1590728400,32391,20720,11671,731,443,https://diviexchange.z6.web.core.windows.net/laendertabelle1.svg
1590732000,32415,20669,11746,727,430,https://diviexchange.z6.web.core.windows.net/laendertabelle1.svg
1590735600,32420,20681,11739,730,425,https://diviexchange.z6.web.core.windows.net/laendertabelle1.svg
1590739200,32415,20664,11751,729,424,https://diviexchange.z6.web.core.windows.net/laendertabelle1.svg
1590742800,32443,20687,11756,732,427,https://diviexchange.z6.web.core.windows.net/laendertabelle1.svg
1590746400,32429,20678,11751,731,425,https://diviexchange.z6.web.core.windows.net/laendertabelle1.svg
1590750000,32431,20674,11757,730,425,https://diviexchange.z6.web.core.windows.net/laendertabelle1.svg
1590753600,32432,20669,11763,732,426,https://diviexchange.z6.web.core.windows.net/laendertabelle1.svg
1590757200,32431,20662,11769,732,426,https://diviexchange.z6.web.core.windows.net/laendertabelle1.svg
1590760800,32422,20656,11766,732,426,https://diviexchange.z6.web.core.windows.net/laendertabelle1.svg
1590764400,32428,20648,11780,733,428,https://diviexchange.z6.web.core.windows.net/laendertabelle1.svg
1590768000,32426,20643,11783,731,426,https://diviexchange.z6.web.core.windows.net/laendertabelle1.svg
1590771600,32421,20645,11776,731,426,https://diviexchange.z6.web.core.windows.net/laendertabelle1.svg
1590775200,32420,20648,11772,731,426,https://diviexchange.z6.web.core.windows.net/laendertabelle1.svg
1590782400,32420,20649,11771,731,426,https://diviexchange.z6.web.core.windows.net/laendertabelle1.svg
1590786000,32406,20635,11771,731,426,https://diviexchange.z6.web.core.windows.net/laendertabelle1.svg
1590789600,32406,20632,11774,728,424,https://diviexchange.z6.web.core.windows.net/laendertabelle1.svg
1590793200,32390,20615,11775,728,424,https://diviexchange.z6.web.core.windows.net/laendertabelle1.svg
1590796800,32358,20597,11761,727,424,https://diviexchange.z6.web.core.windows.net/laendertabelle1.svg
1590800400,32358,20597,11761,728,425,https://diviexchange.z6.web.core.windows.net/laendertabelle1.svg
1590804000,32356,20599,11757,728,425,https://diviexchange.z6.web.core.windows.net/laendertabelle1.svg
1590807600,32354,20592,11762,728,425,https://diviexchange.z6.web.core.windows.net/laendertabelle1.svg
1590811200,32354,20609,11745,728,425,https://diviexchange.z6.web.core.windows.net/laendertabelle1.svg
1590814800,32355,20601,11754,730,425,https://diviexchange.z6.web.core.windows.net/laendertabelle1.svg
1590818400,32436,20550,11886,721,422,https://diviexchange.z6.web.core.windows.net/laendertabelle1.svg
1590822000,32433,20571,11862,720,423,https://diviexchange.z6.web.core.windows.net/laendertabelle1.svg
1590825600,32420,20559,11861,721,426,https://diviexchange.z6.web.core.windows.net/laendertabelle1.svg
1590829200,32414,20555,11859,720,425,https://diviexchange.z6.web.core.windows.net/laendertabelle1.svg
1590832800,32434,20557,11877,722,425,https://diviexchange.z6.web.core.windows.net/laendertabelle1.svg
1590836400,32437,20545,11892,722,425,https://diviexchange.z6.web.core.windows.net/laendertabelle1.svg
1590840000,32431,20539,11892,721,424,https://diviexchange.z6.web.core.windows.net/laendertabelle1.svg
1590843600,32431,20531,11900,721,424,https://diviexchange.z6.web.core.windows.net/laendertabelle1.svg
1590847200,32435,20531,11904,724,427,https://diviexchange.z6.web.core.windows.net/laendertabelle1.svg
1590850800,32437,20522,11915,724,427,https://diviexchange.z6.web.core.windows.net/laendertabelle1.svg
1590854400,32437,20515,11922,724,427,https://diviexchange.z6.web.core.windows.net/laendertabelle1.svg
1590858000,32427,20505,11922,724,427,https://diviexchange.z6.web.core.windows.net/laendertabelle1.svg
1590861600,32303,20415,11888,721,426,https://diviexchange.z6.web.core.windows.net/laendertabelle1.svg
1590865200,32163,20307,11856,719,424,https://diviexchange.z6.web.core.windows.net/laendertabelle1.svg
1590868800,32141,20295,11846,719,424,https://diviexchange.z6.web.core.windows.net/laendertabelle1.svg
1590876000,32116,20272,11844,718,424,https://diviexchange.z6.web.core.windows.net/laendertabelle1.svg
1590879600,32116,20270,11846,715,421,https://diviexchange.z6.web.core.windows.net/laendertabelle1.svg
1590883200,32113,20266,11847,715,421,https://diviexchange.z6.web.core.windows.net/laendertabelle1.svg
1590886800,32111,20264,11847,715,421,https://diviexchange.z6.web.core.windows.net/laendertabelle1.svg
1590890400,32100,20256,11844,715,421,https://diviexchange.z6.web.core.windows.net/laendertabelle1.svg
1590894000,32059,20220,11839,712,420,https://diviexchange.z6.web.core.windows.net/laendertabelle1.svg
1590897600,32061,20207,11854,712,420,https://diviexchange.z6.web.core.windows.net/laendertabelle1.svg
1590901200,32057,20197,11860,711,420,https://diviexchange.z6.web.core.windows.net/laendertabelle1.svg
1590904800,32076,20044,12032,706,412,https://diviexchange.z6.web.core.windows.net/laendertabelle1.svg
1590908400,32145,19869,12276,703,411,https://diviexchange.z6.web.core.windows.net/laendertabelle1.svg
1590912000,32139,19790,12349,697,403,https://diviexchange.z6.web.core.windows.net/laendertabelle1.svg
1590915600,32144,19757,12387,696,402,https://diviexchange.z6.web.core.windows.net/laendertabelle1.svg
1590919200,32157,19764,12393,699,405,https://diviexchange.z6.web.core.windows.net/laendertabelle1.svg
1590922800,32167,19756,12411,699,405,https://diviexchange.z6.web.core.windows.net/laendertabelle1.svg
1590926400,32169,19748,12421,699,405,https://diviexchange.z6.web.core.windows.net/laendertabelle1.svg
1590930000,32169,19742,12427,699,405,https://diviexchange.z6.web.core.windows.net/laendertabelle1.svg
1590933600,32166,19742,12424,697,403,https://diviexchange.z6.web.core.windows.net/laendertabelle1.svg
1590937200,32170,19742,12428,697,403,https://diviexchange.z6.web.core.windows.net/laendertabelle1.svg
1590940800,32163,19740,12423,697,403,https://diviexchange.z6.web.core.windows.net/laendertabelle1.svg
1590944400,32132,19726,12406,697,403,https://diviexchange.z6.web.core.windows.net/laendertabelle1.svg
1590948000,32001,19657,12344,688,397,https://diviexchange.z6.web.core.windows.net/laendertabelle1.svg
1590951600,31764,19508,12256,680,393,https://diviexchange.z6.web.core.windows.net/laendertabelle1.svg
1590955200,31700,19485,12215,680,393,https://diviexchange.z6.web.core.windows.net/laendertabelle1.svg
1590958800,31578,19378,12200,677,390,https://diviexchange.z6.web.core.windows.net/laendertabelle1.svg
1590962400,31578,19382,12196,677,390,https://diviexchange.z6.web.core.windows.net/laendertabelle1.svg
1590966000,31558,19356,12202,676,389,https://diviexchange.z6.web.core.windows.net/laendertabelle1.svg
1590969600,31564,19362,12202,676,389,https://diviexchange.z6.web.core.windows.net/laendertabelle1.svg
1590973200,31558,19346,12212,676,389,https://diviexchange.z6.web.core.windows.net/laendertabelle1.svg
1590976800,31557,19348,12209,676,389,https://diviexchange.z6.web.core.windows.net/laendertabelle1.svg
1590980400,31560,19348,12212,676,389,https://diviexchange.z6.web.core.windows.net/laendertabelle1.svg
1590984000,31566,19359,12207,678,389,https://diviexchange.z6.web.core.windows.net/laendertabelle1.svg
1590987600,31547,19363,12184,676,387,https://diviexchange.z6.web.core.windows.net/laendertabelle1.svg
1590991200,31534,19371,12163,675,388,https://diviexchange.z6.web.core.windows.net/laendertabelle1.svg
1590994800,31553,19308,12245,685,386,https://diviexchange.z6.web.core.windows.net/laendertabelle1.svg
1590998400,31615,19335,12280,679,381,https://diviexchange.z6.web.core.windows.net/laendertabelle1.svg
1591002000,31632,19348,12284,678,379,https://diviexchange.z6.web.core.windows.net/laendertabelle1.svg
1591005600,31640,19351,12289,680,379,https://diviexchange.z6.web.core.windows.net/laendertabelle1.svg
1591009200,31656,19344,12312,680,379,https://diviexchange.z6.web.core.windows.net/laendertabelle1.svg
1591012800,31657,19334,12323,679,381,https://diviexchange.z6.web.core.windows.net/laendertabelle1.svg
1591016400,31781,19449,12332,682,384,https://diviexchange.z6.web.core.windows.net/laendertabelle1.svg
1591020000,31800,19459,12341,684,386,https://diviexchange.z6.web.core.windows.net/laendertabelle1.svg
1591023600,31794,19454,12340,684,386,https://diviexchange.z6.web.core.windows.net/laendertabelle1.svg
1591027200,31770,19433,12337,683,386,https://diviexchange.z6.web.core.windows.net/laendertabelle1.svg
1591030800,31770,19423,12347,683,386,https://diviexchange.z6.web.core.windows.net/laendertabelle1.svg
1591034400,31731,19400,12331,683,386,https://diviexchange.z6.web.core.windows.net/laendertabelle1.svg
1591038000,31723,19392,12331,683,386,https://diviexchange.z6.web.core.windows.net/laendertabelle1.svg
1591041600,31681,19371,12310,683,386,https://diviexchange.z6.web.core.windows.net/laendertabelle1.svg
1591045200,31678,19371,12307,683,386,https://diviexchange.z6.web.core.windows.net/laendertabelle1.svg
1591048800,31690,19373,12317,683,386,https://diviexchange.z6.web.core.windows.net/laendertabelle1.svg
1591052400,31691,19369,12322,683,386,https://diviexchange.z6.web.core.windows.net/laendertabelle1.svg
1591056000,31694,19376,12318,683,386,https://diviexchange.z6.web.core.windows.net/laendertabelle1.svg
1591059600,31694,19378,12316,683,385,https://diviexchange.z6.web.core.windows.net/laendertabelle1.svg
1591066800,31694,19382,12312,682,385,https://diviexchange.z6.web.core.windows.net/laendertabelle1.svg
1591070400,31673,19379,12294,682,385,https://diviexchange.z6.web.core.windows.net/laendertabelle1.svg
1591074000,31661,19407,12254,677,383,https://diviexchange.z6.web.core.windows.net/laendertabelle1.svg
1591077600,31775,19560,12215,678,381,https://diviexchange.z6.web.core.windows.net/laendertabelle1.svg
1591081200,31929,19634,12295,691,380,https://diviexchange.z6.web.core.windows.net/laendertabelle1.svg
1591084800,31969,19650,12319,690,378,https://diviexchange.z6.web.core.windows.net/laendertabelle1.svg
1591088400,32087,19728,12359,690,378,https://diviexchange.z6.web.core.windows.net/laendertabelle1.svg
1591092000,32114,19745,12369,689,378,https://diviexchange.z6.web.core.windows.net/laendertabelle1.svg
1591095600,32117,19743,12374,689,378,https://diviexchange.z6.web.core.windows.net/laendertabelle1.svg
1591099200,32179,19769,12410,690,378,https://diviexchange.z6.web.core.windows.net/laendertabelle1.svg
1591102800,32182,19771,12411,690,378,https://diviexchange.z6.web.core.windows.net/laendertabelle1.svg
1591106400,32186,19755,12431,691,378,https://diviexchange.z6.web.core.windows.net/laendertabelle1.svg
1591110000,32187,19756,12431,691,378,https://diviexchange.z6.web.core.windows.net/laendertabelle1.svg
1591113600,32186,19759,12427,691,378,https://diviexchange.z6.web.core.windows.net/laendertabelle1.svg
1591117200,32184,19757,12427,691,378,https://diviexchange.z6.web.core.windows.net/laendertabelle1.svg
1591120800,32182,19754,12428,691,378,https://diviexchange.z6.web.core.windows.net/laendertabelle1.svg
1591124400,32180,19755,12425,692,378,https://diviexchange.z6.web.core.windows.net/laendertabelle1.svg
1591128000,32184,19759,12425,692,378,https://diviexchange.z6.web.core.windows.net/laendertabelle1.svg
1591131600,32184,19760,12424,692,378,https://diviexchange.z6.web.core.windows.net/laendertabelle1.svg
1591135200,32184,19758,12426,692,378,https://diviexchange.z6.web.core.windows.net/laendertabelle1.svg
1591138800,32187,19758,12429,692,378,https://diviexchange.z6.web.core.windows.net/laendertabelle1.svg
1591142400,32187,19764,12423,692,378,https://diviexchange.z6.web.core.windows.net/laendertabelle1.svg
1591146000,32178,19770,12408,692,378,https://diviexchange.z6.web.core.windows.net/laendertabelle1.svg
1591153200,32178,19774,12404,692,378,https://diviexchange.z6.web.core.windows.net/laendertabelle1.svg
1591156800,32174,19774,12400,691,378,https://diviexchange.z6.web.core.windows.net/laendertabelle1.svg
1591160400,32194,19890,12304,680,374,https://diviexchange.z6.web.core.windows.net/laendertabelle1.svg
1591164000,32238,20166,12072,670,369,https://diviexchange.z6.web.core.windows.net/laendertabelle1.svg
1591167600,32335,20506,11829,638,362,https://diviexchange.z6.web.core.windows.net/laendertabelle1.svg
1591171200,32345,20560,11785,632,362,https://diviexchange.z6.web.core.windows.net/laendertabelle1.svg
1591174800,32379,20588,11791,635,362,https://diviexchange.z6.web.core.windows.net/laendertabelle1.svg
1591178400,32384,20603,11781,635,361,https://diviexchange.z6.web.core.windows.net/laendertabelle1.svg
1591182000,32382,20603,11779,634,360,https://diviexchange.z6.web.core.windows.net/laendertabelle1.svg
1591185600,32382,20605,11777,634,360,https://diviexchange.z6.web.core.windows.net/laendertabelle1.svg
1591189200,32383,20608,11775,636,361,https://diviexchange.z6.web.core.windows.net/laendertabelle1.svg
1591192800,32383,20597,11786,636,361,https://diviexchange.z6.web.core.windows.net/laendertabelle1.svg
1591196400,32405,20610,11795,637,361,https://diviexchange.z6.web.core.windows.net/laendertabelle1.svg
1591200000,32406,20616,11790,636,361,https://diviexchange.z6.web.core.windows.net/laendertabelle1.svg
1591203600,32406,20617,11789,636,361,https://diviexchange.z6.web.core.windows.net/laendertabelle1.svg
1591207200,32384,20598,11786,636,361,https://diviexchange.z6.web.core.windows.net/laendertabelle1.svg
1591210800,32341,20576,11765,636,361,https://diviexchange.z6.web.core.windows.net/laendertabelle1.svg
1591214400,32280,20545,11735,635,360,https://diviexchange.z6.web.core.windows.net/laendertabelle1.svg
1591221600,32279,20549,11730,635,360,https://diviexchange.z6.web.core.windows.net/laendertabelle1.svg
1591225200,32281,20543,11738,634,359,https://diviexchange.z6.web.core.windows.net/laendertabelle1.svg
1591228800,32272,20541,11731,634,359,https://diviexchange.z6.web.core.windows.net/laendertabelle1.svg
1591239600,32269,20541,11728,634,359,https://diviexchange.z6.web.core.windows.net/laendertabelle1.svg
1591243200,32271,20540,11731,633,359,https://diviexchange.z6.web.core.windows.net/laendertabelle1.svg
1591246800,32323,20608,11715,625,358,https://diviexchange.z6.web.core.windows.net/laendertabelle1.svg
1591250400,32327,20721,11606,620,350,https://diviexchange.z6.web.core.windows.net/laendertabelle1.svg
1591254000,32415,20952,11463,601,341,https://diviexchange.z6.web.core.windows.net/laendertabelle1.svg
1591261200,32385,20948,11437,597,340,https://diviexchange.z6.web.core.windows.net/laendertabelle1.svg
1591264800,32377,20933,11444,599,340,https://diviexchange.z6.web.core.windows.net/laendertabelle1.svg
1591268400,32376,20930,11446,602,341,https://diviexchange.z6.web.core.windows.net/laendertabelle1.svg
1591272000,32376,20927,11449,601,340,https://diviexchange.z6.web.core.windows.net/laendertabelle1.svg
1591275600,32376,20931,11445,601,340,https://diviexchange.z6.web.core.windows.net/laendertabelle1.svg
1591279200,32375,20928,11447,601,339,https://diviexchange.z6.web.core.windows.net/laendertabelle1.svg
1591282800,32374,20930,11444,604,339,https://diviexchange.z6.web.core.windows.net/laendertabelle1.svg
1591286400,32374,20932,11442,604,339,https://diviexchange.z6.web.core.windows.net/laendertabelle1.svg
1591290000,32396,20947,11449,604,339,https://diviexchange.z6.web.core.windows.net/laendertabelle1.svg
1591293600,32363,20917,11446,604,339,https://diviexchange.z6.web.core.windows.net/laendertabelle1.svg
1591297200,32362,20908,11454,604,339,https://diviexchange.z6.web.core.windows.net/laendertabelle1.svg
1591300800,32344,20896,11448,603,338,https://diviexchange.z6.web.core.windows.net/laendertabelle1.svg
1591304400,32342,20896,11446,603,338,https://diviexchange.z6.web.core.windows.net/laendertabelle1.svg
1591308000,32342,20895,11447,603,338,https://diviexchange.z6.web.core.windows.net/laendertabelle1.svg
1591311600,32342,20896,11446,603,338,https://diviexchange.z6.web.core.windows.net/laendertabelle1.svg
1591315200,32332,20883,11449,603,338,https://diviexchange.z6.web.core.windows.net/laendertabelle1.svg
1591318800,32332,20884,11448,603,338,https://diviexchange.z6.web.core.windows.net/laendertabelle1.svg
1591326000,32332,20885,11447,603,338,https://diviexchange.z6.web.core.windows.net/laendertabelle1.svg
1591329600,32327,20895,11432,604,338,https://diviexchange.z6.web.core.windows.net/laendertabelle1.svg
1591333200,32330,20964,11366,599,338,https://diviexchange.z6.web.core.windows.net/laendertabelle1.svg
1591336800,32351,21013,11338,602,341,https://diviexchange.z6.web.core.windows.net/laendertabelle1.svg
1591340400,32379,21051,11328,596,339,https://diviexchange.z6.web.core.windows.net/laendertabelle1.svg
1591344000,32399,21059,11340,592,341,https://diviexchange.z6.web.core.windows.net/laendertabelle1.svg
1591347600,32410,21054,11356,593,342,https://diviexchange.z6.web.core.windows.net/laendertabelle1.svg
1591351200,32404,21049,11355,592,340,https://diviexchange.z6.web.core.windows.net/laendertabelle1.svg
1591354800,32406,21066,11340,593,340,https://diviexchange.z6.web.core.windows.net/laendertabelle1.svg
1591358400,32413,21066,11347,594,340,https://diviexchange.z6.web.core.windows.net/laendertabelle1.svg
1591362000,32417,21067,11350,594,340,https://diviexchange.z6.web.core.windows.net/laendertabelle1.svg
1591365600,32423,21054,11369,595,341,https://diviexchange.z6.web.core.windows.net/laendertabelle1.svg
1591369200,32431,21055,11376,595,342,https://diviexchange.z6.web.core.windows.net/laendertabelle1.svg
1591372800,32431,21054,11377,595,342,https://diviexchange.z6.web.core.windows.net/laendertabelle1.svg
1591376400,32410,21035,11375,595,342,https://diviexchange.z6.web.core.windows.net/laendertabelle1.svg
1591380000,32370,21016,11354,595,342,https://diviexchange.z6.web.core.windows.net/laendertabelle1.svg
1591383600,32336,20991,11345,595,342,https://diviexchange.z6.web.core.windows.net/laendertabelle1.svg
1591387200,32336,20981,11355,593,342,https://diviexchange.z6.web.core.windows.net/laendertabelle1.svg
1591390800,32338,20980,11358,593,342,https://diviexchange.z6.web.core.windows.net/laendertabelle1.svg
1591394400,32321,20963,11358,593,342,https://diviexchange.z6.web.core.windows.net/laendertabelle1.svg
1591398000,32311,20950,11361,592,342,https://diviexchange.z6.web.core.windows.net/laendertabelle1.svg
1591401600,32309,20950,11359,592,342,https://diviexchange.z6.web.core.windows.net/laendertabelle1.svg
1591405200,32308,20943,11365,592,342,https://diviexchange.z6.web.core.windows.net/laendertabelle1.svg
1591408800,32308,20940,11368,592,342,https://diviexchange.z6.web.core.windows.net/laendertabelle1.svg
1591412400,32302,20931,11371,593,342,https://diviexchange.z6.web.core.windows.net/laendertabelle1.svg
1591416000,32301,20922,11379,590,342,https://diviexchange.z6.web.core.windows.net/laendertabelle1.svg
1591419600,32311,20930,11381,588,342,https://diviexchange.z6.web.core.windows.net/laendertabelle1.svg
1591423200,32317,20864,11453,590,343,https://diviexchange.z6.web.core.windows.net/laendertabelle1.svg
1591426800,32306,20726,11580,577,337,https://diviexchange.z6.web.core.windows.net/laendertabelle1.svg
1591430400,32311,20731,11580,573,335,https://diviexchange.z6.web.core.windows.net/laendertabelle1.svg
1591434000,32319,20734,11585,573,336,https://diviexchange.z6.web.core.windows.net/laendertabelle1.svg
1591437600,32322,20732,11590,566,336,https://diviexchange.z6.web.core.windows.net/laendertabelle1.svg
1591441200,32322,20731,11591,566,336,https://diviexchange.z6.web.core.windows.net/laendertabelle1.svg
1591444800,32322,20713,11609,567,336,https://diviexchange.z6.web.core.windows.net/laendertabelle1.svg
1591448400,32320,20708,11612,569,336,https://diviexchange.z6.web.core.windows.net/laendertabelle1.svg
1591452000,32318,20705,11613,569,336,https://diviexchange.z6.web.core.windows.net/laendertabelle1.svg
1591455600,32317,20701,11616,569,336,https://diviexchange.z6.web.core.windows.net/laendertabelle1.svg
1591462800,32295,20690,11605,569,336,https://diviexchange.z6.web.core.windows.net/laendertabelle1.svg
1591466400,32250,20672,11578,569,336,https://diviexchange.z6.web.core.windows.net/laendertabelle1.svg
1591470000,32175,20619,11556,569,336,https://diviexchange.z6.web.core.windows.net/laendertabelle1.svg
1591473600,32178,20631,11547,569,336,https://diviexchange.z6.web.core.windows.net/laendertabelle1.svg
1591477200,32150,20618,11532,569,336,https://diviexchange.z6.web.core.windows.net/laendertabelle1.svg
1591480800,32128,20600,11528,569,336,https://diviexchange.z6.web.core.windows.net/laendertabelle1.svg
1591484400,32136,20588,11548,569,336,https://diviexchange.z6.web.core.windows.net/laendertabelle1.svg
1591488000,32139,20580,11559,570,336,https://diviexchange.z6.web.core.windows.net/laendertabelle1.svg
1591491600,32139,20581,11558,570,336,https://diviexchange.z6.web.core.windows.net/laendertabelle1.svg
1591495200,32104,20562,11542,570,336,https://diviexchange.z6.web.core.windows.net/laendertabelle1.svg
1591498800,32076,20539,11537,567,336,https://diviexchange.z6.web.core.windows.net/laendertabelle1.svg
1591502400,32077,20545,11532,564,336,https://diviexchange.z6.web.core.windows.net/laendertabelle1.svg
1591506000,32036,20503,11533,565,338,https://diviexchange.z6.web.core.windows.net/laendertabelle1.svg
1591509600,32059,20369,11690,572,335,https://diviexchange.z6.web.core.windows.net/laendertabelle1.svg
1591513200,32079,20090,11989,568,332,https://diviexchange.z6.web.core.windows.net/laendertabelle1.svg
1591516800,32083,20055,12028,571,331,https://diviexchange.z6.web.core.windows.net/laendertabelle1.svg
1591520400,32076,20033,12043,565,333,https://diviexchange.z6.web.core.windows.net/laendertabelle1.svg
1591524000,32075,20013,12062,567,332,https://diviexchange.z6.web.core.windows.net/laendertabelle1.svg
1591527600,32067,19987,12080,566,331,https://diviexchange.z6.web.core.windows.net/laendertabelle1.svg
1591531200,32061,19981,12080,567,332,https://diviexchange.z6.web.core.windows.net/laendertabelle1.svg
1591534800,32057,19977,12080,566,332,https://diviexchange.z6.web.core.windows.net/laendertabelle1.svg
1591538400,32057,19966,12091,566,332,https://diviexchange.z6.web.core.windows.net/laendertabelle1.svg
1591542000,32055,19966,12089,566,332,https://diviexchange.z6.web.core.windows.net/laendertabelle1.svg
1591545600,32042,19946,12096,566,332,https://diviexchange.z6.web.core.windows.net/laendertabelle1.svg
1591549200,31870,19871,11999,559,327,https://diviexchange.z6.web.core.windows.net/laendertabelle1.svg
1591552800,31636,19708,11928,556,327,https://diviexchange.z6.web.core.windows.net/laendertabelle1.svg
1591556400,31494,19608,11886,551,326,https://diviexchange.z6.web.core.windows.net/laendertabelle1.svg
1591560000,31434,19573,11861,551,326,https://diviexchange.z6.web.core.windows.net/laendertabelle1.svg
1591563600,31330,19518,11812,551,326,https://diviexchange.z6.web.core.windows.net/laendertabelle1.svg
1591567200,31320,19508,11812,551,326,https://diviexchange.z6.web.core.windows.net/laendertabelle1.svg
1591570800,31327,19511,11816,551,326,https://diviexchange.z6.web.core.windows.net/laendertabelle1.svg
1591574400,31284,19486,11798,551,326,https://diviexchange.z6.web.core.windows.net/laendertabelle1.svg
1591578000,31284,19487,11797,551,326,https://diviexchange.z6.web.core.windows.net/laendertabelle1.svg
1591581600,31284,19493,11791,552,326,https://diviexchange.z6.web.core.windows.net/laendertabelle1.svg
1591585200,31279,19499,11780,552,326,https://diviexchange.z6.web.core.windows.net/laendertabelle1.svg
1591588800,31281,19498,11783,552,326,https://diviexchange.z6.web.core.windows.net/laendertabelle1.svg
1591592400,31315,19522,11793,551,326,https://diviexchange.z6.web.core.windows.net/laendertabelle1.svg
1591596000,31430,19508,11922,558,330,https://diviexchange.z6.web.core.windows.net/laendertabelle1.svg
1591599600,31763,19635,12128,548,321,https://diviexchange.z6.web.core.windows.net/laendertabelle1.svg
1591603200,31865,19724,12141,547,319,https://diviexchange.z6.web.core.windows.net/laendertabelle1.svg
1591606800,31956,19790,12166,546,320,https://diviexchange.z6.web.core.windows.net/laendertabelle1.svg
1591610400,32044,19846,12198,545,320,https://diviexchange.z6.web.core.windows.net/laendertabelle1.svg
1591614000,32052,19853,12199,545,319,https://diviexchange.z6.web.core.windows.net/laendertabelle1.svg
1591617600,32122,19897,12225,544,319,https://diviexchange.z6.web.core.windows.net/laendertabelle1.svg
1591621200,32120,19884,12236,544,319,https://diviexchange.z6.web.core.windows.net/laendertabelle1.svg
1591624800,32160,19922,12238,546,319,https://diviexchange.z6.web.core.windows.net/laendertabelle1.svg
1591628400,32159,19934,12225,546,317,https://diviexchange.z6.web.core.windows.net/laendertabelle1.svg
1591632000,32204,19974,12230,546,318,https://diviexchange.z6.web.core.windows.net/laendertabelle1.svg
1591639200,32213,19982,12231,546,318,https://diviexchange.z6.web.core.windows.net/laendertabelle1.svg
1591650000,32213,19981,12232,546,318,https://diviexchange.z6.web.core.windows.net/laendertabelle1.svg
1591653600,32214,19982,12232,546,318,https://diviexchange.z6.web.core.windows.net/laendertabelle1.svg
1591657200,32214,19977,12237,546,318,https://diviexchange.z6.web.core.windows.net/laendertabelle1.svg
1591660800,32213,19972,12241,546,318,https://diviexchange.z6.web.core.windows.net/laendertabelle1.svg
1591668000,32212,19972,12240,546,318,https://diviexchange.z6.web.core.windows.net/laendertabelle1.svg
1591671600,32213,19977,12236,546,317,https://diviexchange.z6.web.core.windows.net/laendertabelle1.svg
1591675200,32216,19989,12227,545,316,https://diviexchange.z6.web.core.windows.net/laendertabelle1.svg
1591678800,32222,20115,12107,544,319,https://diviexchange.z6.web.core.windows.net/laendertabelle1.svg
1591682400,32266,20331,11935,539,317,https://diviexchange.z6.web.core.windows.net/laendertabelle1.svg
1591686000,32309,20764,11545,539,322,https://diviexchange.z6.web.core.windows.net/laendertabelle1.svg
1591689600,32398,20834,11564,532,321,https://diviexchange.z6.web.core.windows.net/laendertabelle1.svg
1591693200,32384,20831,11553,527,319,https://diviexchange.z6.web.core.windows.net/laendertabelle1.svg
1591696800,32391,20858,11533,525,318,https://diviexchange.z6.web.core.windows.net/laendertabelle1.svg
1591700400,32400,20858,11542,523,318,https://diviexchange.z6.web.core.windows.net/laendertabelle1.svg
1591704000,32406,20854,11552,523,318,https://diviexchange.z6.web.core.windows.net/laendertabelle1.svg
1591707600,32406,20864,11542,523,318,https://diviexchange.z6.web.core.windows.net/laendertabelle1.svg
1591711200,32409,20868,11541,522,316,https://diviexchange.z6.web.core.windows.net/laendertabelle1.svg
1591714800,32418,20871,11547,521,315,https://diviexchange.z6.web.core.windows.net/laendertabelle1.svg
1591718400,32418,20868,11550,521,315,https://diviexchange.z6.web.core.windows.net/laendertabelle1.svg
1591722000,32419,20868,11551,521,315,https://diviexchange.z6.web.core.windows.net/laendertabelle1.svg
1591725600,32403,20856,11547,521,315,https://diviexchange.z6.web.core.windows.net/laendertabelle1.svg
1591729200,32357,20826,11531,521,315,https://diviexchange.z6.web.core.windows.net/laendertabelle1.svg
1591732800,32357,20827,11530,521,315,https://diviexchange.z6.web.core.windows.net/laendertabelle1.svg
1591736400,32357,20825,11532,521,315,https://diviexchange.z6.web.core.windows.net/laendertabelle1.svg
1591740000,32347,20817,11530,521,315,https://diviexchange.z6.web.core.windows.net/laendertabelle1.svg
1591743600,32346,20820,11526,521,315,https://diviexchange.z6.web.core.windows.net/laendertabelle1.svg
1591747200,32361,20824,11537,521,315,https://diviexchange.z6.web.core.windows.net/laendertabelle1.svg
1591750800,32362,20825,11537,521,315,https://diviexchange.z6.web.core.windows.net/laendertabelle1.svg
1591754400,32362,20826,11536,521,315,https://diviexchange.z6.web.core.windows.net/laendertabelle1.svg
1591758000,32361,20828,11533,521,315,https://diviexchange.z6.web.core.windows.net/laendertabelle1.svg
1591761600,32364,20832,11532,524,318,https://diviexchange.z6.web.core.windows.net/laendertabelle1.svg
1591765200,32369,20884,11485,520,313,https://diviexchange.z6.web.core.windows.net/laendertabelle1.svg
1591768800,32368,20959,11409,502,301,https://diviexchange.z6.web.core.windows.net/laendertabelle1.svg
1591772400,32427,21015,11412,496,293,https://diviexchange.z6.web.core.windows.net/laendertabelle1.svg
1591776000,32446,21027,11419,498,295,https://diviexchange.z6.web.core.windows.net/laendertabelle1.svg
1591779600,32460,21027,11433,496,293,https://diviexchange.z6.web.core.windows.net/laendertabelle1.svg
1591783200,32467,21040,11427,492,290,https://diviexchange.z6.web.core.windows.net/laendertabelle1.svg
1591786800,32475,21033,11442,492,290,https://diviexchange.z6.web.core.windows.net/laendertabelle1.svg
1591790400,32469,21032,11437,492,290,https://diviexchange.z6.web.core.windows.net/laendertabelle1.svg
1591794000,32469,21039,11430,491,290,https://diviexchange.z6.web.core.windows.net/laendertabelle1.svg
1591797600,32469,21044,11425,491,290,https://diviexchange.z6.web.core.windows.net/laendertabelle1.svg
1591801200,32477,21050,11427,490,291,https://diviexchange.z6.web.core.windows.net/laendertabelle1.svg
1591804800,32477,21051,11426,490,291,https://diviexchange.z6.web.core.windows.net/laendertabelle1.svg
1591808400,32477,21053,11424,490,291,https://diviexchange.z6.web.core.windows.net/laendertabelle1.svg
1591812000,32456,21032,11424,490,291,https://diviexchange.z6.web.core.windows.net/laendertabelle1.svg
1591815600,32449,21028,11421,490,291,https://diviexchange.z6.web.core.windows.net/laendertabelle1.svg
1591826400,32449,21029,11420,490,291,https://diviexchange.z6.web.core.windows.net/laendertabelle1.svg
1591830000,32449,21024,11425,490,291,https://diviexchange.z6.web.core.windows.net/laendertabelle1.svg
1591833600,32449,21023,11426,491,291,https://diviexchange.z6.web.core.windows.net/laendertabelle1.svg
1591837200,32449,21020,11429,491,291,https://diviexchange.z6.web.core.windows.net/laendertabelle1.svg
1591959600,32389,20487,11902,456,277,https://diviexchange.z6.web.core.windows.net/laendertabelle1.svg
1591963200,32397,20479,11918,456,277,https://diviexchange.z6.web.core.windows.net/laendertabelle1.svg
1591966800,32396,20477,11919,456,277,https://diviexchange.z6.web.core.windows.net/laendertabelle1.svg
1591970400,32395,20476,11919,457,277,https://diviexchange.z6.web.core.windows.net/laendertabelle1.svg
1591974000,32395,20479,11916,455,276,https://diviexchange.z6.web.core.windows.net/laendertabelle1.svg
1591977600,32406,20492,11914,456,276,https://diviexchange.z6.web.core.windows.net/laendertabelle1.svg
1591981200,32389,20474,11915,453,273,https://diviexchange.z6.web.core.windows.net/laendertabelle1.svg
1591984800,32367,20454,11913,453,273,https://diviexchange.z6.web.core.windows.net/laendertabelle1.svg
1591988400,32245,20361,11884,453,273,https://diviexchange.z6.web.core.windows.net/laendertabelle1.svg
1591992000,32201,20334,11867,453,273,https://diviexchange.z6.web.core.windows.net/laendertabelle1.svg
1591995600,32210,20332,11878,449,271,https://diviexchange.z6.web.core.windows.net/laendertabelle1.svg
1591999200,32210,20334,11876,449,271,https://diviexchange.z6.web.core.windows.net/laendertabelle1.svg
1592002800,32206,20327,11879,449,271,https://diviexchange.z6.web.core.windows.net/laendertabelle1.svg
1592006400,32205,20332,11873,449,271,https://diviexchange.z6.web.core.windows.net/laendertabelle1.svg
1592010000,32200,20330,11870,449,271,https://diviexchange.z6.web.core.windows.net/laendertabelle1.svg
1592013600,32200,20323,11877,448,270,https://diviexchange.z6.web.core.windows.net/laendertabelle1.svg
1592017200,32161,20293,11868,448,270,https://diviexchange.z6.web.core.windows.net/laendertabelle1.svg
1592020800,32161,20285,11876,447,270,https://diviexchange.z6.web.core.windows.net/laendertabelle1.svg
1592024400,32176,20286,11890,445,269,https://diviexchange.z6.web.core.windows.net/laendertabelle1.svg
1592028000,32166,20289,11877,439,267,https://diviexchange.z6.web.core.windows.net/laendertabelle1.svg
1592031600,32161,20312,11849,448,263,https://diviexchange.z6.web.core.windows.net/laendertabelle1.svg
1592035200,32156,20357,11799,448,262,https://diviexchange.z6.web.core.windows.net/laendertabelle1.svg
1592038800,32139,20320,11819,444,261,https://diviexchange.z6.web.core.windows.net/laendertabelle1.svg
1592042400,32148,20308,11840,456,260,https://diviexchange.z6.web.core.windows.net/laendertabelle1.svg
1592046000,32155,20317,11838,459,265,https://diviexchange.z6.web.core.windows.net/laendertabelle1.svg
1592049600,32154,20312,11842,459,265,https://diviexchange.z6.web.core.windows.net/laendertabelle1.svg
1592053200,32154,20314,11840,459,265,https://diviexchange.z6.web.core.windows.net/laendertabelle1.svg
1592056800,32150,20315,11835,458,265,https://diviexchange.z6.web.core.windows.net/laendertabelle1.svg
1592060400,32151,20320,11831,458,265,https://diviexchange.z6.web.core.windows.net/laendertabelle1.svg
1592064000,32127,20295,11832,458,265,https://diviexchange.z6.web.core.windows.net/laendertabelle1.svg
1592067600,32124,20298,11826,459,265,https://diviexchange.z6.web.core.windows.net/laendertabelle1.svg
1592071200,32079,20260,11819,459,265,https://diviexchange.z6.web.core.windows.net/laendertabelle1.svg
1592074800,32009,20195,11814,456,264,https://diviexchange.z6.web.core.windows.net/laendertabelle1.svg
1592078400,31989,20175,11814,456,264,https://diviexchange.z6.web.core.windows.net/laendertabelle1.svg
1592082000,31972,20161,11811,456,264,https://diviexchange.z6.web.core.windows.net/laendertabelle1.svg
1592085600,31941,20141,11800,453,261,https://diviexchange.z6.web.core.windows.net/laendertabelle1.svg
1592089200,31924,20127,11797,452,261,https://diviexchange.z6.web.core.windows.net/laendertabelle1.svg
1592092800,31923,20130,11793,452,261,https://diviexchange.z6.web.core.windows.net/laendertabelle1.svg
1592096400,31862,20085,11777,448,259,https://diviexchange.z6.web.core.windows.net/laendertabelle1.svg
1592100000,31862,20082,11780,448,259,https://diviexchange.z6.web.core.windows.net/laendertabelle1.svg
1592103600,31863,20084,11779,448,259,https://diviexchange.z6.web.core.windows.net/laendertabelle1.svg
1592107200,31863,20083,11780,448,259,https://diviexchange.z6.web.core.windows.net/laendertabelle1.svg
1592110800,31866,20079,11787,447,259,https://diviexchange.z6.web.core.windows.net/laendertabelle1.svg
1592114400,31875,19972,11903,447,258,https://diviexchange.z6.web.core.windows.net/laendertabelle1.svg
1592118000,31998,19909,12089,443,260,https://diviexchange.z6.web.core.windows.net/laendertabelle1.svg
1592121600,32029,19882,12147,449,260,https://diviexchange.z6.web.core.windows.net/laendertabelle1.svg
1592125200,32025,19830,12195,435,262,https://diviexchange.z6.web.core.windows.net/laendertabelle1.svg
1592128800,32056,19857,12199,437,263,https://diviexchange.z6.web.core.windows.net/laendertabelle1.svg
1592132400,32058,19860,12198,436,263,https://diviexchange.z6.web.core.windows.net/laendertabelle1.svg
1592136000,32057,19858,12199,436,263,https://diviexchange.z6.web.core.windows.net/laendertabelle1.svg
1592139600,32056,19855,12201,436,263,https://diviexchange.z6.web.core.windows.net/laendertabelle1.svg
1592143200,32056,19843,12213,436,263,https://diviexchange.z6.web.core.windows.net/laendertabelle1.svg
1592146800,32002,19795,12207,432,260,https://diviexchange.z6.web.core.windows.net/laendertabelle1.svg
1592150400,32061,19840,12221,436,263,https://diviexchange.z6.web.core.windows.net/laendertabelle1.svg
1592154000,32062,19842,12220,435,263,https://diviexchange.z6.web.core.windows.net/laendertabelle1.svg
1592157600,31942,19775,12167,435,263,https://diviexchange.z6.web.core.windows.net/laendertabelle1.svg
1592161200,31754,19666,12088,435,263,https://diviexchange.z6.web.core.windows.net/laendertabelle1.svg
1592164800,31630,19604,12026,434,262,https://diviexchange.z6.web.core.windows.net/laendertabelle1.svg
1592168400,31579,19573,12006,432,261,https://diviexchange.z6.web.core.windows.net/laendertabelle1.svg
1592172000,31568,19570,11998,432,261,https://diviexchange.z6.web.core.windows.net/laendertabelle1.svg
1592175600,31558,19567,11991,432,261,https://diviexchange.z6.web.core.windows.net/laendertabelle1.svg
1592179200,31511,19540,11971,432,261,https://diviexchange.z6.web.core.windows.net/laendertabelle1.svg
1592182800,31490,19531,11959,432,261,https://diviexchange.z6.web.core.windows.net/laendertabelle1.svg
1592186400,31461,19510,11951,432,261,https://diviexchange.z6.web.core.windows.net/laendertabelle1.svg
1592190000,31451,19494,11957,433,262,https://diviexchange.z6.web.core.windows.net/laendertabelle1.svg
1592193600,31454,19498,11956,434,262,https://diviexchange.z6.web.core.windows.net/laendertabelle1.svg
1592197200,31515,19581,11934,438,264,https://diviexchange.z6.web.core.windows.net/laendertabelle1.svg
1592200800,31649,19625,12024,431,266,https://diviexchange.z6.web.core.windows.net/laendertabelle1.svg
1592204400,31823,19732,12091,427,261,https://diviexchange.z6.web.core.windows.net/laendertabelle1.svg
1592208000,31995,19850,12145,433,263,https://diviexchange.z6.web.core.windows.net/laendertabelle1.svg
1592211600,32116,19909,12207,436,263,https://diviexchange.z6.web.core.windows.net/laendertabelle1.svg
1592215200,32203,19971,12232,435,261,https://diviexchange.z6.web.core.windows.net/laendertabelle1.svg
1592218800,32232,19986,12246,435,261,https://diviexchange.z6.web.core.windows.net/laendertabelle1.svg
1592222400,32283,20002,12281,436,262,https://diviexchange.z6.web.core.windows.net/laendertabelle1.svg
1592226000,32278,20006,12272,436,262,https://diviexchange.z6.web.core.windows.net/laendertabelle1.svg
1592229600,32275,20005,12270,436,262,https://diviexchange.z6.web.core.windows.net/laendertabelle1.svg
1592233200,32321,20039,12282,436,262,https://diviexchange.z6.web.core.windows.net/laendertabelle1.svg
1592236800,32324,20041,12283,436,262,https://diviexchange.z6.web.core.windows.net/laendertabelle1.svg
1592240400,32305,20024,12281,436,262,https://diviexchange.z6.web.core.windows.net/laendertabelle1.svg
1592244000,32305,20032,12273,435,261,https://diviexchange.z6.web.core.windows.net/laendertabelle1.svg
1592247600,32305,20030,12275,435,261,https://diviexchange.z6.web.core.windows.net/laendertabelle1.svg
1592251200,32307,20030,12277,435,261,https://diviexchange.z6.web.core.windows.net/laendertabelle1.svg
1592254800,32308,20029,12279,435,261,https://diviexchange.z6.web.core.windows.net/laendertabelle1.svg
1592258400,32291,20017,12274,435,261,https://diviexchange.z6.web.core.windows.net/laendertabelle1.svg
1592262000,32291,20018,12273,435,261,https://diviexchange.z6.web.core.windows.net/laendertabelle1.svg
1592265600,32307,20024,12283,435,261,https://diviexchange.z6.web.core.windows.net/laendertabelle1.svg
1592269200,32306,20026,12280,435,261,https://diviexchange.z6.web.core.windows.net/laendertabelle1.svg
1592272800,32309,20028,12281,435,261,https://diviexchange.z6.web.core.windows.net/laendertabelle1.svg
1592276400,32307,20027,12280,435,261,https://diviexchange.z6.web.core.windows.net/laendertabelle1.svg
1592280000,32307,20043,12264,434,259,https://diviexchange.z6.web.core.windows.net/laendertabelle1.svg
1592283600,32296,20115,12181,430,259,https://diviexchange.z6.web.core.windows.net/laendertabelle1.svg
1592287200,32345,20358,11987,426,257,https://diviexchange.z6.web.core.windows.net/laendertabelle1.svg
1592290800,32398,20641,11757,424,258,https://diviexchange.z6.web.core.windows.net/laendertabelle1.svg
1592294400,32434,20752,11682,422,257,https://diviexchange.z6.web.core.windows.net/laendertabelle1.svg
1592298000,32433,20772,11661,420,258,https://diviexchange.z6.web.core.windows.net/laendertabelle1.svg
1592301600,32458,20802,11656,424,259,https://diviexchange.z6.web.core.windows.net/laendertabelle1.svg
1592305200,32404,20808,11596,424,260,https://diviexchange.z6.web.core.windows.net/laendertabelle1.svg
1592308800,32408,20818,11590,424,260,https://diviexchange.z6.web.core.windows.net/laendertabelle1.svg
1592312400,32409,20819,11590,424,260,https://diviexchange.z6.web.core.windows.net/laendertabelle1.svg
1592316000,32412,20822,11590,424,260,https://diviexchange.z6.web.core.windows.net/laendertabelle1.svg
1592319600,32443,20863,11580,421,259,https://diviexchange.z6.web.core.windows.net/laendertabelle1.svg
1592323200,32444,20862,11582,421,259,https://diviexchange.z6.web.core.windows.net/laendertabelle1.svg
1592326800,32444,20865,11579,421,259,https://diviexchange.z6.web.core.windows.net/laendertabelle1.svg
1592330400,32447,20872,11575,421,259,https://diviexchange.z6.web.core.windows.net/laendertabelle1.svg
1592334000,32413,20852,11561,421,259,https://diviexchange.z6.web.core.windows.net/laendertabelle1.svg
1592337600,32413,20853,11560,421,259,https://diviexchange.z6.web.core.windows.net/laendertabelle1.svg
1592341200,32414,20854,11560,421,259,https://diviexchange.z6.web.core.windows.net/laendertabelle1.svg
1592344800,32389,20845,11544,421,259,https://diviexchange.z6.web.core.windows.net/laendertabelle1.svg
1592348400,32380,20835,11545,421,259,https://diviexchange.z6.web.core.windows.net/laendertabelle1.svg
1592355600,32366,20822,11544,421,259,https://diviexchange.z6.web.core.windows.net/laendertabelle1.svg
1592359200,32365,20823,11542,421,259,https://diviexchange.z6.web.core.windows.net/laendertabelle1.svg
1592362800,32360,20818,11542,421,259,https://diviexchange.z6.web.core.windows.net/laendertabelle1.svg
1592366400,32361,20820,11541,421,259,https://diviexchange.z6.web.core.windows.net/laendertabelle1.svg
1592370000,32375,20867,11508,425,262,https://diviexchange.z6.web.core.windows.net/laendertabelle1.svg
1592373600,32355,20942,11413,425,264,https://diviexchange.z6.web.core.windows.net/laendertabelle1.svg
1592377200,32340,21052,11288,417,260,https://diviexchange.z6.web.core.windows.net/laendertabelle1.svg
1592380800,32383,21101,11282,410,252,https://diviexchange.z6.web.core.windows.net/laendertabelle1.svg
1592384400,32408,21130,11278,412,255,https://diviexchange.z6.web.core.windows.net/laendertabelle1.svg
1592388000,32438,21138,11300,412,253,https://diviexchange.z6.web.core.windows.net/laendertabelle1.svg
1592391600,32423,21128,11295,411,253,https://diviexchange.z6.web.core.windows.net/laendertabelle1.svg
1592395200,32423,21128,11295,412,253,https://diviexchange.z6.web.core.windows.net/laendertabelle1.svg
1592398800,32421,21104,11317,412,254,https://diviexchange.z6.web.core.windows.net/laendertabelle1.svg
1592402400,32427,21111,11316,412,254,https://diviexchange.z6.web.core.windows.net/laendertabelle1.svg
1592406000,32418,21112,11306,413,254,https://diviexchange.z6.web.core.windows.net/laendertabelle1.svg
1592409600,32433,21126,11307,413,254,https://diviexchange.z6.web.core.windows.net/laendertabelle1.svg
1592413200,32435,21128,11307,413,254,https://diviexchange.z6.web.core.windows.net/laendertabelle1.svg
1592416800,32428,21122,11306,413,254,https://diviexchange.z6.web.core.windows.net/laendertabelle1.svg
1592420400,32394,21108,11286,413,254,https://diviexchange.z6.web.core.windows.net/laendertabelle1.svg
1592424000,32383,21104,11279,413,254,https://diviexchange.z6.web.core.windows.net/laendertabelle1.svg
1592427600,32397,21110,11287,413,254,https://diviexchange.z6.web.core.windows.net/laendertabelle1.svg
1592431200,32339,21065,11274,411,252,https://diviexchange.z6.web.core.windows.net/laendertabelle1.svg
1592434800,32322,21048,11274,411,252,https://diviexchange.z6.web.core.windows.net/laendertabelle1.svg
1592438400,32326,21047,11279,411,252,https://diviexchange.z6.web.core.windows.net/laendertabelle1.svg
1592442000,32329,21047,11282,411,252,https://diviexchange.z6.web.core.windows.net/laendertabelle1.svg
1592449200,32329,21048,11281,411,251,https://diviexchange.z6.web.core.windows.net/laendertabelle1.svg
1592452800,32333,21045,11288,411,251,https://diviexchange.z6.web.core.windows.net/laendertabelle1.svg
1592456400,32331,21024,11307,406,246,https://diviexchange.z6.web.core.windows.net/laendertabelle1.svg
1592460000,32362,21078,11284,406,241,https://diviexchange.z6.web.core.windows.net/laendertabelle1.svg
1592463600,32398,21188,11210,402,240,https://diviexchange.z6.web.core.windows.net/laendertabelle1.svg
1592467200,32398,21168,11230,401,239,https://diviexchange.z6.web.core.windows.net/laendertabelle1.svg
1592470800,32361,21172,11189,397,240,https://diviexchange.z6.web.core.windows.net/laendertabelle1.svg
1592474400,32465,21218,11247,400,241,https://diviexchange.z6.web.core.windows.net/laendertabelle1.svg
1592478000,32464,21204,11260,400,241,https://diviexchange.z6.web.core.windows.net/laendertabelle1.svg
1592481600,32464,21202,11262,399,241,https://diviexchange.z6.web.core.windows.net/laendertabelle1.svg
1592485200,32459,21199,11260,399,241,https://diviexchange.z6.web.core.windows.net/laendertabelle1.svg
1592488800,32510,21239,11271,403,243,https://diviexchange.z6.web.core.windows.net/laendertabelle1.svg
1592492400,32505,21234,11271,402,242,https://diviexchange.z6.web.core.windows.net/laendertabelle1.svg
1592496000,32505,21236,11269,403,243,https://diviexchange.z6.web.core.windows.net/laendertabelle1.svg
1592499600,32507,21237,11270,403,243,https://diviexchange.z6.web.core.windows.net/laendertabelle1.svg
1592503200,32507,21239,11268,403,243,https://diviexchange.z6.web.core.windows.net/laendertabelle1.svg
1592506800,32504,21239,11265,403,243,https://diviexchange.z6.web.core.windows.net/laendertabelle1.svg
1592510400,32457,21205,11252,403,243,https://diviexchange.z6.web.core.windows.net/laendertabelle1.svg
1592517600,32450,21204,11246,403,243,https://diviexchange.z6.web.core.windows.net/laendertabelle1.svg
1592521200,32467,21216,11251,402,243,https://diviexchange.z6.web.core.windows.net/laendertabelle1.svg
1592524800,32457,21215,11242,402,243,https://diviexchange.z6.web.core.windows.net/laendertabelle1.svg
1592532000,32456,21212,11244,402,243,https://diviexchange.z6.web.core.windows.net/laendertabelle1.svg
1592535600,32458,21210,11248,402,243,https://diviexchange.z6.web.core.windows.net/laendertabelle1.svg
1592539200,32456,21214,11242,402,243,https://diviexchange.z6.web.core.windows.net/laendertabelle1.svg
1592542800,32449,21232,11217,400,239,https://diviexchange.z6.web.core.windows.net/laendertabelle1.svg
1592546400,32507,21310,11197,398,233,https://diviexchange.z6.web.core.windows.net/laendertabelle1.svg
1592550000,32508,21379,11129,387,230,https://diviexchange.z6.web.core.windows.net/laendertabelle1.svg
1592553600,32519,21396,11123,382,229,https://diviexchange.z6.web.core.windows.net/laendertabelle1.svg
1592557200,32502,21365,11137,382,229,https://diviexchange.z6.web.core.windows.net/laendertabelle1.svg
1592560800,32522,21351,11171,381,230,https://diviexchange.z6.web.core.windows.net/laendertabelle1.svg
1592564400,32522,21354,11168,380,228,https://diviexchange.z6.web.core.windows.net/laendertabelle1.svg
1592568000,32530,21341,11189,379,228,https://diviexchange.z6.web.core.windows.net/laendertabelle1.svg
1592571600,32521,21337,11184,379,228,https://diviexchange.z6.web.core.windows.net/laendertabelle1.svg
1592575200,32523,21333,11190,379,228,https://diviexchange.z6.web.core.windows.net/laendertabelle1.svg
1592578800,32524,21327,11197,379,228,https://diviexchange.z6.web.core.windows.net/laendertabelle1.svg
1592582400,32533,21337,11196,379,228,https://diviexchange.z6.web.core.windows.net/laendertabelle1.svg
1592586000,32532,21337,11195,379,228,https://diviexchange.z6.web.core.windows.net/laendertabelle1.svg
1592589600,32530,21343,11187,380,228,https://diviexchange.z6.web.core.windows.net/laendertabelle1.svg
1592593200,32493,21314,11179,380,228,https://diviexchange.z6.web.core.windows.net/laendertabelle1.svg
1592596800,32326,21203,11123,377,225,https://diviexchange.z6.web.core.windows.net/laendertabelle1.svg
1592600400,32301,21190,11111,377,225,https://diviexchange.z6.web.core.windows.net/laendertabelle1.svg
1592604000,32256,21175,11081,377,225,https://diviexchange.z6.web.core.windows.net/laendertabelle1.svg
1592607600,32253,21162,11091,377,225,https://diviexchange.z6.web.core.windows.net/laendertabelle1.svg
1592611200,32256,21163,11093,376,225,https://diviexchange.z6.web.core.windows.net/laendertabelle1.svg
1592614800,32256,21162,11094,376,225,https://diviexchange.z6.web.core.windows.net/laendertabelle1.svg
1592622000,32256,21161,11095,376,225,https://diviexchange.z6.web.core.windows.net/laendertabelle1.svg
1592625600,32242,21157,11085,375,225,https://diviexchange.z6.web.core.windows.net/laendertabelle1.svg
1592629200,32241,21127,11114,376,224,https://diviexchange.z6.web.core.windows.net/laendertabelle1.svg
1592632800,32243,21105,11138,373,223,https://diviexchange.z6.web.core.windows.net/laendertabelle1.svg
1592636400,32256,21068,11188,373,225,https://diviexchange.z6.web.core.windows.net/laendertabelle1.svg
1592640000,32272,21050,11222,371,224,https://diviexchange.z6.web.core.windows.net/laendertabelle1.svg
1592643600,32272,20995,11277,366,223,https://diviexchange.z6.web.core.windows.net/laendertabelle1.svg
1592647200,32410,21007,11403,366,225,https://diviexchange.z6.web.core.windows.net/laendertabelle1.svg
1592650800,32405,20998,11407,366,224,https://diviexchange.z6.web.core.windows.net/laendertabelle1.svg
1592654400,32393,20980,11413,365,224,https://diviexchange.z6.web.core.windows.net/laendertabelle1.svg
1592658000,32405,20979,11426,365,224,https://diviexchange.z6.web.core.windows.net/laendertabelle1.svg
1592661600,32402,20964,11438,365,224,https://diviexchange.z6.web.core.windows.net/laendertabelle1.svg
1592665200,32400,20959,11441,365,224,https://diviexchange.z6.web.core.windows.net/laendertabelle1.svg
1592668800,32406,20953,11453,364,224,https://diviexchange.z6.web.core.windows.net/laendertabelle1.svg
1592672400,32363,20917,11446,364,224,https://diviexchange.z6.web.core.windows.net/laendertabelle1.svg
1592676000,32356,20911,11445,364,224,https://diviexchange.z6.web.core.windows.net/laendertabelle1.svg
1592679600,32226,20812,11414,363,223,https://diviexchange.z6.web.core.windows.net/laendertabelle1.svg
1592683200,32194,20787,11407,363,223,https://diviexchange.z6.web.core.windows.net/laendertabelle1.svg
1592686800,32212,20797,11415,363,223,https://diviexchange.z6.web.core.windows.net/laendertabelle1.svg
1592690400,32168,20772,11396,363,223,https://diviexchange.z6.web.core.windows.net/laendertabelle1.svg
1592694000,32166,20766,11400,363,223,https://diviexchange.z6.web.core.windows.net/laendertabelle1.svg
1592697600,32154,20758,11396,363,223,https://diviexchange.z6.web.core.windows.net/laendertabelle1.svg
1592701200,32154,20756,11398,363,223,https://diviexchange.z6.web.core.windows.net/laendertabelle1.svg
1592704800,32154,20758,11396,363,223,https://diviexchange.z6.web.core.windows.net/laendertabelle1.svg
1592708400,32156,20756,11400,363,223,https://diviexchange.z6.web.core.windows.net/laendertabelle1.svg
1592712000,32145,20756,11389,362,223,https://diviexchange.z6.web.core.windows.net/laendertabelle1.svg
1592715600,32157,20734,11423,363,223,https://diviexchange.z6.web.core.windows.net/laendertabelle1.svg
1592719200,32144,20602,11542,362,222,https://diviexchange.z6.web.core.windows.net/laendertabelle1.svg
1592722800,32100,20356,11744,362,216,https://diviexchange.z6.web.core.windows.net/laendertabelle1.svg
1592726400,32133,20258,11875,356,213,https://diviexchange.z6.web.core.windows.net/laendertabelle1.svg
1592730000,32126,20207,11919,360,212,https://diviexchange.z6.web.core.windows.net/laendertabelle1.svg
1592733600,32143,20216,11927,356,207,https://diviexchange.z6.web.core.windows.net/laendertabelle1.svg
1592737200,32135,20211,11924,356,207,https://diviexchange.z6.web.core.windows.net/laendertabelle1.svg
1592740800,32148,20210,11938,356,207,https://diviexchange.z6.web.core.windows.net/laendertabelle1.svg
1592744400,32148,20212,11936,356,207,https://diviexchange.z6.web.core.windows.net/laendertabelle1.svg
1592755200,32143,20216,11927,357,207,https://diviexchange.z6.web.core.windows.net/laendertabelle1.svg
1592758800,32122,20197,11925,357,207,https://diviexchange.z6.web.core.windows.net/laendertabelle1.svg
1592762400,31884,20047,11837,354,206,https://diviexchange.z6.web.core.windows.net/laendertabelle1.svg
1592766000,31635,19875,11760,354,206,https://diviexchange.z6.web.core.windows.net/laendertabelle1.svg
1592769600,31557,19822,11735,351,206,https://diviexchange.z6.web.core.windows.net/laendertabelle1.svg
1592773200,31553,19798,11755,350,205,https://diviexchange.z6.web.core.windows.net/laendertabelle1.svg
1592776800,31535,19784,11751,350,205,https://diviexchange.z6.web.core.windows.net/laendertabelle1.svg
1592780400,31536,19778,11758,350,205,https://diviexchange.z6.web.core.windows.net/laendertabelle1.svg
1592784000,31528,19774,11754,350,205,https://diviexchange.z6.web.core.windows.net/laendertabelle1.svg
1592787600,31489,19741,11748,350,205,https://diviexchange.z6.web.core.windows.net/laendertabelle1.svg
1592794800,31490,19741,11749,350,205,https://diviexchange.z6.web.core.windows.net/laendertabelle1.svg
1592798400,31493,19747,11746,350,205,https://diviexchange.z6.web.core.windows.net/laendertabelle1.svg
1592802000,31567,19775,11792,355,207,https://diviexchange.z6.web.core.windows.net/laendertabelle1.svg
1592805600,31701,19809,11892,360,212,https://diviexchange.z6.web.core.windows.net/laendertabelle1.svg
1592809200,32151,20074,12077,367,215,https://diviexchange.z6.web.core.windows.net/laendertabelle1.svg
1592812800,32233,20163,12070,368,215,https://diviexchange.z6.web.core.windows.net/laendertabelle1.svg
1592816400,32340,20244,12096,365,214,https://diviexchange.z6.web.core.windows.net/laendertabelle1.svg
1592820000,32380,20274,12106,368,213,https://diviexchange.z6.web.core.windows.net/laendertabelle1.svg
1592823600,32391,20273,12118,368,213,https://diviexchange.z6.web.core.windows.net/laendertabelle1.svg
1592827200,32401,20275,12126,370,212,https://diviexchange.z6.web.core.windows.net/laendertabelle1.svg
1592830800,32413,20284,12129,371,212,https://diviexchange.z6.web.core.windows.net/laendertabelle1.svg
1592834400,32404,20277,12127,372,213,https://diviexchange.z6.web.core.windows.net/laendertabelle1.svg
1592838000,32413,20282,12131,372,213,https://diviexchange.z6.web.core.windows.net/laendertabelle1.svg
1592841600,32412,20280,12132,371,212,https://diviexchange.z6.web.core.windows.net/laendertabelle1.svg
1592845200,32412,20279,12133,370,209,https://diviexchange.z6.web.core.windows.net/laendertabelle1.svg
1592848800,32398,20270,12128,370,209,https://diviexchange.z6.web.core.windows.net/laendertabelle1.svg
1592852400,32387,20265,12122,370,209,https://diviexchange.z6.web.core.windows.net/laendertabelle1.svg
1592859600,32357,20252,12105,370,209,https://diviexchange.z6.web.core.windows.net/laendertabelle1.svg
1592866800,32357,20251,12106,370,209,https://diviexchange.z6.web.core.windows.net/laendertabelle1.svg
1592870400,32357,20256,12101,370,209,https://diviexchange.z6.web.core.windows.net/laendertabelle1.svg
1592874000,32357,20258,12099,370,209,https://diviexchange.z6.web.core.windows.net/laendertabelle1.svg
1592877600,32356,20261,12095,370,209,https://diviexchange.z6.web.core.windows.net/laendertabelle1.svg
1592881200,32356,20258,12098,370,209,https://diviexchange.z6.web.core.windows.net/laendertabelle1.svg
1592884800,32347,20248,12099,368,208,https://diviexchange.z6.web.core.windows.net/laendertabelle1.svg
1592888400,32355,20346,12009,371,206,https://diviexchange.z6.web.core.windows.net/laendertabelle1.svg
1592892000,32424,20588,11836,368,204,https://diviexchange.z6.web.core.windows.net/laendertabelle1.svg
1592895600,32463,20804,11659,367,211,https://diviexchange.z6.web.core.windows.net/laendertabelle1.svg
1592899200,32436,20890,11546,368,209,https://diviexchange.z6.web.core.windows.net/laendertabelle1.svg
1592902800,32445,20941,11504,366,208,https://diviexchange.z6.web.core.windows.net/laendertabelle1.svg
1592906400,32457,20967,11490,361,204,https://diviexchange.z6.web.core.windows.net/laendertabelle1.svg
1592910000,32484,20998,11486,362,204,https://diviexchange.z6.web.core.windows.net/laendertabelle1.svg
1592913600,32479,20997,11482,362,205,https://diviexchange.z6.web.core.windows.net/laendertabelle1.svg
1592917200,32478,20974,11504,362,205,https://diviexchange.z6.web.core.windows.net/laendertabelle1.svg
1592920800,32483,20968,11515,362,204,https://diviexchange.z6.web.core.windows.net/laendertabelle1.svg
1592924400,32495,20979,11516,363,204,https://diviexchange.z6.web.core.windows.net/laendertabelle1.svg
1592928000,32496,20979,11517,363,204,https://diviexchange.z6.web.core.windows.net/laendertabelle1.svg
1592931600,32495,20981,11514,363,204,https://diviexchange.z6.web.core.windows.net/laendertabelle1.svg
1592935200,32481,20968,11513,363,204,https://diviexchange.z6.web.core.windows.net/laendertabelle1.svg
1592938800,32410,20919,11491,362,203,https://diviexchange.z6.web.core.windows.net/laendertabelle1.svg
1592942400,32383,20895,11488,360,202,https://diviexchange.z6.web.core.windows.net/laendertabelle1.svg
1592946000,32383,20894,11489,360,202,https://diviexchange.z6.web.core.windows.net/laendertabelle1.svg
1592949600,32370,20889,11481,360,202,https://diviexchange.z6.web.core.windows.net/laendertabelle1.svg
1592953200,32368,20888,11480,360,202,https://diviexchange.z6.web.core.windows.net/laendertabelle1.svg
1592956800,32368,20889,11479,360,202,https://diviexchange.z6.web.core.windows.net/laendertabelle1.svg
1592960400,32368,20890,11478,360,202,https://diviexchange.z6.web.core.windows.net/laendertabelle1.svg
1592964000,32370,20896,11474,360,202,https://diviexchange.z6.web.core.windows.net/laendertabelle1.svg
1592967600,32370,20894,11476,361,202,https://diviexchange.z6.web.core.windows.net/laendertabelle1.svg
1592971200,32368,20895,11473,361,201,https://diviexchange.z6.web.core.windows.net/laendertabelle1.svg
1592974800,32418,20930,11488,354,196,https://diviexchange.z6.web.core.windows.net/laendertabelle1.svg
1592978400,32411,20981,11430,352,198,https://diviexchange.z6.web.core.windows.net/laendertabelle1.svg
1592982000,32435,21002,11433,358,198,https://diviexchange.z6.web.core.windows.net/laendertabelle1.svg
1592985600,32539,21094,11445,358,195,https://diviexchange.z6.web.core.windows.net/laendertabelle1.svg
1592989200,32549,21071,11478,356,193,https://diviexchange.z6.web.core.windows.net/laendertabelle1.svg
1592992800,32537,21060,11477,354,193,https://diviexchange.z6.web.core.windows.net/laendertabelle1.svg
1592996400,32541,21068,11473,354,193,https://diviexchange.z6.web.core.windows.net/laendertabelle1.svg
1593000000,32548,21072,11476,354,193,https://diviexchange.z6.web.core.windows.net/laendertabelle1.svg
1593003600,32579,21102,11477,354,193,https://diviexchange.z6.web.core.windows.net/laendertabelle1.svg
1593007200,32591,21110,11481,355,194,https://diviexchange.z6.web.core.windows.net/laendertabelle1.svg
1593010800,32614,21135,11479,355,194,https://diviexchange.z6.web.core.windows.net/laendertabelle1.svg
1593014400,32617,21136,11481,355,194,https://diviexchange.z6.web.core.windows.net/laendertabelle1.svg
1593018000,32597,21132,11465,355,194,https://diviexchange.z6.web.core.windows.net/laendertabelle1.svg
1593021600,32577,21117,11460,355,194,https://diviexchange.z6.web.core.windows.net/laendertabelle1.svg
1593025200,32578,21118,11460,354,194,https://diviexchange.z6.web.core.windows.net/laendertabelle1.svg
1593028800,32575,21114,11461,354,194,https://diviexchange.z6.web.core.windows.net/laendertabelle1.svg
1593039600,32571,21113,11458,354,194,https://diviexchange.z6.web.core.windows.net/laendertabelle1.svg
1593043200,32571,21111,11460,354,194,https://diviexchange.z6.web.core.windows.net/laendertabelle1.svg
1593046800,32571,21108,11463,354,194,https://diviexchange.z6.web.core.windows.net/laendertabelle1.svg
1593050400,32561,21100,11461,354,194,https://diviexchange.z6.web.core.windows.net/laendertabelle1.svg
1593054000,32558,21101,11457,354,194,https://diviexchange.z6.web.core.windows.net/laendertabelle1.svg
1593057600,32558,21106,11452,352,192,https://diviexchange.z6.web.core.windows.net/laendertabelle1.svg
1593061200,32557,21083,11474,352,193,https://diviexchange.z6.web.core.windows.net/laendertabelle1.svg
1593064800,32588,21054,11534,351,196,https://diviexchange.z6.web.core.windows.net/laendertabelle1.svg
1593068400,32569,21113,11456,357,197,https://diviexchange.z6.web.core.windows.net/laendertabelle1.svg
1593072000,32544,21076,11468,358,198,https://diviexchange.z6.web.core.windows.net/laendertabelle1.svg
1593075600,32510,21076,11434,361,197,https://diviexchange.z6.web.core.windows.net/laendertabelle1.svg
1593079200,32504,21077,11427,360,196,https://diviexchange.z6.web.core.windows.net/laendertabelle1.svg
1593082800,32503,21064,11439,357,196,https://diviexchange.z6.web.core.windows.net/laendertabelle1.svg
1593086400,32510,21075,11435,357,196,https://diviexchange.z6.web.core.windows.net/laendertabelle1.svg
1593090000,32515,21082,11433,357,196,https://diviexchange.z6.web.core.windows.net/laendertabelle1.svg
1593093600,32518,21091,11427,356,195,https://diviexchange.z6.web.core.windows.net/laendertabelle1.svg
1593133200,32426,21048,11378,355,194,https://diviexchange.z6.web.core.windows.net/laendertabelle1.svg
1593136800,32426,21052,11374,355,194,https://diviexchange.z6.web.core.windows.net/laendertabelle1.svg
1593140400,32426,21060,11366,356,194,https://diviexchange.z6.web.core.windows.net/laendertabelle1.svg
1593144000,32429,21054,11375,356,194,https://diviexchange.z6.web.core.windows.net/laendertabelle1.svg
1593147600,32385,21043,11342,364,196,https://diviexchange.z6.web.core.windows.net/laendertabelle1.svg
1593151200,32446,21071,11375,366,197,https://diviexchange.z6.web.core.windows.net/laendertabelle1.svg
1593154800,32465,21154,11311,362,198,https://diviexchange.z6.web.core.windows.net/laendertabelle1.svg
1593158400,32457,21227,11230,365,200,https://diviexchange.z6.web.core.windows.net/laendertabelle1.svg
1593162000,32468,21237,11231,364,197,https://diviexchange.z6.web.core.windows.net/laendertabelle1.svg
1593165600,32429,21223,11206,364,198,https://diviexchange.z6.web.core.windows.net/laendertabelle1.svg
1593169200,32441,21222,11219,364,198,https://diviexchange.z6.web.core.windows.net/laendertabelle1.svg
1593172800,32435,21216,11219,364,198,https://diviexchange.z6.web.core.windows.net/laendertabelle1.svg
1593176400,32435,21218,11217,364,198,https://diviexchange.z6.web.core.windows.net/laendertabelle1.svg
1593180000,32448,21216,11232,364,198,https://diviexchange.z6.web.core.windows.net/laendertabelle1.svg
1593183600,32449,21214,11235,364,198,https://diviexchange.z6.web.core.windows.net/laendertabelle1.svg
1593187200,32459,21219,11240,364,198,https://diviexchange.z6.web.core.windows.net/laendertabelle1.svg
1593190800,32442,21205,11237,364,198,https://diviexchange.z6.web.core.windows.net/laendertabelle1.svg
1593194400,32383,21158,11225,363,197,https://diviexchange.z6.web.core.windows.net/laendertabelle1.svg
1593198000,32354,21137,11217,363,197,https://diviexchange.z6.web.core.windows.net/laendertabelle1.svg
1593201600,32354,21139,11215,363,197,https://diviexchange.z6.web.core.windows.net/laendertabelle1.svg
1593208800,32360,21147,11213,363,197,https://diviexchange.z6.web.core.windows.net/laendertabelle1.svg
1593212400,32346,21133,11213,363,197,https://diviexchange.z6.web.core.windows.net/laendertabelle1.svg
1593216000,32316,21111,11205,362,197,https://diviexchange.z6.web.core.windows.net/laendertabelle1.svg
1593219600,32309,21111,11198,362,197,https://diviexchange.z6.web.core.windows.net/laendertabelle1.svg
1593223200,32307,21106,11201,362,197,https://diviexchange.z6.web.core.windows.net/laendertabelle1.svg
1593226800,32324,21119,11205,362,197,https://diviexchange.z6.web.core.windows.net/laendertabelle1.svg
1593230400,32340,21114,11226,362,197,https://diviexchange.z6.web.core.windows.net/laendertabelle1.svg
1593234000,32336,21118,11218,360,196,https://diviexchange.z6.web.core.windows.net/laendertabelle1.svg
1593237600,32340,21103,11237,352,191,https://diviexchange.z6.web.core.windows.net/laendertabelle1.svg
1593241200,32366,21105,11261,346,193,https://diviexchange.z6.web.core.windows.net/laendertabelle1.svg
1593244800,32374,21063,11311,347,192,https://diviexchange.z6.web.core.windows.net/laendertabelle1.svg
1593248400,32388,21038,11350,345,190,https://diviexchange.z6.web.core.windows.net/laendertabelle1.svg
1593252000,32393,21001,11392,345,188,https://diviexchange.z6.web.core.windows.net/laendertabelle1.svg
1593255600,32405,20998,11407,345,188,https://diviexchange.z6.web.core.windows.net/laendertabelle1.svg
1593259200,32406,20996,11410,344,187,https://diviexchange.z6.web.core.windows.net/laendertabelle1.svg
1593262800,32405,20979,11426,344,187,https://diviexchange.z6.web.core.windows.net/laendertabelle1.svg
1593266400,32429,20998,11431,344,186,https://diviexchange.z6.web.core.windows.net/laendertabelle1.svg
1593270000,32443,21005,11438,346,188,https://diviexchange.z6.web.core.windows.net/laendertabelle1.svg
1593273600,32445,20994,11451,347,189,https://diviexchange.z6.web.core.windows.net/laendertabelle1.svg
1593277200,32434,20990,11444,346,189,https://diviexchange.z6.web.core.windows.net/laendertabelle1.svg
1593280800,32360,20970,11390,346,189,https://diviexchange.z6.web.core.windows.net/laendertabelle1.svg
1593288000,32309,20925,11384,347,189,https://diviexchange.z6.web.core.windows.net/laendertabelle1.svg
1593291600,32305,20922,11383,347,189,https://diviexchange.z6.web.core.windows.net/laendertabelle1.svg
1593298800,32301,20918,11383,346,189,https://diviexchange.z6.web.core.windows.net/laendertabelle1.svg
1593302400,32305,20914,11391,346,189,https://diviexchange.z6.web.core.windows.net/laendertabelle1.svg
1593306000,32305,20908,11397,346,189,https://diviexchange.z6.web.core.windows.net/laendertabelle1.svg
1593309600,32305,20910,11395,346,189,https://diviexchange.z6.web.core.windows.net/laendertabelle1.svg
1593316800,32299,20902,11397,346,189,https://diviexchange.z6.web.core.windows.net/laendertabelle1.svg
1593320400,32291,20887,11404,347,189,https://diviexchange.z6.web.core.windows.net/laendertabelle1.svg
1593324000,32285,20795,11490,342,189,https://diviexchange.z6.web.core.windows.net/laendertabelle1.svg
1593327600,32280,20715,11565,338,190,https://diviexchange.z6.web.core.windows.net/laendertabelle1.svg
1593331200,32280,20646,11634,339,191,https://diviexchange.z6.web.core.windows.net/laendertabelle1.svg
1593334800,32298,20572,11726,334,188,https://diviexchange.z6.web.core.windows.net/laendertabelle1.svg
1593338400,32307,20478,11829,338,189,https://diviexchange.z6.web.core.windows.net/laendertabelle1.svg
1593342000,32313,20468,11845,337,188,https://diviexchange.z6.web.core.windows.net/laendertabelle1.svg
1593345600,32348,20464,11884,337,188,https://diviexchange.z6.web.core.windows.net/laendertabelle1.svg
1593349200,32346,20448,11898,337,188,https://diviexchange.z6.web.core.windows.net/laendertabelle1.svg
1593352800,32346,20444,11902,337,188,https://diviexchange.z6.web.core.windows.net/laendertabelle1.svg
1593356400,32346,20447,11899,337,188,https://diviexchange.z6.web.core.windows.net/laendertabelle1.svg
1593360000,32355,20454,11901,337,188,https://diviexchange.z6.web.core.windows.net/laendertabelle1.svg
1593363600,32348,20456,11892,336,187,https://diviexchange.z6.web.core.windows.net/laendertabelle1.svg
1593367200,32176,20334,11842,334,186,https://diviexchange.z6.web.core.windows.net/laendertabelle1.svg
1593370800,31788,20097,11691,322,177,https://diviexchange.z6.web.core.windows.net/laendertabelle1.svg
1593374400,31795,20111,11684,323,177,https://diviexchange.z6.web.core.windows.net/laendertabelle1.svg
1593378000,31827,20151,11676,328,181,https://diviexchange.z6.web.core.windows.net/laendertabelle1.svg
1593381600,31742,20087,11655,328,181,https://diviexchange.z6.web.core.windows.net/laendertabelle1.svg
1593385200,31732,20078,11654,328,181,https://diviexchange.z6.web.core.windows.net/laendertabelle1.svg
1593388800,31710,20070,11640,328,181,https://diviexchange.z6.web.core.windows.net/laendertabelle1.svg
1593392400,31710,20069,11641,328,181,https://diviexchange.z6.web.core.windows.net/laendertabelle1.svg
1593396000,31710,20070,11640,328,181,https://diviexchange.z6.web.core.windows.net/laendertabelle1.svg
1593399600,31701,20064,11637,327,181,https://diviexchange.z6.web.core.windows.net/laendertabelle1.svg
1593403200,31706,20063,11643,327,181,https://diviexchange.z6.web.core.windows.net/laendertabelle1.svg
1593406800,31714,20063,11651,326,181,https://diviexchange.z6.web.core.windows.net/laendertabelle1.svg
1593410400,31870,20130,11740,321,177,https://diviexchange.z6.web.core.windows.net/laendertabelle1.svg
1593414000,32117,20228,11889,322,177,https://diviexchange.z6.web.core.windows.net/laendertabelle1.svg
1593417600,32314,20304,12010,328,183,https://diviexchange.z6.web.core.windows.net/laendertabelle1.svg
1593421200,32365,20360,12005,330,182,https://diviexchange.z6.web.core.windows.net/laendertabelle1.svg
1593424800,32349,20351,11998,332,183,https://diviexchange.z6.web.core.windows.net/laendertabelle1.svg
1593428400,32391,20398,11993,331,182,https://diviexchange.z6.web.core.windows.net/laendertabelle1.svg
1593432000,32398,20406,11992,332,182,https://diviexchange.z6.web.core.windows.net/laendertabelle1.svg
1593435600,32402,20406,11996,332,182,https://diviexchange.z6.web.core.windows.net/laendertabelle1.svg
1593439200,32400,20405,11995,331,182,https://diviexchange.z6.web.core.windows.net/laendertabelle1.svg
1593442800,32412,20407,12005,331,182,https://diviexchange.z6.web.core.windows.net/laendertabelle1.svg
1593450000,32411,20404,12007,331,182,https://diviexchange.z6.web.core.windows.net/laendertabelle1.svg
1593457200,32408,20402,12006,331,182,https://diviexchange.z6.web.core.windows.net/laendertabelle1.svg
1593460800,32405,20402,12003,331,182,https://diviexchange.z6.web.core.windows.net/laendertabelle1.svg
1593464400,32376,20381,11995,331,182,https://diviexchange.z6.web.core.windows.net/laendertabelle1.svg
1593471600,32375,20378,11997,331,182,https://diviexchange.z6.web.core.windows.net/laendertabelle1.svg
1593475200,32374,20382,11992,331,182,https://diviexchange.z6.web.core.windows.net/laendertabelle1.svg
1593478800,32375,20385,11990,331,182,https://diviexchange.z6.web.core.windows.net/laendertabelle1.svg
1593482400,32377,20387,11990,331,182,https://diviexchange.z6.web.core.windows.net/laendertabelle1.svg
1593486000,32376,20388,11988,331,182,https://diviexchange.z6.web.core.windows.net/laendertabelle1.svg
1593489600,32375,20394,11981,330,182,https://diviexchange.z6.web.core.windows.net/laendertabelle1.svg
1593493200,32388,20509,11879,330,182,https://diviexchange.z6.web.core.windows.net/laendertabelle1.svg
1593496800,32432,20677,11755,328,181,https://diviexchange.z6.web.core.windows.net/laendertabelle1.svg
1593500400,32437,20864,11573,337,174,https://diviexchange.z6.web.core.windows.net/laendertabelle1.svg
1593504000,32472,20960,11512,338,175,https://diviexchange.z6.web.core.windows.net/laendertabelle1.svg
1593507600,32465,20985,11480,339,174,https://diviexchange.z6.web.core.windows.net/laendertabelle1.svg
1593511200,32504,20997,11507,337,174,https://diviexchange.z6.web.core.windows.net/laendertabelle1.svg
1593514800,32517,21003,11514,336,174,https://diviexchange.z6.web.core.windows.net/laendertabelle1.svg
1593518400,32522,21002,11520,335,174,https://diviexchange.z6.web.core.windows.net/laendertabelle1.svg
1593522000,32525,21006,11519,335,174,https://diviexchange.z6.web.core.windows.net/laendertabelle1.svg
1593525600,32525,21009,11516,335,174,https://diviexchange.z6.web.core.windows.net/laendertabelle1.svg
1593529200,32526,21009,11517,335,174,https://diviexchange.z6.web.core.windows.net/laendertabelle1.svg
1593532800,32528,21009,11519,335,174,https://diviexchange.z6.web.core.windows.net/laendertabelle1.svg
1593536400,32528,21012,11516,335,174,https://diviexchange.z6.web.core.windows.net/laendertabelle1.svg
1593543600,32526,21010,11516,335,174,https://diviexchange.z6.web.core.windows.net/laendertabelle1.svg
1593547200,32515,21004,11511,335,174,https://diviexchange.z6.web.core.windows.net/laendertabelle1.svg
1593558000,32505,20996,11509,335,174,https://diviexchange.z6.web.core.windows.net/laendertabelle1.svg
1593561600,32505,20995,11510,335,174,https://diviexchange.z6.web.core.windows.net/laendertabelle1.svg
1593565200,32504,20993,11511,336,174,https://diviexchange.z6.web.core.windows.net/laendertabelle1.svg
1593568800,32504,20991,11513,336,174,https://diviexchange.z6.web.core.windows.net/laendertabelle1.svg
1593572400,32504,20985,11519,336,174,https://diviexchange.z6.web.core.windows.net/laendertabelle1.svg
1593576000,32507,20980,11527,336,174,https://diviexchange.z6.web.core.windows.net/laendertabelle1.svg
1593579600,32532,21000,11532,333,172,https://diviexchange.z6.web.core.windows.net/laendertabelle1.svg
1593583200,32571,21201,11370,334,172,https://diviexchange.z6.web.core.windows.net/laendertabelle1.svg
1593586800,32578,21308,11270,332,170,https://diviexchange.z6.web.core.windows.net/laendertabelle1.svg
1593590400,32633,21375,11258,328,168,https://diviexchange.z6.web.core.windows.net/laendertabelle1.svg
1593594000,32633,21390,11243,327,168,https://diviexchange.z6.web.core.windows.net/laendertabelle1.svg
1593597600,32614,21408,11206,328,169,https://diviexchange.z6.web.core.windows.net/laendertabelle1.svg
1593601200,32616,21405,11211,329,170,https://diviexchange.z6.web.core.windows.net/laendertabelle1.svg
1593604800,32614,21407,11207,331,171,https://diviexchange.z6.web.core.windows.net/laendertabelle1.svg
1593608400,32614,21405,11209,331,171,https://diviexchange.z6.web.core.windows.net/laendertabelle1.svg
1593612000,32617,21404,11213,331,171,https://diviexchange.z6.web.core.windows.net/laendertabelle1.svg
1593615600,32637,21403,11234,331,171,https://diviexchange.z6.web.core.windows.net/laendertabelle1.svg
1593619200,32659,21421,11238,331,171,https://diviexchange.z6.web.core.windows.net/laendertabelle1.svg
1593622800,32643,21411,11232,331,171,https://diviexchange.z6.web.core.windows.net/laendertabelle1.svg
1593626400,32636,21411,11225,331,171,https://diviexchange.z6.web.core.windows.net/laendertabelle1.svg
1593630000,32596,21378,11218,331,171,https://diviexchange.z6.web.core.windows.net/laendertabelle1.svg
1593644400,32593,21380,11213,331,171,https://diviexchange.z6.web.core.windows.net/laendertabelle1.svg
1593648000,32594,21381,11213,330,171,https://diviexchange.z6.web.core.windows.net/laendertabelle1.svg
1593651600,32594,21380,11214,330,171,https://diviexchange.z6.web.core.windows.net/laendertabelle1.svg
1593655200,32594,21382,11212,330,171,https://diviexchange.z6.web.core.windows.net/laendertabelle1.svg
1593658800,32592,21380,11212,330,171,https://diviexchange.z6.web.core.windows.net/laendertabelle1.svg
1593662400,32590,21398,11192,332,172,https://diviexchange.z6.web.core.windows.net/laendertabelle1.svg
1593666000,32607,21400,11207,334,174,https://diviexchange.z6.web.core.windows.net/laendertabelle1.svg
1593669600,32601,21379,11222,329,172,https://diviexchange.z6.web.core.windows.net/laendertabelle1.svg
1593673200,32655,21476,11179,331,168,https://diviexchange.z6.web.core.windows.net/laendertabelle1.svg
1593676800,32636,21507,11129,333,166,https://diviexchange.z6.web.core.windows.net/laendertabelle1.svg
1593680400,32631,21570,11061,330,163,https://diviexchange.z6.web.core.windows.net/laendertabelle1.svg
1593684000,32643,21526,11117,327,160,https://diviexchange.z6.web.core.windows.net/laendertabelle1.svg
1593687600,32644,21527,11117,327,160,https://diviexchange.z6.web.core.windows.net/laendertabelle1.svg
1593691200,32644,21522,11122,327,160,https://diviexchange.z6.web.core.windows.net/laendertabelle1.svg
1593694800,32644,21525,11119,327,160,https://diviexchange.z6.web.core.windows.net/laendertabelle1.svg
1593698400,32644,21521,11123,327,160,https://diviexchange.z6.web.core.windows.net/laendertabelle1.svg
1593705600,32642,21521,11121,327,160,https://diviexchange.z6.web.core.windows.net/laendertabelle1.svg
1593709200,32609,21510,11099,326,160,https://diviexchange.z6.web.core.windows.net/laendertabelle1.svg
1593712800,32587,21494,11093,326,160,https://diviexchange.z6.web.core.windows.net/laendertabelle1.svg
1593716400,32552,21475,11077,324,160,https://diviexchange.z6.web.core.windows.net/laendertabelle1.svg
1593720000,32549,21474,11075,324,160,https://diviexchange.z6.web.core.windows.net/laendertabelle1.svg
1593723600,32501,21441,11060,324,160,https://diviexchange.z6.web.core.windows.net/laendertabelle1.svg
1593727200,32502,21443,11059,324,160,https://diviexchange.z6.web.core.windows.net/laendertabelle1.svg
1593730800,32494,21434,11060,324,160,https://diviexchange.z6.web.core.windows.net/laendertabelle1.svg
1593734400,32494,21436,11058,324,160,https://diviexchange.z6.web.core.windows.net/laendertabelle1.svg
1593738000,32495,21438,11057,326,160,https://diviexchange.z6.web.core.windows.net/laendertabelle1.svg
1593741600,32495,21436,11059,326,160,https://diviexchange.z6.web.core.windows.net/laendertabelle1.svg
1593748800,32478,21419,11059,324,160,https://diviexchange.z6.web.core.windows.net/laendertabelle1.svg
1593752400,32487,21385,11102,324,160,https://diviexchange.z6.web.core.windows.net/laendertabelle1.svg
1593756000,32473,21357,11116,321,160,https://diviexchange.z6.web.core.windows.net/laendertabelle1.svg
1593759600,32288,21308,10980,323,169,https://diviexchange.z6.web.core.windows.net/laendertabelle1.svg
1593763200,32322,21283,11039,314,159,https://diviexchange.z6.web.core.windows.net/laendertabelle1.svg
1593766800,32356,21338,11018,317,160,https://diviexchange.z6.web.core.windows.net/laendertabelle1.svg
1593770400,32361,21319,11042,318,161,https://diviexchange.z6.web.core.windows.net/laendertabelle1.svg
1593774000,32361,21309,11052,318,161,https://diviexchange.z6.web.core.windows.net/laendertabelle1.svg
1593777600,32358,21310,11048,321,161,https://diviexchange.z6.web.core.windows.net/laendertabelle1.svg
1593781200,32353,21308,11045,321,161,https://diviexchange.z6.web.core.windows.net/laendertabelle1.svg
1593784800,32354,21313,11041,321,161,https://diviexchange.z6.web.core.windows.net/laendertabelle1.svg
1593788400,32353,21314,11039,321,161,https://diviexchange.z6.web.core.windows.net/laendertabelle1.svg
1593795600,32333,21307,11026,322,161,https://diviexchange.z6.web.core.windows.net/laendertabelle1.svg
1593799200,32319,21296,11023,322,161,https://diviexchange.z6.web.core.windows.net/laendertabelle1.svg
1593806400,32320,21297,11023,322,161,https://diviexchange.z6.web.core.windows.net/laendertabelle1.svg
1593810000,32260,21269,10991,322,161,https://diviexchange.z6.web.core.windows.net/laendertabelle1.svg
1593813600,32255,21269,10986,322,161,https://diviexchange.z6.web.core.windows.net/laendertabelle1.svg
1593817200,32238,21252,10986,322,161,https://diviexchange.z6.web.core.windows.net/laendertabelle1.svg
1593820800,32238,21257,10981,322,161,https://diviexchange.z6.web.core.windows.net/laendertabelle1.svg
1593824400,32240,21255,10985,323,161,https://diviexchange.z6.web.core.windows.net/laendertabelle1.svg
1593835200,32217,21243,10974,323,161,https://diviexchange.z6.web.core.windows.net/laendertabelle1.svg
1593838800,32207,21216,10991,324,162,https://diviexchange.z6.web.core.windows.net/laendertabelle1.svg
1593842400,32372,21210,11162,320,161,https://diviexchange.z6.web.core.windows.net/laendertabelle1.svg
1593846000,32371,21058,11313,320,162,https://diviexchange.z6.web.core.windows.net/laendertabelle1.svg
1593849600,32380,20990,11390,320,163,https://diviexchange.z6.web.core.windows.net/laendertabelle1.svg
1593853200,32389,20931,11458,323,160,https://diviexchange.z6.web.core.windows.net/laendertabelle1.svg
1593856800,32401,20919,11482,322,159,https://diviexchange.z6.web.core.windows.net/laendertabelle1.svg
1593860400,32415,20906,11509,322,160,https://diviexchange.z6.web.core.windows.net/laendertabelle1.svg
1593864000,32411,20904,11507,322,161,https://diviexchange.z6.web.core.windows.net/laendertabelle1.svg
1593867600,32411,20890,11521,320,160,https://diviexchange.z6.web.core.windows.net/laendertabelle1.svg
1593871200,32415,20888,11527,320,160,https://diviexchange.z6.web.core.windows.net/laendertabelle1.svg
1593874800,32415,20882,11533,320,160,https://diviexchange.z6.web.core.windows.net/laendertabelle1.svg
1593878400,32413,20881,11532,320,160,https://diviexchange.z6.web.core.windows.net/laendertabelle1.svg
1593882000,32399,20872,11527,320,160,https://diviexchange.z6.web.core.windows.net/laendertabelle1.svg
1593885600,32383,20861,11522,320,160,https://diviexchange.z6.web.core.windows.net/laendertabelle1.svg
1593889200,32373,20856,11517,320,160,https://diviexchange.z6.web.core.windows.net/laendertabelle1.svg
1593892800,32372,20854,11518,320,160,https://diviexchange.z6.web.core.windows.net/laendertabelle1.svg
1593896400,32337,20826,11511,320,160,https://diviexchange.z6.web.core.windows.net/laendertabelle1.svg
1593900000,32311,20819,11492,317,159,https://diviexchange.z6.web.core.windows.net/laendertabelle1.svg
1593903600,32304,20817,11487,317,159,https://diviexchange.z6.web.core.windows.net/laendertabelle1.svg
1593910800,32322,20829,11493,317,159,https://diviexchange.z6.web.core.windows.net/laendertabelle1.svg
1593914400,32321,20833,11488,317,159,https://diviexchange.z6.web.core.windows.net/laendertabelle1.svg
1593918000,32321,20831,11490,317,159,https://diviexchange.z6.web.core.windows.net/laendertabelle1.svg
1593921600,32325,20834,11491,317,159,https://diviexchange.z6.web.core.windows.net/laendertabelle1.svg
1593925200,32318,20806,11512,316,159,https://diviexchange.z6.web.core.windows.net/laendertabelle1.svg
1593928800,32319,20746,11573,314,158,https://diviexchange.z6.web.core.windows.net/laendertabelle1.svg
1593932400,32278,20549,11729,306,156,https://diviexchange.z6.web.core.windows.net/laendertabelle1.svg
1593936000,32326,20454,11872,300,149,https://diviexchange.z6.web.core.windows.net/laendertabelle1.svg
1593939600,32323,20377,11946,297,149,https://diviexchange.z6.web.core.windows.net/laendertabelle1.svg
1593943200,32322,20317,12005,298,149,https://diviexchange.z6.web.core.windows.net/laendertabelle1.svg
1593946800,32318,20330,11988,299,149,https://diviexchange.z6.web.core.windows.net/laendertabelle1.svg
1593950400,32317,20330,11987,299,149,https://diviexchange.z6.web.core.windows.net/laendertabelle1.svg
1593954000,32312,20318,11994,299,149,https://diviexchange.z6.web.core.windows.net/laendertabelle1.svg
1593957600,32316,20320,11996,299,149,https://diviexchange.z6.web.core.windows.net/laendertabelle1.svg
1593961200,32326,20317,12009,299,149,https://diviexchange.z6.web.core.windows.net/laendertabelle1.svg
1593964800,32305,20292,12013,299,149,https://diviexchange.z6.web.core.windows.net/laendertabelle1.svg
1593968400,32149,20180,11969,295,148,https://diviexchange.z6.web.core.windows.net/laendertabelle1.svg
1593972000,31892,20014,11878,292,146,https://diviexchange.z6.web.core.windows.net/laendertabelle1.svg
1593975600,31827,19975,11852,292,146,https://diviexchange.z6.web.core.windows.net/laendertabelle1.svg
1593979200,31728,19880,11848,291,146,https://diviexchange.z6.web.core.windows.net/laendertabelle1.svg
1593982800,31572,19771,11801,291,146,https://diviexchange.z6.web.core.windows.net/laendertabelle1.svg
1593986400,31541,19747,11794,290,146,https://diviexchange.z6.web.core.windows.net/laendertabelle1.svg
1593990000,31539,19748,11791,290,146,https://diviexchange.z6.web.core.windows.net/laendertabelle1.svg
1593993600,31535,19751,11784,290,146,https://diviexchange.z6.web.core.windows.net/laendertabelle1.svg
1593997200,31531,19749,11782,290,146,https://diviexchange.z6.web.core.windows.net/laendertabelle1.svg
1594000800,31519,19734,11785,290,146,https://diviexchange.z6.web.core.windows.net/laendertabelle1.svg
1594004400,31458,19695,11763,290,146,https://diviexchange.z6.web.core.windows.net/laendertabelle1.svg
1594008000,31472,19696,11776,291,146,https://diviexchange.z6.web.core.windows.net/laendertabelle1.svg
1594011600,31558,19772,11786,291,145,https://diviexchange.z6.web.core.windows.net/laendertabelle1.svg
1594015200,31787,19839,11948,307,145,https://diviexchange.z6.web.core.windows.net/laendertabelle1.svg
1594018800,31979,19990,11989,309,145,https://diviexchange.z6.web.core.windows.net/laendertabelle1.svg
1594022400,32110,20125,11985,309,145,https://diviexchange.z6.web.core.windows.net/laendertabelle1.svg
1594026000,32241,20231,12010,307,144,https://diviexchange.z6.web.core.windows.net/laendertabelle1.svg
1594029600,32263,20238,12025,305,145,https://diviexchange.z6.web.core.windows.net/laendertabelle1.svg
1594033200,32306,20268,12038,305,145,https://diviexchange.z6.web.core.windows.net/laendertabelle1.svg
1594036800,32347,20297,12050,305,145,https://diviexchange.z6.web.core.windows.net/laendertabelle1.svg
1594040400,32354,20297,12057,304,145,https://diviexchange.z6.web.core.windows.net/laendertabelle1.svg
1594044000,32373,20314,12059,304,145,https://diviexchange.z6.web.core.windows.net/laendertabelle1.svg
1594047600,32378,20323,12055,305,146,https://diviexchange.z6.web.core.windows.net/laendertabelle1.svg
1594051200,32379,20323,12056,305,146,https://diviexchange.z6.web.core.windows.net/laendertabelle1.svg
1594054800,32403,20344,12059,306,146,https://diviexchange.z6.web.core.windows.net/laendertabelle1.svg
1594062000,32402,20345,12057,306,146,https://diviexchange.z6.web.core.windows.net/laendertabelle1.svg
1594065600,32372,20326,12046,306,146,https://diviexchange.z6.web.core.windows.net/laendertabelle1.svg
1594069200,32355,20309,12046,306,146,https://diviexchange.z6.web.core.windows.net/laendertabelle1.svg
1594072800,32356,20313,12043,307,146,https://diviexchange.z6.web.core.windows.net/laendertabelle1.svg
1594076400,32363,20312,12051,307,146,https://diviexchange.z6.web.core.windows.net/laendertabelle1.svg
1594080000,32365,20312,12053,307,146,https://diviexchange.z6.web.core.windows.net/laendertabelle1.svg
1594083600,32368,20308,12060,307,146,https://diviexchange.z6.web.core.windows.net/laendertabelle1.svg
1594090800,32368,20309,12059,307,146,https://diviexchange.z6.web.core.windows.net/laendertabelle1.svg
1594094400,32383,20326,12057,306,146,https://diviexchange.z6.web.core.windows.net/laendertabelle1.svg
1594098000,32398,20370,12028,307,147,https://diviexchange.z6.web.core.windows.net/laendertabelle1.svg
1594101600,32450,20567,11883,303,147,https://diviexchange.z6.web.core.windows.net/laendertabelle1.svg
1594105200,32468,20784,11684,297,144,https://diviexchange.z6.web.core.windows.net/laendertabelle1.svg
1594108800,32522,20897,11625,296,143,https://diviexchange.z6.web.core.windows.net/laendertabelle1.svg
1594112400,32552,20955,11597,297,144,https://diviexchange.z6.web.core.windows.net/laendertabelle1.svg
1594116000,32573,20971,11602,298,144,https://diviexchange.z6.web.core.windows.net/laendertabelle1.svg
1594119600,32577,20970,11607,299,144,https://diviexchange.z6.web.core.windows.net/laendertabelle1.svg
1594123200,32582,20983,11599,298,144,https://diviexchange.z6.web.core.windows.net/laendertabelle1.svg
1594126800,32583,20983,11600,299,145,https://diviexchange.z6.web.core.windows.net/laendertabelle1.svg
1594130400,32582,20980,11602,299,145,https://diviexchange.z6.web.core.windows.net/laendertabelle1.svg
1594134000,32586,20984,11602,299,145,https://diviexchange.z6.web.core.windows.net/laendertabelle1.svg
1594137600,32595,20997,11598,298,144,https://diviexchange.z6.web.core.windows.net/laendertabelle1.svg
1594141200,32596,20995,11601,298,144,https://diviexchange.z6.web.core.windows.net/laendertabelle1.svg
1594144800,32566,20967,11599,299,145,https://diviexchange.z6.web.core.windows.net/laendertabelle1.svg
1594148400,32554,20961,11593,299,145,https://diviexchange.z6.web.core.windows.net/laendertabelle1.svg
1594152000,32408,20871,11537,299,145,https://diviexchange.z6.web.core.windows.net/laendertabelle1.svg
1594155600,32388,20867,11521,299,145,https://diviexchange.z6.web.core.windows.net/laendertabelle1.svg
1594159200,32382,20863,11519,299,145,https://diviexchange.z6.web.core.windows.net/laendertabelle1.svg
1594162800,32379,20869,11510,299,145,https://diviexchange.z6.web.core.windows.net/laendertabelle1.svg
1594166400,32382,20867,11515,299,145,https://diviexchange.z6.web.core.windows.net/laendertabelle1.svg
1594170000,32385,20866,11519,299,145,https://diviexchange.z6.web.core.windows.net/laendertabelle1.svg
1594173600,32391,20869,11522,299,145,https://diviexchange.z6.web.core.windows.net/laendertabelle1.svg
1594177200,32378,20864,11514,299,145,https://diviexchange.z6.web.core.windows.net/laendertabelle1.svg
1594180800,32377,20874,11503,299,145,https://diviexchange.z6.web.core.windows.net/laendertabelle1.svg
1594184400,32381,20894,11487,297,144,https://diviexchange.z6.web.core.windows.net/laendertabelle1.svg
1594188000,32380,20966,11414,299,142,https://diviexchange.z6.web.core.windows.net/laendertabelle1.svg
1594191600,32392,20997,11395,298,140,https://diviexchange.z6.web.core.windows.net/laendertabelle1.svg
1594195200,32378,21034,11344,295,140,https://diviexchange.z6.web.core.windows.net/laendertabelle1.svg
1594198800,32400,21077,11323,293,141,https://diviexchange.z6.web.core.windows.net/laendertabelle1.svg
1594202400,32380,21081,11299,292,141,https://diviexchange.z6.web.core.windows.net/laendertabelle1.svg
1594206000,32381,21076,11305,291,141,https://diviexchange.z6.web.core.windows.net/laendertabelle1.svg
1594209600,32399,21078,11321,292,141,https://diviexchange.z6.web.core.windows.net/laendertabelle1.svg
1594213200,32400,21089,11311,291,141,https://diviexchange.z6.web.core.windows.net/laendertabelle1.svg
1594216800,32400,21085,11315,291,141,https://diviexchange.z6.web.core.windows.net/laendertabelle1.svg
1594220400,32415,21098,11317,292,141,https://diviexchange.z6.web.core.windows.net/laendertabelle1.svg
1594224000,32415,21099,11316,292,141,https://diviexchange.z6.web.core.windows.net/laendertabelle1.svg
1594227600,32378,21065,11313,290,139,https://diviexchange.z6.web.core.windows.net/laendertabelle1.svg
1594231200,32303,21001,11302,290,139,https://diviexchange.z6.web.core.windows.net/laendertabelle1.svg
1594234800,32261,20971,11290,290,139,https://diviexchange.z6.web.core.windows.net/laendertabelle1.svg
1594238400,32238,20961,11277,290,139,https://diviexchange.z6.web.core.windows.net/laendertabelle1.svg
1594242000,32234,20966,11268,290,139,https://diviexchange.z6.web.core.windows.net/laendertabelle1.svg
1594245600,32234,20967,11267,290,139,https://diviexchange.z6.web.core.windows.net/laendertabelle1.svg
1594249200,32234,20964,11270,290,139,https://diviexchange.z6.web.core.windows.net/laendertabelle1.svg
1594252800,32232,20967,11265,290,139,https://diviexchange.z6.web.core.windows.net/laendertabelle1.svg
1594256400,32232,20965,11267,290,139,https://diviexchange.z6.web.core.windows.net/laendertabelle1.svg
1594260000,32232,20964,11268,290,139,https://diviexchange.z6.web.core.windows.net/laendertabelle1.svg
1594263600,32234,20970,11264,290,139,https://diviexchange.z6.web.core.windows.net/laendertabelle1.svg
1594267200,32239,20978,11261,290,139,https://diviexchange.z6.web.core.windows.net/laendertabelle1.svg
1594270800,32242,21006,11236,290,138,https://diviexchange.z6.web.core.windows.net/laendertabelle1.svg
1594274400,32246,21036,11210,280,136,https://diviexchange.z6.web.core.windows.net/laendertabelle1.svg
1594278000,32254,21085,11169,279,137,https://diviexchange.z6.web.core.windows.net/laendertabelle1.svg
1594281600,32278,21121,11157,277,135,https://diviexchange.z6.web.core.windows.net/laendertabelle1.svg
1594285200,32275,21118,11157,277,134,https://diviexchange.z6.web.core.windows.net/laendertabelle1.svg
1594288800,32276,21089,11187,275,133,https://diviexchange.z6.web.core.windows.net/laendertabelle1.svg
1594292400,32287,21092,11195,275,133,https://diviexchange.z6.web.core.windows.net/laendertabelle1.svg
1594296000,32286,21090,11196,275,133,https://diviexchange.z6.web.core.windows.net/laendertabelle1.svg
1594299600,32286,21092,11194,275,133,https://diviexchange.z6.web.core.windows.net/laendertabelle1.svg
1594303200,32281,21072,11209,276,133,https://diviexchange.z6.web.core.windows.net/laendertabelle1.svg
1594314000,32272,21066,11206,276,133,https://diviexchange.z6.web.core.windows.net/laendertabelle1.svg
1594317600,32246,21045,11201,276,133,https://diviexchange.z6.web.core.windows.net/laendertabelle1.svg
1594321200,32227,21040,11187,276,133,https://diviexchange.z6.web.core.windows.net/laendertabelle1.svg
1594324800,32214,21028,11186,276,133,https://diviexchange.z6.web.core.windows.net/laendertabelle1.svg
1594328400,32202,21021,11181,276,133,https://diviexchange.z6.web.core.windows.net/laendertabelle1.svg
1594332000,32202,21026,11176,276,133,https://diviexchange.z6.web.core.windows.net/laendertabelle1.svg
1594335600,32201,21020,11181,276,133,https://diviexchange.z6.web.core.windows.net/laendertabelle1.svg
1594339200,32200,21025,11175,276,133,https://diviexchange.z6.web.core.windows.net/laendertabelle1.svg
1594342800,32200,21026,11174,276,133,https://diviexchange.z6.web.core.windows.net/laendertabelle1.svg
1594346400,32199,21022,11177,276,133,https://diviexchange.z6.web.core.windows.net/laendertabelle1.svg
1594353600,32194,21006,11188,277,135,https://diviexchange.z6.web.core.windows.net/laendertabelle1.svg
1594357200,32193,21044,11149,277,135,https://diviexchange.z6.web.core.windows.net/laendertabelle1.svg
1594360800,32192,21097,11095,273,134,https://diviexchange.z6.web.core.windows.net/laendertabelle1.svg
1594368000,32247,21137,11110,277,132,https://diviexchange.z6.web.core.windows.net/laendertabelle1.svg
1594371600,32296,21204,11092,278,134,https://diviexchange.z6.web.core.windows.net/laendertabelle1.svg
1594375200,32292,21201,11091,278,132,https://diviexchange.z6.web.core.windows.net/laendertabelle1.svg
1594378800,32422,21305,11117,275,130,https://diviexchange.z6.web.core.windows.net/laendertabelle1.svg
1594382400,32436,21311,11125,275,130,https://diviexchange.z6.web.core.windows.net/laendertabelle1.svg
1594386000,32435,21299,11136,273,130,https://diviexchange.z6.web.core.windows.net/laendertabelle1.svg
1594389600,32435,21289,11146,273,130,https://diviexchange.z6.web.core.windows.net/laendertabelle1.svg
1594393200,32435,21291,11144,272,129,https://diviexchange.z6.web.core.windows.net/laendertabelle1.svg
1594396800,32436,21290,11146,272,129,https://diviexchange.z6.web.core.windows.net/laendertabelle1.svg
1594400400,32424,21281,11143,273,130,https://diviexchange.z6.web.core.windows.net/laendertabelle1.svg
1594407600,32341,21241,11100,273,130,https://diviexchange.z6.web.core.windows.net/laendertabelle1.svg
1594411200,32376,21266,11110,273,130,https://diviexchange.z6.web.core.windows.net/laendertabelle1.svg
1594414800,32368,21260,11108,273,130,https://diviexchange.z6.web.core.windows.net/laendertabelle1.svg
1594418400,32363,21257,11106,273,130,https://diviexchange.z6.web.core.windows.net/laendertabelle1.svg
1594422000,32333,21235,11098,273,130,https://diviexchange.z6.web.core.windows.net/laendertabelle1.svg
1594425600,32324,21236,11088,273,130,https://diviexchange.z6.web.core.windows.net/laendertabelle1.svg
1594432800,32324,21233,11091,273,130,https://diviexchange.z6.web.core.windows.net/laendertabelle1.svg
1594436400,32309,21230,11079,273,130,https://diviexchange.z6.web.core.windows.net/laendertabelle1.svg
1594440000,32310,21223,11087,272,129,https://diviexchange.z6.web.core.windows.net/laendertabelle1.svg
1594443600,32294,21205,11089,271,128,https://diviexchange.z6.web.core.windows.net/laendertabelle1.svg
1594447200,32310,21209,11101,267,127,https://diviexchange.z6.web.core.windows.net/laendertabelle1.svg
1594450800,32280,21149,11131,264,127,https://diviexchange.z6.web.core.windows.net/laendertabelle1.svg
1594454400,32349,21110,11239,260,129,https://diviexchange.z6.web.core.windows.net/laendertabelle1.svg
1594458000,32384,21086,11298,255,127,https://diviexchange.z6.web.core.windows.net/laendertabelle1.svg
1594461600,32396,21053,11343,252,127,https://diviexchange.z6.web.core.windows.net/laendertabelle1.svg
1594465200,32393,21048,11345,250,126,https://diviexchange.z6.web.core.windows.net/laendertabelle1.svg
1594468800,32391,21044,11347,250,126,https://diviexchange.z6.web.core.windows.net/laendertabelle1.svg
1594472400,32398,21048,11350,250,126,https://diviexchange.z6.web.core.windows.net/laendertabelle1.svg
1594476000,32409,21051,11358,250,126,https://diviexchange.z6.web.core.windows.net/laendertabelle1.svg
1594479600,32401,21049,11352,250,126,https://diviexchange.z6.web.core.windows.net/laendertabelle1.svg
1594483200,32400,21051,11349,250,126,https://diviexchange.z6.web.core.windows.net/laendertabelle1.svg
1594490400,32307,20968,11339,250,125,https://diviexchange.z6.web.core.windows.net/laendertabelle1.svg
1594494000,32270,20939,11331,250,125,https://diviexchange.z6.web.core.windows.net/laendertabelle1.svg
1594497600,32251,20918,11333,250,125,https://diviexchange.z6.web.core.windows.net/laendertabelle1.svg
1594501200,32244,20912,11332,250,125,https://diviexchange.z6.web.core.windows.net/laendertabelle1.svg
1594504800,32235,20910,11325,250,125,https://diviexchange.z6.web.core.windows.net/laendertabelle1.svg
1594508400,32235,20903,11332,250,125,https://diviexchange.z6.web.core.windows.net/laendertabelle1.svg
1594512000,32173,20850,11323,250,125,https://diviexchange.z6.web.core.windows.net/laendertabelle1.svg
1594515600,32171,20852,11319,250,125,https://diviexchange.z6.web.core.windows.net/laendertabelle1.svg
1594519200,32171,20852,11319,251,125,https://diviexchange.z6.web.core.windows.net/laendertabelle1.svg
1594522800,32171,20851,11320,251,125,https://diviexchange.z6.web.core.windows.net/laendertabelle1.svg
1594526400,32171,20841,11330,251,125,https://diviexchange.z6.web.core.windows.net/laendertabelle1.svg
1594530000,32180,20828,11352,251,125,https://diviexchange.z6.web.core.windows.net/laendertabelle1.svg
1594533600,32128,20671,11457,250,125,https://diviexchange.z6.web.core.windows.net/laendertabelle1.svg
1594537200,32051,20456,11595,249,125,https://diviexchange.z6.web.core.windows.net/laendertabelle1.svg
1594540800,32042,20353,11689,252,126,https://diviexchange.z6.web.core.windows.net/laendertabelle1.svg
1594544400,32061,20325,11736,253,126,https://diviexchange.z6.web.core.windows.net/laendertabelle1.svg
1594548000,32064,20281,11783,253,125,https://diviexchange.z6.web.core.windows.net/laendertabelle1.svg
1594551600,32052,20236,11816,252,124,https://diviexchange.z6.web.core.windows.net/laendertabelle1.svg
1594555200,32048,20237,11811,253,124,https://diviexchange.z6.web.core.windows.net/laendertabelle1.svg
1594558800,32050,20231,11819,253,124,https://diviexchange.z6.web.core.windows.net/laendertabelle1.svg
1594562400,32048,20231,11817,253,124,https://diviexchange.z6.web.core.windows.net/laendertabelle1.svg
1594566000,32046,20228,11818,253,124,https://diviexchange.z6.web.core.windows.net/laendertabelle1.svg
1594569600,32046,20229,11817,253,124,https://diviexchange.z6.web.core.windows.net/laendertabelle1.svg
1594573200,31958,20200,11758,253,124,https://diviexchange.z6.web.core.windows.net/laendertabelle1.svg
1594576800,31552,19913,11639,249,121,https://diviexchange.z6.web.core.windows.net/laendertabelle1.svg
1594580400,31353,19773,11580,249,121,https://diviexchange.z6.web.core.windows.net/laendertabelle1.svg
1594584000,31144,19620,11524,245,117,https://diviexchange.z6.web.core.windows.net/laendertabelle1.svg
1594587600,31032,19553,11479,243,116,https://diviexchange.z6.web.core.windows.net/laendertabelle1.svg
1594591200,30985,19519,11466,243,116,https://diviexchange.z6.web.core.windows.net/laendertabelle1.svg
1594594800,30912,19473,11439,243,116,https://diviexchange.z6.web.core.windows.net/laendertabelle1.svg
1594598400,30903,19472,11431,243,116,https://diviexchange.z6.web.core.windows.net/laendertabelle1.svg
1594605600,30896,19468,11428,243,116,https://diviexchange.z6.web.core.windows.net/laendertabelle1.svg
1594609200,30848,19430,11418,242,116,https://diviexchange.z6.web.core.windows.net/laendertabelle1.svg
1594612800,30845,19421,11424,242,116,https://diviexchange.z6.web.core.windows.net/laendertabelle1.svg
1594616400,30945,19509,11436,243,116,https://diviexchange.z6.web.core.windows.net/laendertabelle1.svg
1594620000,31252,19640,11612,246,122,https://diviexchange.z6.web.core.windows.net/laendertabelle1.svg
1594623600,31565,19800,11765,252,125,https://diviexchange.z6.web.core.windows.net/laendertabelle1.svg
1594627200,31719,19884,11835,260,128,https://diviexchange.z6.web.core.windows.net/laendertabelle1.svg
1594630800,31787,19915,11872,258,128,https://diviexchange.z6.web.core.windows.net/laendertabelle1.svg
1594634400,32135,20162,11973,264,130,https://diviexchange.z6.web.core.windows.net/laendertabelle1.svg
1594638000,32171,20201,11970,264,130,https://diviexchange.z6.web.core.windows.net/laendertabelle1.svg
1594641600,32187,20211,11976,264,130,https://diviexchange.z6.web.core.windows.net/laendertabelle1.svg
1594645200,32200,20217,11983,264,130,https://diviexchange.z6.web.core.windows.net/laendertabelle1.svg
1594648800,32218,20227,11991,263,130,https://diviexchange.z6.web.core.windows.net/laendertabelle1.svg
1594652400,32218,20228,11990,263,130,https://diviexchange.z6.web.core.windows.net/laendertabelle1.svg
1594656000,32225,20230,11995,263,130,https://diviexchange.z6.web.core.windows.net/laendertabelle1.svg
1594659600,32238,20239,11999,263,130,https://diviexchange.z6.web.core.windows.net/laendertabelle1.svg
1594666800,32225,20231,11994,263,130,https://diviexchange.z6.web.core.windows.net/laendertabelle1.svg
1594670400,32214,20224,11990,263,130,https://diviexchange.z6.web.core.windows.net/laendertabelle1.svg
1594674000,32202,20217,11985,263,130,https://diviexchange.z6.web.core.windows.net/laendertabelle1.svg
1594677600,32182,20204,11978,263,130,https://diviexchange.z6.web.core.windows.net/laendertabelle1.svg
1594681200,32180,20204,11976,263,130,https://diviexchange.z6.web.core.windows.net/laendertabelle1.svg
1594684800,32177,20200,11977,263,130,https://diviexchange.z6.web.core.windows.net/laendertabelle1.svg
1594688400,32175,20197,11978,263,130,https://diviexchange.z6.web.core.windows.net/laendertabelle1.svg
1594692000,32175,20198,11977,263,130,https://diviexchange.z6.web.core.windows.net/laendertabelle1.svg
1594695600,32174,20192,11982,263,130,https://diviexchange.z6.web.core.windows.net/laendertabelle1.svg
1594699200,32180,20210,11970,266,132,https://diviexchange.z6.web.core.windows.net/laendertabelle1.svg
1594702800,32208,20361,11847,266,132,https://diviexchange.z6.web.core.windows.net/laendertabelle1.svg
1594706400,32266,20576,11690,264,130,https://diviexchange.z6.web.core.windows.net/laendertabelle1.svg
1594710000,32305,20732,11573,262,129,https://diviexchange.z6.web.core.windows.net/laendertabelle1.svg
1594713600,32361,20924,11437,268,128,https://diviexchange.z6.web.core.windows.net/laendertabelle1.svg
1594717200,32360,20961,11399,266,127,https://diviexchange.z6.web.core.windows.net/laendertabelle1.svg
1594720800,32362,21004,11358,266,125,https://diviexchange.z6.web.core.windows.net/laendertabelle1.svg
1594724400,32359,21005,11354,266,125,https://diviexchange.z6.web.core.windows.net/laendertabelle1.svg
1594728000,32362,21012,11350,266,125,https://diviexchange.z6.web.core.windows.net/laendertabelle1.svg
1594731600,32432,21067,11365,266,125,https://diviexchange.z6.web.core.windows.net/laendertabelle1.svg
1594735200,32447,21083,11364,266,125,https://diviexchange.z6.web.core.windows.net/laendertabelle1.svg
1594738800,32437,21072,11365,266,125,https://diviexchange.z6.web.core.windows.net/laendertabelle1.svg
1594742400,32437,21069,11368,266,125,https://diviexchange.z6.web.core.windows.net/laendertabelle1.svg
1594746000,32444,21065,11379,266,125,https://diviexchange.z6.web.core.windows.net/laendertabelle1.svg
1594749600,32424,21071,11353,266,125,https://diviexchange.z6.web.core.windows.net/laendertabelle1.svg
1594753200,32406,21057,11349,266,125,https://diviexchange.z6.web.core.windows.net/laendertabelle1.svg
1594756800,32400,21050,11350,265,125,https://diviexchange.z6.web.core.windows.net/laendertabelle1.svg
1594760400,32406,21056,11350,265,125,https://diviexchange.z6.web.core.windows.net/laendertabelle1.svg
1594767600,32406,21067,11339,265,125,https://diviexchange.z6.web.core.windows.net/laendertabelle1.svg
1594771200,32387,21057,11330,265,125,https://diviexchange.z6.web.core.windows.net/laendertabelle1.svg
1594785600,32380,21055,11325,265,126,https://diviexchange.z6.web.core.windows.net/laendertabelle1.svg
1594789200,32376,21136,11240,261,127,https://diviexchange.z6.web.core.windows.net/laendertabelle1.svg
1594792800,32374,21243,11131,264,126,https://diviexchange.z6.web.core.windows.net/laendertabelle1.svg
1594796400,32424,21372,11052,253,124,https://diviexchange.z6.web.core.windows.net/laendertabelle1.svg
1594800000,32482,21448,11034,256,122,https://diviexchange.z6.web.core.windows.net/laendertabelle1.svg
1594803600,32495,21503,10992,251,120,https://diviexchange.z6.web.core.windows.net/laendertabelle1.svg
1594807200,32512,21483,11029,248,120,https://diviexchange.z6.web.core.windows.net/laendertabelle1.svg
1594810800,32521,21483,11038,248,120,https://diviexchange.z6.web.core.windows.net/laendertabelle1.svg
1594814400,32519,21476,11043,248,120,https://diviexchange.z6.web.core.windows.net/laendertabelle1.svg
1594818000,32519,21478,11041,248,120,https://diviexchange.z6.web.core.windows.net/laendertabelle1.svg
1594821600,32520,21479,11041,248,120,https://diviexchange.z6.web.core.windows.net/laendertabelle1.svg
1594825200,32538,21486,11052,248,120,https://diviexchange.z6.web.core.windows.net/laendertabelle1.svg
1594828800,32539,21487,11052,248,120,https://diviexchange.z6.web.core.windows.net/laendertabelle1.svg
1594832400,32533,21483,11050,248,120,https://diviexchange.z6.web.core.windows.net/laendertabelle1.svg
1594836000,32532,21482,11050,248,120,https://diviexchange.z6.web.core.windows.net/laendertabelle1.svg
1594843200,32489,21466,11023,248,120,https://diviexchange.z6.web.core.windows.net/laendertabelle1.svg
1594846800,32471,21458,11013,248,120,https://diviexchange.z6.web.core.windows.net/laendertabelle1.svg
1594854000,32490,21470,11020,248,120,https://diviexchange.z6.web.core.windows.net/laendertabelle1.svg
1594857600,32490,21467,11023,248,120,https://diviexchange.z6.web.core.windows.net/laendertabelle1.svg
1594861200,32490,21468,11022,248,120,https://diviexchange.z6.web.core.windows.net/laendertabelle1.svg
1594864800,32504,21467,11037,248,120,https://diviexchange.z6.web.core.windows.net/laendertabelle1.svg
1594872000,32503,21460,11043,248,119,https://diviexchange.z6.web.core.windows.net/laendertabelle1.svg
1594875600,32546,21532,11014,247,117,https://diviexchange.z6.web.core.windows.net/laendertabelle1.svg
1594879200,32518,21527,10991,249,118,https://diviexchange.z6.web.core.windows.net/laendertabelle1.svg
1594882800,32539,21545,10994,254,117,https://diviexchange.z6.web.core.windows.net/laendertabelle1.svg
1594886400,32517,21568,10949,258,121,https://diviexchange.z6.web.core.windows.net/laendertabelle1.svg
1594890000,32526,21565,10961,254,121,https://diviexchange.z6.web.core.windows.net/laendertabelle1.svg
1594893600,32514,21525,10989,255,121,https://diviexchange.z6.web.core.windows.net/laendertabelle1.svg
1594897200,32512,21525,10987,256,121,https://diviexchange.z6.web.core.windows.net/laendertabelle1.svg
1594900800,32525,21531,10994,255,121,https://diviexchange.z6.web.core.windows.net/laendertabelle1.svg
1594904400,32524,21528,10996,255,121,https://diviexchange.z6.web.core.windows.net/laendertabelle1.svg
1594908000,32521,21529,10992,256,121,https://diviexchange.z6.web.core.windows.net/laendertabelle1.svg
1594911600,32536,21546,10990,256,121,https://diviexchange.z6.web.core.windows.net/laendertabelle1.svg
1594918800,32536,21544,10992,256,121,https://diviexchange.z6.web.core.windows.net/laendertabelle1.svg
1594922400,32534,21546,10988,256,121,https://diviexchange.z6.web.core.windows.net/laendertabelle1.svg
1594926000,32432,21473,10959,255,120,https://diviexchange.z6.web.core.windows.net/laendertabelle1.svg
1594929600,32483,21517,10966,256,121,https://diviexchange.z6.web.core.windows.net/laendertabelle1.svg
1594933200,32485,21514,10971,256,121,https://diviexchange.z6.web.core.windows.net/laendertabelle1.svg
1594936800,32478,21509,10969,256,121,https://diviexchange.z6.web.core.windows.net/laendertabelle1.svg
1594940400,32474,21505,10969,256,121,https://diviexchange.z6.web.core.windows.net/laendertabelle1.svg
1594944000,32469,21498,10971,256,121,https://diviexchange.z6.web.core.windows.net/laendertabelle1.svg
1594947600,32469,21501,10968,256,121,https://diviexchange.z6.web.core.windows.net/laendertabelle1.svg
1594954800,32469,21503,10966,256,121,https://diviexchange.z6.web.core.windows.net/laendertabelle1.svg
1594958400,32473,21513,10960,254,120,https://diviexchange.z6.web.core.windows.net/laendertabelle1.svg
1594962000,32470,21541,10929,256,120,https://diviexchange.z6.web.core.windows.net/laendertabelle1.svg
1594965600,32505,21580,10925,257,120,https://diviexchange.z6.web.core.windows.net/laendertabelle1.svg
1594969200,32526,21631,10895,249,116,https://diviexchange.z6.web.core.windows.net/laendertabelle1.svg
1594972800,32580,21619,10961,249,117,https://diviexchange.z6.web.core.windows.net/laendertabelle1.svg
1594976400,32580,21580,11000,251,117,https://diviexchange.z6.web.core.windows.net/laendertabelle1.svg
1594980000,32582,21577,11005,249,118,https://diviexchange.z6.web.core.windows.net/laendertabelle1.svg
1594983600,32579,21568,11011,249,118,https://diviexchange.z6.web.core.windows.net/laendertabelle1.svg
1594987200,32585,21560,11025,249,118,https://diviexchange.z6.web.core.windows.net/laendertabelle1.svg
1594990800,32570,21553,11017,249,118,https://diviexchange.z6.web.core.windows.net/laendertabelle1.svg
1594994400,32567,21550,11017,249,118,https://diviexchange.z6.web.core.windows.net/laendertabelle1.svg
1594998000,32571,21547,11024,249,118,https://diviexchange.z6.web.core.windows.net/laendertabelle1.svg
1595001600,32573,21548,11025,249,118,https://diviexchange.z6.web.core.windows.net/laendertabelle1.svg
1595005200,32573,21547,11026,249,118,https://diviexchange.z6.web.core.windows.net/laendertabelle1.svg
1595008800,32547,21527,11020,249,118,https://diviexchange.z6.web.core.windows.net/laendertabelle1.svg
1595012400,32544,21529,11015,249,118,https://diviexchange.z6.web.core.windows.net/laendertabelle1.svg
1595016000,32544,21525,11019,249,118,https://diviexchange.z6.web.core.windows.net/laendertabelle1.svg
1595019600,32520,21517,11003,249,118,https://diviexchange.z6.web.core.windows.net/laendertabelle1.svg
1595023200,32509,21509,11000,249,118,https://diviexchange.z6.web.core.windows.net/laendertabelle1.svg
1595026800,32499,21502,10997,249,118,https://diviexchange.z6.web.core.windows.net/laendertabelle1.svg
1595030400,32522,21511,11011,249,118,https://diviexchange.z6.web.core.windows.net/laendertabelle1.svg
1595034000,32522,21512,11010,249,118,https://diviexchange.z6.web.core.windows.net/laendertabelle1.svg
1595037600,32507,21505,11002,248,117,https://diviexchange.z6.web.core.windows.net/laendertabelle1.svg
1595041200,32492,21495,10997,248,117,https://diviexchange.z6.web.core.windows.net/laendertabelle1.svg
1595044800,32490,21490,11000,248,117,https://diviexchange.z6.web.core.windows.net/laendertabelle1.svg
1595048400,32502,21469,11033,246,117,https://diviexchange.z6.web.core.windows.net/laendertabelle1.svg
1595052000,32492,21421,11071,246,115,https://diviexchange.z6.web.core.windows.net/laendertabelle1.svg
1595055600,32507,21350,11157,247,113,https://diviexchange.z6.web.core.windows.net/laendertabelle1.svg
1595062800,32443,21243,11200,248,114,https://diviexchange.z6.web.core.windows.net/laendertabelle1.svg
1595066400,32403,21147,11256,247,116,https://diviexchange.z6.web.core.windows.net/laendertabelle1.svg
1595070000,32408,21128,11280,247,115,https://diviexchange.z6.web.core.windows.net/laendertabelle1.svg
1595073600,32404,21107,11297,247,115,https://diviexchange.z6.web.core.windows.net/laendertabelle1.svg
1595077200,32407,21106,11301,246,115,https://diviexchange.z6.web.core.windows.net/laendertabelle1.svg
1595080800,32404,21094,11310,246,115,https://diviexchange.z6.web.core.windows.net/laendertabelle1.svg
1595084400,32405,21095,11310,246,115,https://diviexchange.z6.web.core.windows.net/laendertabelle1.svg
1595088000,32391,21081,11310,246,115,https://diviexchange.z6.web.core.windows.net/laendertabelle1.svg
1595091600,32372,21064,11308,246,115,https://diviexchange.z6.web.core.windows.net/laendertabelle1.svg
1595095200,32352,21041,11311,245,114,https://diviexchange.z6.web.core.windows.net/laendertabelle1.svg
1595098800,32267,20979,11288,241,111,https://diviexchange.z6.web.core.windows.net/laendertabelle1.svg
1595102400,32255,20964,11291,241,111,https://diviexchange.z6.web.core.windows.net/laendertabelle1.svg
1595106000,32255,20965,11290,241,111,https://diviexchange.z6.web.core.windows.net/laendertabelle1.svg
1595109600,32255,20961,11294,241,111,https://diviexchange.z6.web.core.windows.net/laendertabelle1.svg
1595113200,32243,20949,11294,241,111,https://diviexchange.z6.web.core.windows.net/laendertabelle1.svg
1595116800,32247,20954,11293,242,112,https://diviexchange.z6.web.core.windows.net/laendertabelle1.svg
1595120400,32245,20956,11289,242,112,https://diviexchange.z6.web.core.windows.net/laendertabelle1.svg
1595124000,32240,20954,11286,242,112,https://diviexchange.z6.web.core.windows.net/laendertabelle1.svg
1595127600,32242,20955,11287,242,112,https://diviexchange.z6.web.core.windows.net/laendertabelle1.svg
1595131200,32241,20956,11285,242,112,https://diviexchange.z6.web.core.windows.net/laendertabelle1.svg
1595134800,32243,20951,11292,243,114,https://diviexchange.z6.web.core.windows.net/laendertabelle1.svg
1595138400,32222,20876,11346,244,116,https://diviexchange.z6.web.core.windows.net/laendertabelle1.svg
1595142000,32215,20708,11507,243,116,https://diviexchange.z6.web.core.windows.net/laendertabelle1.svg
1595145600,32196,20607,11589,250,116,https://diviexchange.z6.web.core.windows.net/laendertabelle1.svg
1595149200,32191,20590,11601,249,115,https://diviexchange.z6.web.core.windows.net/laendertabelle1.svg
1595152800,32192,20533,11659,249,116,https://diviexchange.z6.web.core.windows.net/laendertabelle1.svg
1595156400,32196,20533,11663,248,116,https://diviexchange.z6.web.core.windows.net/laendertabelle1.svg
1595160000,32185,20531,11654,248,116,https://diviexchange.z6.web.core.windows.net/laendertabelle1.svg
1595163600,32186,20529,11657,248,116,https://diviexchange.z6.web.core.windows.net/laendertabelle1.svg
1595167200,32211,20541,11670,249,117,https://diviexchange.z6.web.core.windows.net/laendertabelle1.svg
1595170800,32211,20544,11667,249,117,https://diviexchange.z6.web.core.windows.net/laendertabelle1.svg
1595174400,32212,20543,11669,249,117,https://diviexchange.z6.web.core.windows.net/laendertabelle1.svg
1595178000,32165,20513,11652,249,117,https://diviexchange.z6.web.core.windows.net/laendertabelle1.svg
1595181600,32003,20418,11585,249,117,https://diviexchange.z6.web.core.windows.net/laendertabelle1.svg
1595185200,31845,20299,11546,249,117,https://diviexchange.z6.web.core.windows.net/laendertabelle1.svg
1595188800,31724,20211,11513,249,117,https://diviexchange.z6.web.core.windows.net/laendertabelle1.svg
1595192400,31616,20133,11483,247,116,https://diviexchange.z6.web.core.windows.net/laendertabelle1.svg
1595196000,31515,20051,11464,233,103,https://diviexchange.z6.web.core.windows.net/laendertabelle1.svg
1595199600,31448,20034,11414,233,103,https://diviexchange.z6.web.core.windows.net/laendertabelle1.svg
1595203200,31429,20013,11416,233,103,https://diviexchange.z6.web.core.windows.net/laendertabelle1.svg
1595206800,31404,19989,11415,231,102,https://diviexchange.z6.web.core.windows.net/laendertabelle1.svg
1595210400,31397,19987,11410,231,102,https://diviexchange.z6.web.core.windows.net/laendertabelle1.svg
1595214000,31356,19959,11397,231,102,https://diviexchange.z6.web.core.windows.net/laendertabelle1.svg
1595217600,31354,19953,11401,232,103,https://diviexchange.z6.web.core.windows.net/laendertabelle1.svg
1595221200,31340,19957,11383,231,101,https://diviexchange.z6.web.core.windows.net/laendertabelle1.svg
1595224800,31563,20134,11429,227,102,https://diviexchange.z6.web.core.windows.net/laendertabelle1.svg
1595228400,31880,20328,11552,229,103,https://diviexchange.z6.web.core.windows.net/laendertabelle1.svg
1595232000,32044,20407,11637,227,103,https://diviexchange.z6.web.core.windows.net/laendertabelle1.svg
1595235600,32224,20553,11671,232,105,https://diviexchange.z6.web.core.windows.net/laendertabelle1.svg
1595239200,32416,20698,11718,245,119,https://diviexchange.z6.web.core.windows.net/laendertabelle1.svg
1595242800,32482,20737,11745,246,120,https://diviexchange.z6.web.core.windows.net/laendertabelle1.svg
1595246400,32507,20752,11755,246,120,https://diviexchange.z6.web.core.windows.net/laendertabelle1.svg
1595250000,32502,20750,11752,246,120,https://diviexchange.z6.web.core.windows.net/laendertabelle1.svg
1595253600,32532,20769,11763,246,121,https://diviexchange.z6.web.core.windows.net/laendertabelle1.svg
1595257200,32551,20781,11770,246,121,https://diviexchange.z6.web.core.windows.net/laendertabelle1.svg
1595260800,32614,20818,11796,246,121,https://diviexchange.z6.web.core.windows.net/laendertabelle1.svg
1595264400,32604,20814,11790,246,121,https://diviexchange.z6.web.core.windows.net/laendertabelle1.svg
1595268000,32558,20766,11792,246,121,https://diviexchange.z6.web.core.windows.net/laendertabelle1.svg
1595271600,32519,20728,11791,246,121,https://diviexchange.z6.web.core.windows.net/laendertabelle1.svg
1595278800,32519,20729,11790,246,121,https://diviexchange.z6.web.core.windows.net/laendertabelle1.svg
1595286000,32472,20702,11770,246,121,https://diviexchange.z6.web.core.windows.net/laendertabelle1.svg
1595289600,32471,20708,11763,246,121,https://diviexchange.z6.web.core.windows.net/laendertabelle1.svg
1595293200,32477,20714,11763,246,121,https://diviexchange.z6.web.core.windows.net/laendertabelle1.svg
1595296800,32477,20715,11762,246,121,https://diviexchange.z6.web.core.windows.net/laendertabelle1.svg
1595300400,32468,20711,11757,246,121,https://diviexchange.z6.web.core.windows.net/laendertabelle1.svg
1595304000,32470,20716,11754,246,121,https://diviexchange.z6.web.core.windows.net/laendertabelle1.svg
1595307600,32465,20813,11652,247,121,https://diviexchange.z6.web.core.windows.net/laendertabelle1.svg
1595311200,32451,20892,11559,246,119,https://diviexchange.z6.web.core.windows.net/laendertabelle1.svg
1595314800,32504,21076,11428,246,121,https://diviexchange.z6.web.core.windows.net/laendertabelle1.svg
1595318400,32596,21174,11422,248,122,https://diviexchange.z6.web.core.windows.net/laendertabelle1.svg
1595322000,32599,21216,11383,249,121,https://diviexchange.z6.web.core.windows.net/laendertabelle1.svg
1595325600,32634,21236,11398,254,122,https://diviexchange.z6.web.core.windows.net/laendertabelle1.svg
1595329200,32634,21229,11405,254,122,https://diviexchange.z6.web.core.windows.net/laendertabelle1.svg
1595332800,32621,21228,11393,254,122,https://diviexchange.z6.web.core.windows.net/laendertabelle1.svg
1595336400,32620,21224,11396,254,122,https://diviexchange.z6.web.core.windows.net/laendertabelle1.svg
1595343600,32645,21247,11398,254,122,https://diviexchange.z6.web.core.windows.net/laendertabelle1.svg
1595347200,32644,21249,11395,254,122,https://diviexchange.z6.web.core.windows.net/laendertabelle1.svg
1595350800,32631,21236,11395,254,122,https://diviexchange.z6.web.core.windows.net/laendertabelle1.svg
1595354400,32616,21228,11388,254,122,https://diviexchange.z6.web.core.windows.net/laendertabelle1.svg
1595358000,32616,21230,11386,254,122,https://diviexchange.z6.web.core.windows.net/laendertabelle1.svg
1595361600,32616,21232,11384,255,123,https://diviexchange.z6.web.core.windows.net/laendertabelle1.svg
1595365200,32610,21228,11382,255,123,https://diviexchange.z6.web.core.windows.net/laendertabelle1.svg
1595368800,32614,21232,11382,255,123,https://diviexchange.z6.web.core.windows.net/laendertabelle1.svg
1595372400,32449,21138,11311,254,123,https://diviexchange.z6.web.core.windows.net/laendertabelle1.svg
1595376000,32438,21140,11298,254,123,https://diviexchange.z6.web.core.windows.net/laendertabelle1.svg
1595379600,32416,21127,11289,254,123,https://diviexchange.z6.web.core.windows.net/laendertabelle1.svg
1595383200,32411,21124,11287,254,123,https://diviexchange.z6.web.core.windows.net/laendertabelle1.svg
1595386800,32411,21123,11288,255,123,https://diviexchange.z6.web.core.windows.net/laendertabelle1.svg
1595390400,32389,21115,11274,255,123,https://diviexchange.z6.web.core.windows.net/laendertabelle1.svg
1595394000,32387,21145,11242,256,124,https://diviexchange.z6.web.core.windows.net/laendertabelle1.svg
1595397600,32496,21291,11205,258,126,https://diviexchange.z6.web.core.windows.net/laendertabelle1.svg
1595401200,32635,21417,11218,259,127,https://diviexchange.z6.web.core.windows.net/laendertabelle1.svg
1595404800,32655,21456,11199,253,128,https://diviexchange.z6.web.core.windows.net/laendertabelle1.svg
1595408400,32736,21497,11239,251,128,https://diviexchange.z6.web.core.windows.net/laendertabelle1.svg
1595412000,32772,21518,11254,250,127,https://diviexchange.z6.web.core.windows.net/laendertabelle1.svg
1595415600,32779,21527,11252,250,127,https://diviexchange.z6.web.core.windows.net/laendertabelle1.svg
1595419200,32777,21518,11259,249,127,https://diviexchange.z6.web.core.windows.net/laendertabelle1.svg
1595422800,32777,21510,11267,247,127,https://diviexchange.z6.web.core.windows.net/laendertabelle1.svg
1595426400,32793,21518,11275,247,127,https://diviexchange.z6.web.core.windows.net/laendertabelle1.svg
1595430000,32818,21542,11276,246,127,https://diviexchange.z6.web.core.windows.net/laendertabelle1.svg
1595433600,32819,21545,11274,245,127,https://diviexchange.z6.web.core.windows.net/laendertabelle1.svg
1595437200,32819,21550,11269,246,128,https://diviexchange.z6.web.core.windows.net/laendertabelle1.svg
1595440800,32734,21513,11221,244,126,https://diviexchange.z6.web.core.windows.net/laendertabelle1.svg
1595444400,32713,21501,11212,244,126,https://diviexchange.z6.web.core.windows.net/laendertabelle1.svg
1595448000,32710,21501,11209,244,126,https://diviexchange.z6.web.core.windows.net/laendertabelle1.svg
1595451600,32635,21436,11199,244,126,https://diviexchange.z6.web.core.windows.net/laendertabelle1.svg
1595458800,32538,21349,11189,246,128,https://diviexchange.z6.web.core.windows.net/laendertabelle1.svg
1595462400,32519,21345,11174,246,128,https://diviexchange.z6.web.core.windows.net/laendertabelle1.svg
1595466000,32510,21341,11169,246,128,https://diviexchange.z6.web.core.windows.net/laendertabelle1.svg
1595473200,32516,21343,11173,246,128,https://diviexchange.z6.web.core.windows.net/laendertabelle1.svg
1595476800,32515,21336,11179,246,128,https://diviexchange.z6.web.core.windows.net/laendertabelle1.svg
1595480400,32556,21332,11224,244,127,https://diviexchange.z6.web.core.windows.net/laendertabelle1.svg
1595484000,32694,21393,11301,243,130,https://diviexchange.z6.web.core.windows.net/laendertabelle1.svg
1595487600,32827,21580,11247,233,124,https://diviexchange.z6.web.core.windows.net/laendertabelle1.svg
1595491200,32881,21600,11281,239,127,https://diviexchange.z6.web.core.windows.net/laendertabelle1.svg
1595494800,32855,21542,11313,236,127,https://diviexchange.z6.web.core.windows.net/laendertabelle1.svg
1595498400,32927,21576,11351,239,127,https://diviexchange.z6.web.core.windows.net/laendertabelle1.svg
1595502000,32954,21577,11377,238,127,https://diviexchange.z6.web.core.windows.net/laendertabelle1.svg
1595505600,32955,21579,11376,237,127,https://diviexchange.z6.web.core.windows.net/laendertabelle1.svg
1595509200,32954,21581,11373,236,126,https://diviexchange.z6.web.core.windows.net/laendertabelle1.svg
1595512800,32952,21566,11386,237,126,https://diviexchange.z6.web.core.windows.net/laendertabelle1.svg
1595516400,32955,21575,11380,237,126,https://diviexchange.z6.web.core.windows.net/laendertabelle1.svg
1595520000,32980,21589,11391,237,126,https://diviexchange.z6.web.core.windows.net/laendertabelle1.svg
1595523600,32983,21589,11394,237,126,https://diviexchange.z6.web.core.windows.net/laendertabelle1.svg
1595527200,32961,21578,11383,237,126,https://diviexchange.z6.web.core.windows.net/laendertabelle1.svg
1595530800,32965,21575,11390,237,126,https://diviexchange.z6.web.core.windows.net/laendertabelle1.svg
1595541600,32960,21570,11390,237,126,https://diviexchange.z6.web.core.windows.net/laendertabelle1.svg
1595545200,32694,21389,11305,237,126,https://diviexchange.z6.web.core.windows.net/laendertabelle1.svg
1595548800,32693,21391,11302,235,124,https://diviexchange.z6.web.core.windows.net/laendertabelle1.svg
1595552400,32693,21388,11305,235,124,https://diviexchange.z6.web.core.windows.net/laendertabelle1.svg
1595556000,32693,21383,11310,235,124,https://diviexchange.z6.web.core.windows.net/laendertabelle1.svg
1595559600,32697,21387,11310,235,124,https://diviexchange.z6.web.core.windows.net/laendertabelle1.svg
1595563200,32695,21400,11295,236,124,https://diviexchange.z6.web.core.windows.net/laendertabelle1.svg
1595566800,32702,21400,11302,234,123,https://diviexchange.z6.web.core.windows.net/laendertabelle1.svg
1595570400,32706,21462,11244,231,121,https://diviexchange.z6.web.core.windows.net/laendertabelle1.svg
1595574000,32722,21492,11230,242,122,https://diviexchange.z6.web.core.windows.net/laendertabelle1.svg
1595577600,32783,21556,11227,236,118,https://diviexchange.z6.web.core.windows.net/laendertabelle1.svg
1595581200,32956,21694,11262,234,120,https://diviexchange.z6.web.core.windows.net/laendertabelle1.svg
1595584800,32995,21736,11259,237,119,https://diviexchange.z6.web.core.windows.net/laendertabelle1.svg
1595588400,32988,21724,11264,237,119,https://diviexchange.z6.web.core.windows.net/laendertabelle1.svg
1595592000,33003,21723,11280,237,119,https://diviexchange.z6.web.core.windows.net/laendertabelle1.svg
1595595600,32998,21713,11285,237,119,https://diviexchange.z6.web.core.windows.net/laendertabelle1.svg
1595599200,32999,21707,11292,237,119,https://diviexchange.z6.web.core.windows.net/laendertabelle1.svg
1595602800,33001,21706,11295,238,119,https://diviexchange.z6.web.core.windows.net/laendertabelle1.svg
1595610000,32987,21688,11299,238,119,https://diviexchange.z6.web.core.windows.net/laendertabelle1.svg
1595613600,32921,21638,11283,237,119,https://diviexchange.z6.web.core.windows.net/laendertabelle1.svg
1595617200,32892,21619,11273,237,119,https://diviexchange.z6.web.core.windows.net/laendertabelle1.svg
1595620800,32876,21603,11273,237,119,https://diviexchange.z6.web.core.windows.net/laendertabelle1.svg
1595631600,32848,21575,11273,237,120,https://diviexchange.z6.web.core.windows.net/laendertabelle1.svg
1595635200,32846,21571,11275,237,120,https://diviexchange.z6.web.core.windows.net/laendertabelle1.svg
1595638800,32856,21581,11275,237,120,https://diviexchange.z6.web.core.windows.net/laendertabelle1.svg
1595642400,32841,21568,11273,237,120,https://diviexchange.z6.web.core.windows.net/laendertabelle1.svg
1595646000,32841,21569,11272,237,120,https://diviexchange.z6.web.core.windows.net/laendertabelle1.svg
1595649600,32836,21567,11269,238,121,https://diviexchange.z6.web.core.windows.net/laendertabelle1.svg
1595653200,32829,21543,11286,238,121,https://diviexchange.z6.web.core.windows.net/laendertabelle1.svg
1595656800,32798,21513,11285,244,125,https://diviexchange.z6.web.core.windows.net/laendertabelle1.svg
1595660400,32799,21509,11290,242,125,https://diviexchange.z6.web.core.windows.net/laendertabelle1.svg
1595664000,32807,21498,11309,248,123,https://diviexchange.z6.web.core.windows.net/laendertabelle1.svg
1595667600,32854,21472,11382,249,126,https://diviexchange.z6.web.core.windows.net/laendertabelle1.svg
1595671200,32873,21428,11445,249,127,https://diviexchange.z6.web.core.windows.net/laendertabelle1.svg
1595674800,32870,21402,11468,249,126,https://diviexchange.z6.web.core.windows.net/laendertabelle1.svg
1595678400,32879,21417,11462,248,124,https://diviexchange.z6.web.core.windows.net/laendertabelle1.svg
1595682000,32877,21413,11464,248,124,https://diviexchange.z6.web.core.windows.net/laendertabelle1.svg
1595685600,32878,21413,11465,248,124,https://diviexchange.z6.web.core.windows.net/laendertabelle1.svg
1595689200,32878,21407,11471,249,124,https://diviexchange.z6.web.core.windows.net/laendertabelle1.svg
1595692800,32877,21408,11469,248,124,https://diviexchange.z6.web.core.windows.net/laendertabelle1.svg
1595696400,32871,21404,11467,248,124,https://diviexchange.z6.web.core.windows.net/laendertabelle1.svg
1595700000,32858,21390,11468,248,124,https://diviexchange.z6.web.core.windows.net/laendertabelle1.svg
1595703600,32860,21388,11472,248,124,https://diviexchange.z6.web.core.windows.net/laendertabelle1.svg
1595707200,32792,21343,11449,248,124,https://diviexchange.z6.web.core.windows.net/laendertabelle1.svg
1595714400,32745,21297,11448,248,124,https://diviexchange.z6.web.core.windows.net/laendertabelle1.svg
1595718000,32745,21291,11454,248,124,https://diviexchange.z6.web.core.windows.net/laendertabelle1.svg
1595721600,32725,21269,11456,248,124,https://diviexchange.z6.web.core.windows.net/laendertabelle1.svg
1595725200,32724,21269,11455,248,124,https://diviexchange.z6.web.core.windows.net/laendertabelle1.svg
1595732400,32722,21265,11457,248,124,https://diviexchange.z6.web.core.windows.net/laendertabelle1.svg
1595736000,32711,21264,11447,248,124,https://diviexchange.z6.web.core.windows.net/laendertabelle1.svg
1595739600,32714,21249,11465,251,125,https://diviexchange.z6.web.core.windows.net/laendertabelle1.svg
1595743200,32688,21130,11558,256,125,https://diviexchange.z6.web.core.windows.net/laendertabelle1.svg
1595746800,32684,21031,11653,260,126,https://diviexchange.z6.web.core.windows.net/laendertabelle1.svg
1595750400,32707,20940,11767,267,128,https://diviexchange.z6.web.core.windows.net/laendertabelle1.svg
1595754000,32719,20881,11838,264,129,https://diviexchange.z6.web.core.windows.net/laendertabelle1.svg
1595757600,32713,20811,11902,270,130,https://diviexchange.z6.web.core.windows.net/laendertabelle1.svg
1595761200,32711,20799,11912,269,130,https://diviexchange.z6.web.core.windows.net/laendertabelle1.svg
1595764800,32711,20796,11915,269,130,https://diviexchange.z6.web.core.windows.net/laendertabelle1.svg
1595768400,32701,20752,11949,269,130,https://diviexchange.z6.web.core.windows.net/laendertabelle1.svg
1595772000,32702,20751,11951,269,130,https://diviexchange.z6.web.core.windows.net/laendertabelle1.svg
1595775600,32702,20752,11950,270,131,https://diviexchange.z6.web.core.windows.net/laendertabelle1.svg
1595779200,32707,20750,11957,270,131,https://diviexchange.z6.web.core.windows.net/laendertabelle1.svg
1595782800,32642,20708,11934,270,131,https://diviexchange.z6.web.core.windows.net/laendertabelle1.svg
1595786400,32554,20660,11894,271,131,https://diviexchange.z6.web.core.windows.net/laendertabelle1.svg
1595790000,32282,20530,11752,271,131,https://diviexchange.z6.web.core.windows.net/laendertabelle1.svg
1595793600,32191,20451,11740,271,131,https://diviexchange.z6.web.core.windows.net/laendertabelle1.svg
1595797200,31989,20333,11656,270,130,https://diviexchange.z6.web.core.windows.net/laendertabelle1.svg
1595800800,31932,20296,11636,270,130,https://diviexchange.z6.web.core.windows.net/laendertabelle1.svg
1595804400,31924,20296,11628,270,130,https://diviexchange.z6.web.core.windows.net/laendertabelle1.svg
1595808000,31918,20300,11618,270,130,https://diviexchange.z6.web.core.windows.net/laendertabelle1.svg
1595811600,31924,20305,11619,270,130,https://diviexchange.z6.web.core.windows.net/laendertabelle1.svg
1595815200,31893,20280,11613,270,130,https://diviexchange.z6.web.core.windows.net/laendertabelle1.svg
1595818800,31883,20275,11608,270,130,https://diviexchange.z6.web.core.windows.net/laendertabelle1.svg
1595822400,31885,20272,11613,269,130,https://diviexchange.z6.web.core.windows.net/laendertabelle1.svg
1595826000,31931,20273,11658,268,131,https://diviexchange.z6.web.core.windows.net/laendertabelle1.svg
1595829600,32068,20384,11684,267,133,https://diviexchange.z6.web.core.windows.net/laendertabelle1.svg
1595833200,32227,20446,11781,259,133,https://diviexchange.z6.web.core.windows.net/laendertabelle1.svg
1595836800,32454,20585,11869,260,131,https://diviexchange.z6.web.core.windows.net/laendertabelle1.svg
1595840400,32663,20680,11983,262,131,https://diviexchange.z6.web.core.windows.net/laendertabelle1.svg
1595844000,32765,20720,12045,262,133,https://diviexchange.z6.web.core.windows.net/laendertabelle1.svg
1595847600,32836,20781,12055,261,133,https://diviexchange.z6.web.core.windows.net/laendertabelle1.svg
1595851200,32826,20781,12045,262,134,https://diviexchange.z6.web.core.windows.net/laendertabelle1.svg
1595854800,32821,20781,12040,262,134,https://diviexchange.z6.web.core.windows.net/laendertabelle1.svg
1595862000,32834,20786,12048,261,133,https://diviexchange.z6.web.core.windows.net/laendertabelle1.svg
1595865600,32831,20787,12044,262,133,https://diviexchange.z6.web.core.windows.net/laendertabelle1.svg
1595872800,32831,20788,12043,262,133,https://diviexchange.z6.web.core.windows.net/laendertabelle1.svg
1595876400,32821,20778,12043,262,133,https://diviexchange.z6.web.core.windows.net/laendertabelle1.svg
1595880000,32813,20770,12043,262,133,https://diviexchange.z6.web.core.windows.net/laendertabelle1.svg
1595890800,32714,20697,12017,259,132,https://diviexchange.z6.web.core.windows.net/laendertabelle1.svg
1595894400,32715,20698,12017,259,132,https://diviexchange.z6.web.core.windows.net/laendertabelle1.svg
1595898000,32714,20697,12017,259,132,https://diviexchange.z6.web.core.windows.net/laendertabelle1.svg
1595901600,32713,20698,12015,259,132,https://diviexchange.z6.web.core.windows.net/laendertabelle1.svg
1595905200,32713,20699,12014,259,132,https://diviexchange.z6.web.core.windows.net/laendertabelle1.svg
1595908800,32719,20704,12015,259,132,https://diviexchange.z6.web.core.windows.net/laendertabelle1.svg
1595912400,32721,20756,11965,259,131,https://diviexchange.z6.web.core.windows.net/laendertabelle1.svg
1595916000,32788,20978,11810,252,127,https://diviexchange.z6.web.core.windows.net/laendertabelle1.svg
1595919600,32935,21288,11647,258,130,https://diviexchange.z6.web.core.windows.net/laendertabelle1.svg
1595923200,32936,21366,11570,258,127,https://diviexchange.z6.web.core.windows.net/laendertabelle1.svg
1595926800,32988,21428,11560,258,126,https://diviexchange.z6.web.core.windows.net/laendertabelle1.svg
1595930400,33008,21441,11567,258,126,https://diviexchange.z6.web.core.windows.net/laendertabelle1.svg
1595934000,33008,21447,11561,258,126,https://diviexchange.z6.web.core.windows.net/laendertabelle1.svg
1595937600,33050,21487,11563,258,126,https://diviexchange.z6.web.core.windows.net/laendertabelle1.svg
1595941200,33063,21482,11581,257,126,https://diviexchange.z6.web.core.windows.net/laendertabelle1.svg
1595944800,33043,21457,11586,256,126,https://diviexchange.z6.web.core.windows.net/laendertabelle1.svg
1595948400,33043,21461,11582,256,126,https://diviexchange.z6.web.core.windows.net/laendertabelle1.svg
1595952000,33044,21458,11586,256,126,https://diviexchange.z6.web.core.windows.net/laendertabelle1.svg
1595955600,33045,21458,11587,256,126,https://diviexchange.z6.web.core.windows.net/laendertabelle1.svg
1595959200,33044,21460,11584,256,126,https://diviexchange.z6.web.core.windows.net/laendertabelle1.svg
1595962800,33038,21456,11582,256,126,https://diviexchange.z6.web.core.windows.net/laendertabelle1.svg
1595966400,33007,21442,11565,256,126,https://diviexchange.z6.web.core.windows.net/laendertabelle1.svg
1595970000,32988,21424,11564,256,126,https://diviexchange.z6.web.core.windows.net/laendertabelle1.svg
1595973600,32980,21418,11562,256,126,https://diviexchange.z6.web.core.windows.net/laendertabelle1.svg
1595977200,32570,21124,11446,254,124,https://diviexchange.z6.web.core.windows.net/laendertabelle1.svg
1595984400,32571,21124,11447,254,124,https://diviexchange.z6.web.core.windows.net/laendertabelle1.svg
1595988000,32569,21118,11451,254,124,https://diviexchange.z6.web.core.windows.net/laendertabelle1.svg
1595991600,32569,21121,11448,254,124,https://diviexchange.z6.web.core.windows.net/laendertabelle1.svg
1595995200,32574,21126,11448,254,124,https://diviexchange.z6.web.core.windows.net/laendertabelle1.svg
1595998800,32573,21163,11410,254,125,https://diviexchange.z6.web.core.windows.net/laendertabelle1.svg
1596002400,32626,21255,11371,262,130,https://diviexchange.z6.web.core.windows.net/laendertabelle1.svg
1596006000,33032,21529,11503,261,130,https://diviexchange.z6.web.core.windows.net/laendertabelle1.svg
1596009600,33101,21663,11438,259,128,https://diviexchange.z6.web.core.windows.net/laendertabelle1.svg
1596013200,33176,21757,11419,264,131,https://diviexchange.z6.web.core.windows.net/laendertabelle1.svg
1596016800,33220,21767,11453,261,130,https://diviexchange.z6.web.core.windows.net/laendertabelle1.svg
1596020400,33237,21771,11466,262,130,https://diviexchange.z6.web.core.windows.net/laendertabelle1.svg
1596024000,33284,21779,11505,262,130,https://diviexchange.z6.web.core.windows.net/laendertabelle1.svg
1596027600,33299,21792,11507,263,130,https://diviexchange.z6.web.core.windows.net/laendertabelle1.svg
1596031200,33334,21799,11535,263,130,https://diviexchange.z6.web.core.windows.net/laendertabelle1.svg
1596034800,33348,21805,11543,264,130,https://diviexchange.z6.web.core.windows.net/laendertabelle1.svg
1596038400,33353,21811,11542,264,130,https://diviexchange.z6.web.core.windows.net/laendertabelle1.svg
1596042000,33387,21839,11548,264,130,https://diviexchange.z6.web.core.windows.net/laendertabelle1.svg
1596045600,33377,21831,11546,264,130,https://diviexchange.z6.web.core.windows.net/laendertabelle1.svg
1596049200,33367,21831,11536,264,130,https://diviexchange.z6.web.core.windows.net/laendertabelle1.svg
1596052800,33353,21819,11534,264,130,https://diviexchange.z6.web.core.windows.net/laendertabelle1.svg
1596060000,33319,21795,11524,264,130,https://diviexchange.z6.web.core.windows.net/laendertabelle1.svg
1596063600,33290,21763,11527,264,130,https://diviexchange.z6.web.core.windows.net/laendertabelle1.svg
1596067200,33292,21766,11526,264,130,https://diviexchange.z6.web.core.windows.net/laendertabelle1.svg
1596074400,33265,21765,11500,264,130,https://diviexchange.z6.web.core.windows.net/laendertabelle1.svg
1596081600,33264,21759,11505,264,130,https://diviexchange.z6.web.core.windows.net/laendertabelle1.svg
1596085200,33258,21755,11503,265,131,https://diviexchange.z6.web.core.windows.net/laendertabelle1.svg
1596088800,33214,21706,11508,264,133,https://diviexchange.z6.web.core.windows.net/laendertabelle1.svg
1596092400,33271,21696,11575,263,134,https://diviexchange.z6.web.core.windows.net/laendertabelle1.svg
1596096000,33281,21676,11605,262,134,https://diviexchange.z6.web.core.windows.net/laendertabelle1.svg
1596099600,33310,21654,11656,262,133,https://diviexchange.z6.web.core.windows.net/laendertabelle1.svg
1596103200,33365,21694,11671,265,132,https://diviexchange.z6.web.core.windows.net/laendertabelle1.svg
1596106800,33394,21720,11674,266,132,https://diviexchange.z6.web.core.windows.net/laendertabelle1.svg
1596110400,33383,21713,11670,266,132,https://diviexchange.z6.web.core.windows.net/laendertabelle1.svg
1596114000,33384,21720,11664,266,132,https://diviexchange.z6.web.core.windows.net/laendertabelle1.svg
1596117600,33385,21720,11665,266,132,https://diviexchange.z6.web.core.windows.net/laendertabelle1.svg
1596121200,33386,21721,11665,267,132,https://diviexchange.z6.web.core.windows.net/laendertabelle1.svg
1596124800,33415,21741,11674,267,132,https://diviexchange.z6.web.core.windows.net/laendertabelle1.svg
1596128400,33400,21725,11675,267,132,https://diviexchange.z6.web.core.windows.net/laendertabelle1.svg
1596132000,33372,21713,11659,267,132,https://diviexchange.z6.web.core.windows.net/laendertabelle1.svg
1596139200,33352,21697,11655,267,132,https://diviexchange.z6.web.core.windows.net/laendertabelle1.svg
1596146400,33313,21661,11652,265,131,https://diviexchange.z6.web.core.windows.net/laendertabelle1.svg
1596150000,33297,21653,11644,265,131,https://diviexchange.z6.web.core.windows.net/laendertabelle1.svg
1596153600,33297,21655,11642,265,131,https://diviexchange.z6.web.core.windows.net/laendertabelle1.svg
1596157200,33292,21648,11644,265,131,https://diviexchange.z6.web.core.windows.net/laendertabelle1.svg
1596160800,33266,21630,11636,265,131,https://diviexchange.z6.web.core.windows.net/laendertabelle1.svg
1596164400,33266,21629,11637,265,131,https://diviexchange.z6.web.core.windows.net/laendertabelle1.svg
1596168000,33265,21647,11618,265,131,https://diviexchange.z6.web.core.windows.net/laendertabelle1.svg
1596171600,33255,21627,11628,267,133,https://diviexchange.z6.web.core.windows.net/laendertabelle1.svg
1596175200,33296,21670,11626,266,129,https://diviexchange.z6.web.core.windows.net/laendertabelle1.svg
1596178800,33305,21707,11598,267,126,https://diviexchange.z6.web.core.windows.net/laendertabelle1.svg
1596182400,33333,21714,11619,267,124,https://diviexchange.z6.web.core.windows.net/laendertabelle1.svg
1596186000,33313,21704,11609,264,124,https://diviexchange.z6.web.core.windows.net/laendertabelle1.svg
1596189600,33321,21696,11625,265,125,https://diviexchange.z6.web.core.windows.net/laendertabelle1.svg
1596193200,33344,21693,11651,266,126,https://diviexchange.z6.web.core.windows.net/laendertabelle1.svg
1596196800,33344,21698,11646,266,126,https://diviexchange.z6.web.core.windows.net/laendertabelle1.svg
1596200400,33363,21712,11651,266,126,https://diviexchange.z6.web.core.windows.net/laendertabelle1.svg
1596204000,33405,21752,11653,265,126,https://diviexchange.z6.web.core.windows.net/laendertabelle1.svg
1596207600,33424,21763,11661,265,126,https://diviexchange.z6.web.core.windows.net/laendertabelle1.svg
1596211200,33425,21760,11665,265,126,https://diviexchange.z6.web.core.windows.net/laendertabelle1.svg
1596214800,33437,21767,11670,265,126,https://diviexchange.z6.web.core.windows.net/laendertabelle1.svg
1596222000,33427,21768,11659,265,126,https://diviexchange.z6.web.core.windows.net/laendertabelle1.svg
1596225600,33427,21770,11657,265,126,https://diviexchange.z6.web.core.windows.net/laendertabelle1.svg
1596232800,33437,21770,11667,265,126,https://diviexchange.z6.web.core.windows.net/laendertabelle1.svg
1596236400,33382,21725,11657,266,127,https://diviexchange.z6.web.core.windows.net/laendertabelle1.svg
1596240000,33382,21720,11662,266,127,https://diviexchange.z6.web.core.windows.net/laendertabelle1.svg
1596243600,33379,21718,11661,267,127,https://diviexchange.z6.web.core.windows.net/laendertabelle1.svg
1596247200,33375,21706,11669,268,127,https://diviexchange.z6.web.core.windows.net/laendertabelle1.svg
1596250800,33381,21712,11669,268,127,https://diviexchange.z6.web.core.windows.net/laendertabelle1.svg
1596254400,33378,21704,11674,268,127,https://diviexchange.z6.web.core.windows.net/laendertabelle1.svg
1596258000,33352,21694,11658,269,127,https://diviexchange.z6.web.core.windows.net/laendertabelle1.svg
1596261600,33357,21612,11745,267,127,https://diviexchange.z6.web.core.windows.net/laendertabelle1.svg
1596265200,33323,21571,11752,264,125,https://diviexchange.z6.web.core.windows.net/laendertabelle1.svg
1596268800,33375,21592,11783,262,122,https://diviexchange.z6.web.core.windows.net/laendertabelle1.svg
1596272400,33334,21488,11846,261,121,https://diviexchange.z6.web.core.windows.net/laendertabelle1.svg
1596276000,33322,21484,11838,261,122,https://diviexchange.z6.web.core.windows.net/laendertabelle1.svg
1596279600,33315,21445,11870,261,122,https://diviexchange.z6.web.core.windows.net/laendertabelle1.svg
1596283200,33324,21445,11879,261,122,https://diviexchange.z6.web.core.windows.net/laendertabelle1.svg
1596286800,33320,21442,11878,262,124,https://diviexchange.z6.web.core.windows.net/laendertabelle1.svg
1596290400,33320,21442,11878,263,125,https://diviexchange.z6.web.core.windows.net/laendertabelle1.svg
1596294000,33318,21435,11883,263,125,https://diviexchange.z6.web.core.windows.net/laendertabelle1.svg
1596297600,33316,21429,11887,263,125,https://diviexchange.z6.web.core.windows.net/laendertabelle1.svg
1596301200,33283,21413,11870,263,125,https://diviexchange.z6.web.core.windows.net/laendertabelle1.svg
1596304800,33321,21412,11909,263,125,https://diviexchange.z6.web.core.windows.net/laendertabelle1.svg
1596308400,33297,21400,11897,262,124,https://diviexchange.z6.web.core.windows.net/laendertabelle1.svg
1596312000,33248,21361,11887,262,124,https://diviexchange.z6.web.core.windows.net/laendertabelle1.svg
1596319200,33254,21367,11887,262,124,https://diviexchange.z6.web.core.windows.net/laendertabelle1.svg
1596322800,33255,21364,11891,262,123,https://diviexchange.z6.web.core.windows.net/laendertabelle1.svg
1596326400,33255,21361,11894,262,123,https://diviexchange.z6.web.core.windows.net/laendertabelle1.svg
1596330000,33239,21351,11888,262,123,https://diviexchange.z6.web.core.windows.net/laendertabelle1.svg
1596333600,33244,21348,11896,262,123,https://diviexchange.z6.web.core.windows.net/laendertabelle1.svg
1596340800,33189,21310,11879,261,123,https://diviexchange.z6.web.core.windows.net/laendertabelle1.svg
1596344400,33198,21314,11884,261,123,https://diviexchange.z6.web.core.windows.net/laendertabelle1.svg
1596348000,33149,21204,11945,260,123,https://diviexchange.z6.web.core.windows.net/laendertabelle1.svg
1596351600,33077,21104,11973,263,125,https://diviexchange.z6.web.core.windows.net/laendertabelle1.svg
1596355200,33121,21004,12117,268,124,https://diviexchange.z6.web.core.windows.net/laendertabelle1.svg
1596358800,33115,20959,12156,270,126,https://diviexchange.z6.web.core.windows.net/laendertabelle1.svg
1596362400,33116,20922,12194,272,129,https://diviexchange.z6.web.core.windows.net/laendertabelle1.svg
1596366000,33118,20906,12212,271,129,https://diviexchange.z6.web.core.windows.net/laendertabelle1.svg
1596369600,33131,20912,12219,271,129,https://diviexchange.z6.web.core.windows.net/laendertabelle1.svg
1596373200,33157,20930,12227,271,129,https://diviexchange.z6.web.core.windows.net/laendertabelle1.svg
1596376800,33157,20932,12225,271,129,https://diviexchange.z6.web.core.windows.net/laendertabelle1.svg
1596380400,33123,20919,12204,270,129,https://diviexchange.z6.web.core.windows.net/laendertabelle1.svg
1596384000,33132,20926,12206,270,129,https://diviexchange.z6.web.core.windows.net/laendertabelle1.svg
1596387600,33047,20876,12171,271,129,https://diviexchange.z6.web.core.windows.net/laendertabelle1.svg
1596391200,32862,20776,12086,269,128,https://diviexchange.z6.web.core.windows.net/laendertabelle1.svg
1596394800,32670,20668,12002,268,128,https://diviexchange.z6.web.core.windows.net/laendertabelle1.svg
1596398400,32398,20458,11940,268,128,https://diviexchange.z6.web.core.windows.net/laendertabelle1.svg
1596402000,32327,20411,11916,268,128,https://diviexchange.z6.web.core.windows.net/laendertabelle1.svg
1596405600,32303,20396,11907,268,128,https://diviexchange.z6.web.core.windows.net/laendertabelle1.svg
1596409200,32276,20374,11902,266,128,https://diviexchange.z6.web.core.windows.net/laendertabelle1.svg
1596412800,32243,20348,11895,265,127,https://diviexchange.z6.web.core.windows.net/laendertabelle1.svg
1596416400,32243,20349,11894,265,127,https://diviexchange.z6.web.core.windows.net/laendertabelle1.svg
1596420000,32228,20328,11900,265,127,https://diviexchange.z6.web.core.windows.net/laendertabelle1.svg
1596423600,32203,20316,11887,264,127,https://diviexchange.z6.web.core.windows.net/laendertabelle1.svg
1596427200,32202,20311,11891,264,127,https://diviexchange.z6.web.core.windows.net/laendertabelle1.svg
1596430800,32257,20379,11878,265,127,https://diviexchange.z6.web.core.windows.net/laendertabelle1.svg
1596434400,32430,20389,12041,260,128,https://diviexchange.z6.web.core.windows.net/laendertabelle1.svg
1596438000,32603,20452,12151,262,129,https://diviexchange.z6.web.core.windows.net/laendertabelle1.svg
1596441600,32850,20658,12192,269,128,https://diviexchange.z6.web.core.windows.net/laendertabelle1.svg
1596445200,32995,20757,12238,272,130,https://diviexchange.z6.web.core.windows.net/laendertabelle1.svg
1596448800,33024,20781,12243,271,130,https://diviexchange.z6.web.core.windows.net/laendertabelle1.svg
1596452400,33031,20775,12256,270,130,https://diviexchange.z6.web.core.windows.net/laendertabelle1.svg
1596456000,33191,20891,12300,270,130,https://diviexchange.z6.web.core.windows.net/laendertabelle1.svg
1596459600,33203,20876,12327,270,130,https://diviexchange.z6.web.core.windows.net/laendertabelle1.svg
1596463200,33199,20865,12334,270,130,https://diviexchange.z6.web.core.windows.net/laendertabelle1.svg
1596466800,33237,20889,12348,271,130,https://diviexchange.z6.web.core.windows.net/laendertabelle1.svg
1596470400,33255,20906,12349,271,130,https://diviexchange.z6.web.core.windows.net/laendertabelle1.svg
1596474000,33247,20899,12348,271,130,https://diviexchange.z6.web.core.windows.net/laendertabelle1.svg
1596477600,33235,20888,12347,270,130,https://diviexchange.z6.web.core.windows.net/laendertabelle1.svg
1596481200,33210,20873,12337,270,130,https://diviexchange.z6.web.core.windows.net/laendertabelle1.svg
1596492000,33182,20852,12330,270,130,https://diviexchange.z6.web.core.windows.net/laendertabelle1.svg
1596495600,33172,20842,12330,270,130,https://diviexchange.z6.web.core.windows.net/laendertabelle1.svg
1596564000,33128,20824,12304,270,130,https://diviexchange.z6.web.core.windows.net/laendertabelle1.svg
1596567600,32863,20695,12168,269,130,https://diviexchange.z6.web.core.windows.net/laendertabelle1.svg
1596571200,32587,20493,12094,267,130,https://diviexchange.z6.web.core.windows.net/laendertabelle1.svg
1596574800,32448,20408,12040,267,130,https://diviexchange.z6.web.core.windows.net/laendertabelle1.svg
1596578400,32421,20391,12030,267,130,https://diviexchange.z6.web.core.windows.net/laendertabelle1.svg
1596582000,32405,20379,12026,267,130,https://diviexchange.z6.web.core.windows.net/laendertabelle1.svg
1596585600,32398,20375,12023,267,130,https://diviexchange.z6.web.core.windows.net/laendertabelle1.svg
1596589200,32396,20373,12023,267,130,https://diviexchange.z6.web.core.windows.net/laendertabelle1.svg
1596600000,32390,20369,12021,267,130,https://diviexchange.z6.web.core.windows.net/laendertabelle1.svg
1596603600,32376,20355,12021,267,130,https://diviexchange.z6.web.core.windows.net/laendertabelle1.svg
1596607200,32367,20354,12013,267,130,https://diviexchange.z6.web.core.windows.net/laendertabelle1.svg
1596621600,32304,20321,11983,267,130,https://diviexchange.z6.web.core.windows.net/laendertabelle1.svg
1596625200,32239,20282,11957,267,130,https://diviexchange.z6.web.core.windows.net/laendertabelle1.svg
1596628800,32141,20221,11920,267,130,https://diviexchange.z6.web.core.windows.net/laendertabelle1.svg
1596632400,32060,20173,11887,266,130,https://diviexchange.z6.web.core.windows.net/laendertabelle1.svg
1596636000,31985,20115,11870,265,130,https://diviexchange.z6.web.core.windows.net/laendertabelle1.svg
1596639600,31867,20042,11825,264,129,https://diviexchange.z6.web.core.windows.net/laendertabelle1.svg
1596643200,30997,19501,11496,260,127,https://diviexchange.z6.web.core.windows.net/laendertabelle1.svg
1596664805,30485,21383,9102,240,141,https://www.intensivregister.de/api/public/reporting/laendertabelle
1596668405,30485,21380,9105,240,141,https://www.intensivregister.de/api/public/reporting/laendertabelle
1596672005,30485,21377,9108,240,141,https://www.intensivregister.de/api/public/reporting/laendertabelle
1596675605,30485,21379,9106,240,141,https://www.intensivregister.de/api/public/reporting/laendertabelle
1596679205,30481,21379,9102,242,141,https://www.intensivregister.de/api/public/reporting/laendertabelle
1596682805,30488,21401,9087,242,141,https://www.intensivregister.de/api/public/reporting/laendertabelle
1596686406,30551,21408,9143,238,138,https://www.intensivregister.de/api/public/reporting/laendertabelle
1596690005,30525,21362,9163,240,136,https://www.intensivregister.de/api/public/reporting/laendertabelle
1596693606,30510,21396,9114,235,134,https://www.intensivregister.de/api/public/reporting/laendertabelle
1596697205,30502,21447,9055,235,131,https://www.intensivregister.de/api/public/reporting/laendertabelle
1596700806,30528,21447,9081,235,131,https://www.intensivregister.de/api/public/reporting/laendertabelle
1596704406,30526,21440,9086,235,131,https://www.intensivregister.de/api/public/reporting/laendertabelle
1596708005,30526,21443,9083,235,130,https://www.intensivregister.de/api/public/reporting/laendertabelle
1596711607,30519,21452,9067,237,131,https://www.intensivregister.de/api/public/reporting/laendertabelle
1596715205,30519,21446,9073,237,131,https://www.intensivregister.de/api/public/reporting/laendertabelle
1596718805,30521,21449,9072,236,131,https://www.intensivregister.de/api/public/reporting/laendertabelle
1596722405,30521,21441,9080,236,131,https://www.intensivregister.de/api/public/reporting/laendertabelle
1596726006,30521,21440,9081,236,131,https://www.intensivregister.de/api/public/reporting/laendertabelle
1596729606,30511,21431,9080,236,131,https://www.intensivregister.de/api/public/reporting/laendertabelle
1596733205,30516,21433,9083,236,131,https://www.intensivregister.de/api/public/reporting/laendertabelle
1596736805,30490,21412,9078,236,131,https://www.intensivregister.de/api/public/reporting/laendertabelle
1596740406,30449,21387,9062,236,131,https://www.intensivregister.de/api/public/reporting/laendertabelle
1596744005,30449,21382,9067,236,131,https://www.intensivregister.de/api/public/reporting/laendertabelle
1596747605,30432,21364,9068,236,131,https://www.intensivregister.de/api/public/reporting/laendertabelle
1596751205,30422,21357,9065,236,131,https://www.intensivregister.de/api/public/reporting/laendertabelle
1596754805,30422,21361,9061,236,131,https://www.intensivregister.de/api/public/reporting/laendertabelle
1596758405,30393,21338,9055,236,131,https://www.intensivregister.de/api/public/reporting/laendertabelle
1596762005,30385,21333,9052,236,131,https://www.intensivregister.de/api/public/reporting/laendertabelle
1596765605,30385,21340,9045,236,132,https://www.intensivregister.de/api/public/reporting/laendertabelle
1596769205,30416,21361,9055,236,133,https://www.intensivregister.de/api/public/reporting/laendertabelle
1596772805,30422,21386,9036,231,132,https://www.intensivregister.de/api/public/reporting/laendertabelle
1596776405,30396,21457,8939,223,131,https://www.intensivregister.de/api/public/reporting/laendertabelle
1596780005,30386,21462,8924,228,135,https://www.intensivregister.de/api/public/reporting/laendertabelle
1596783606,30389,21416,8973,229,135,https://www.intensivregister.de/api/public/reporting/laendertabelle
1596787205,30420,21445,8975,229,134,https://www.intensivregister.de/api/public/reporting/laendertabelle
1596790805,30420,21444,8976,230,135,https://www.intensivregister.de/api/public/reporting/laendertabelle
1596794405,30459,21471,8988,230,135,https://www.intensivregister.de/api/public/reporting/laendertabelle
1596798005,30459,21465,8994,231,136,https://www.intensivregister.de/api/public/reporting/laendertabelle
1596801605,30470,21471,8999,232,136,https://www.intensivregister.de/api/public/reporting/laendertabelle
1596805205,30464,21459,9005,231,135,https://www.intensivregister.de/api/public/reporting/laendertabelle
1596812405,30448,21449,8999,231,135,https://www.intensivregister.de/api/public/reporting/laendertabelle
1596816005,30436,21449,8987,232,135,https://www.intensivregister.de/api/public/reporting/laendertabelle
1596819606,30416,21429,8987,232,135,https://www.intensivregister.de/api/public/reporting/laendertabelle
1596830405,30416,21434,8982,232,135,https://www.intensivregister.de/api/public/reporting/laendertabelle
1596834005,30416,21437,8979,232,135,https://www.intensivregister.de/api/public/reporting/laendertabelle
1596837605,30415,21444,8971,232,135,https://www.intensivregister.de/api/public/reporting/laendertabelle
1596841205,30415,21433,8982,232,135,https://www.intensivregister.de/api/public/reporting/laendertabelle
1596844805,30383,21415,8968,232,135,https://www.intensivregister.de/api/public/reporting/laendertabelle
1596848405,30383,21411,8972,232,135,https://www.intensivregister.de/api/public/reporting/laendertabelle
1596852005,30382,21416,8966,231,135,https://www.intensivregister.de/api/public/reporting/laendertabelle
1596855605,30389,21405,8984,231,135,https://www.intensivregister.de/api/public/reporting/laendertabelle
1596859205,30402,21406,8996,232,135,https://www.intensivregister.de/api/public/reporting/laendertabelle
1596862805,30386,21385,9001,228,134,https://www.intensivregister.de/api/public/reporting/laendertabelle
1596866406,30358,21328,9030,230,134,https://www.intensivregister.de/api/public/reporting/laendertabelle
1596870005,30341,21230,9111,234,137,https://www.intensivregister.de/api/public/reporting/laendertabelle
1596873606,30328,21187,9141,231,135,https://www.intensivregister.de/api/public/reporting/laendertabelle
1596877205,30326,21174,9152,231,134,https://www.intensivregister.de/api/public/reporting/laendertabelle
1596880805,30319,21164,9155,230,133,https://www.intensivregister.de/api/public/reporting/laendertabelle
1596888005,30319,21158,9161,230,133,https://www.intensivregister.de/api/public/reporting/laendertabelle
1596891605,30319,21161,9158,230,133,https://www.intensivregister.de/api/public/reporting/laendertabelle
1596895205,30319,21158,9161,230,133,https://www.intensivregister.de/api/public/reporting/laendertabelle
1596898805,30299,21141,9158,230,133,https://www.intensivregister.de/api/public/reporting/laendertabelle
1596902405,30292,21133,9159,229,132,https://www.intensivregister.de/api/public/reporting/laendertabelle
1596906005,30226,21086,9140,229,132,https://www.intensivregister.de/api/public/reporting/laendertabelle
1596909605,30217,21080,9137,229,132,https://www.intensivregister.de/api/public/reporting/laendertabelle
1596916805,30110,21005,9105,229,132,https://www.intensivregister.de/api/public/reporting/laendertabelle
1596920405,30093,20990,9103,229,132,https://www.intensivregister.de/api/public/reporting/laendertabelle
1596924005,30085,20985,9100,229,132,https://www.intensivregister.de/api/public/reporting/laendertabelle
1596927605,30085,20988,9097,229,132,https://www.intensivregister.de/api/public/reporting/laendertabelle
1596931205,30085,20984,9101,229,132,https://www.intensivregister.de/api/public/reporting/laendertabelle
1596934805,30085,20980,9105,229,132,https://www.intensivregister.de/api/public/reporting/laendertabelle
1596938405,30085,20970,9115,229,132,https://www.intensivregister.de/api/public/reporting/laendertabelle
1596942005,30083,20960,9123,229,132,https://www.intensivregister.de/api/public/reporting/laendertabelle
1596945605,30079,20894,9185,230,132,https://www.intensivregister.de/api/public/reporting/laendertabelle
1596949205,30156,20820,9336,236,134,https://www.intensivregister.de/api/public/reporting/laendertabelle
1596952805,30173,20738,9435,235,135,https://www.intensivregister.de/api/public/reporting/laendertabelle
1596956405,30185,20711,9474,239,136,https://www.intensivregister.de/api/public/reporting/laendertabelle
1596960005,30169,20671,9498,237,136,https://www.intensivregister.de/api/public/reporting/laendertabelle
1596963606,30207,20683,9524,238,136,https://www.intensivregister.de/api/public/reporting/laendertabelle
1596967205,30211,20696,9515,238,136,https://www.intensivregister.de/api/public/reporting/laendertabelle
1596970806,30212,20681,9531,238,136,https://www.intensivregister.de/api/public/reporting/laendertabelle
1596974405,30212,20677,9535,238,136,https://www.intensivregister.de/api/public/reporting/laendertabelle
1596978005,30212,20679,9533,238,136,https://www.intensivregister.de/api/public/reporting/laendertabelle
1596981605,30206,20672,9534,238,136,https://www.intensivregister.de/api/public/reporting/laendertabelle
1596985205,30109,20595,9514,238,136,https://www.intensivregister.de/api/public/reporting/laendertabelle
1596988805,29956,20494,9462,238,136,https://www.intensivregister.de/api/public/reporting/laendertabelle
1596992405,29842,20412,9430,238,136,https://www.intensivregister.de/api/public/reporting/laendertabelle
1596996005,29711,20320,9391,236,135,https://www.intensivregister.de/api/public/reporting/laendertabelle
1596999605,29618,20264,9354,235,135,https://www.intensivregister.de/api/public/reporting/laendertabelle
1597003205,29616,20264,9352,235,135,https://www.intensivregister.de/api/public/reporting/laendertabelle
1597006805,29616,20259,9357,235,135,https://www.intensivregister.de/api/public/reporting/laendertabelle
1597010405,29582,20241,9341,235,135,https://www.intensivregister.de/api/public/reporting/laendertabelle
1597014005,29576,20237,9339,235,135,https://www.intensivregister.de/api/public/reporting/laendertabelle
1597017605,29565,20231,9334,235,135,https://www.intensivregister.de/api/public/reporting/laendertabelle
1597021205,29494,20179,9315,235,135,https://www.intensivregister.de/api/public/reporting/laendertabelle
1597024805,29568,20240,9328,235,135,https://www.intensivregister.de/api/public/reporting/laendertabelle
1597028406,29621,20268,9353,234,135,https://www.intensivregister.de/api/public/reporting/laendertabelle
1597032006,29728,20403,9325,234,133,https://www.intensivregister.de/api/public/reporting/laendertabelle
1597035606,30043,20641,9402,233,131,https://www.intensivregister.de/api/public/reporting/laendertabelle
1597039206,30148,20698,9450,227,131,https://www.intensivregister.de/api/public/reporting/laendertabelle
1597042806,30174,20744,9430,231,131,https://www.intensivregister.de/api/public/reporting/laendertabelle
1597046406,30230,20792,9438,229,131,https://www.intensivregister.de/api/public/reporting/laendertabelle
1597050007,30243,20794,9449,228,132,https://www.intensivregister.de/api/public/reporting/laendertabelle
1597053606,30252,20801,9451,228,132,https://www.intensivregister.de/api/public/reporting/laendertabelle
1597057205,30281,20822,9459,228,132,https://www.intensivregister.de/api/public/reporting/laendertabelle
1597060805,30281,20827,9454,228,132,https://www.intensivregister.de/api/public/reporting/laendertabelle
1597064405,30281,20818,9463,228,132,https://www.intensivregister.de/api/public/reporting/laendertabelle
1597068006,30293,20830,9463,228,132,https://www.intensivregister.de/api/public/reporting/laendertabelle
1597071605,30327,20863,9464,228,132,https://www.intensivregister.de/api/public/reporting/laendertabelle
1597078805,30327,20865,9462,228,132,https://www.intensivregister.de/api/public/reporting/laendertabelle
1597082405,30301,20850,9451,226,130,https://www.intensivregister.de/api/public/reporting/laendertabelle
1597089605,30289,20838,9451,226,130,https://www.intensivregister.de/api/public/reporting/laendertabelle
1597093205,30303,20845,9458,226,130,https://www.intensivregister.de/api/public/reporting/laendertabelle
1597096808,30303,20839,9464,226,130,https://www.intensivregister.de/api/public/reporting/laendertabelle
1597100405,30299,20837,9462,226,130,https://www.intensivregister.de/api/public/reporting/laendertabelle
1597104005,30299,20844,9455,226,130,https://www.intensivregister.de/api/public/reporting/laendertabelle
1597107605,30299,20846,9453,226,130,https://www.intensivregister.de/api/public/reporting/laendertabelle
1597111205,30299,20843,9456,226,130,https://www.intensivregister.de/api/public/reporting/laendertabelle
1597114805,30294,20904,9390,230,131,https://www.intensivregister.de/api/public/reporting/laendertabelle
1597118405,30331,21055,9276,235,136,https://www.intensivregister.de/api/public/reporting/laendertabelle
1597122006,30377,21342,9035,235,139,https://www.intensivregister.de/api/public/reporting/laendertabelle
1597125605,30393,21440,8953,235,139,https://www.intensivregister.de/api/public/reporting/laendertabelle
1597129206,30422,21551,8871,234,139,https://www.intensivregister.de/api/public/reporting/laendertabelle
1597132806,30387,21565,8822,234,139,https://www.intensivregister.de/api/public/reporting/laendertabelle
1597136405,30390,21554,8836,233,139,https://www.intensivregister.de/api/public/reporting/laendertabelle
1597140006,30390,21545,8845,232,139,https://www.intensivregister.de/api/public/reporting/laendertabelle
1597143606,30386,21543,8843,232,139,https://www.intensivregister.de/api/public/reporting/laendertabelle
1597147205,30386,21544,8842,233,139,https://www.intensivregister.de/api/public/reporting/laendertabelle
1597150806,30380,21538,8842,233,139,https://www.intensivregister.de/api/public/reporting/laendertabelle
1597154406,30380,21535,8845,233,139,https://www.intensivregister.de/api/public/reporting/laendertabelle
1597158005,30380,21531,8849,233,139,https://www.intensivregister.de/api/public/reporting/laendertabelle
1597161605,30350,21514,8836,233,139,https://www.intensivregister.de/api/public/reporting/laendertabelle
1597165205,30314,21486,8828,233,139,https://www.intensivregister.de/api/public/reporting/laendertabelle
1597168805,30314,21489,8825,233,139,https://www.intensivregister.de/api/public/reporting/laendertabelle
1597172405,30290,21476,8814,233,139,https://www.intensivregister.de/api/public/reporting/laendertabelle
1597179605,30290,21472,8818,233,139,https://www.intensivregister.de/api/public/reporting/laendertabelle
1597183205,30294,21474,8820,234,140,https://www.intensivregister.de/api/public/reporting/laendertabelle
1597186805,30296,21471,8825,234,140,https://www.intensivregister.de/api/public/reporting/laendertabelle
1597190405,30297,21486,8811,234,140,https://www.intensivregister.de/api/public/reporting/laendertabelle
1597194005,30300,21489,8811,234,140,https://www.intensivregister.de/api/public/reporting/laendertabelle
1597197605,30265,21474,8791,234,140,https://www.intensivregister.de/api/public/reporting/laendertabelle
1597201206,30269,21454,8815,234,141,https://www.intensivregister.de/api/public/reporting/laendertabelle
1597204805,30329,21543,8786,228,138,https://www.intensivregister.de/api/public/reporting/laendertabelle
1597208406,30336,21620,8716,232,140,https://www.intensivregister.de/api/public/reporting/laendertabelle
1597212006,30360,21672,8688,227,140,https://www.intensivregister.de/api/public/reporting/laendertabelle
1597215606,30398,21675,8723,225,138,https://www.intensivregister.de/api/public/reporting/laendertabelle
1597219206,30428,21714,8714,226,138,https://www.intensivregister.de/api/public/reporting/laendertabelle
1597222808,30451,21718,8733,225,138,https://www.intensivregister.de/api/public/reporting/laendertabelle
1597226406,30486,21744,8742,225,138,https://www.intensivregister.de/api/public/reporting/laendertabelle
1597230007,30486,21740,8746,225,138,https://www.intensivregister.de/api/public/reporting/laendertabelle
1597233606,30481,21741,8740,226,139,https://www.intensivregister.de/api/public/reporting/laendertabelle
1597237205,30481,21742,8739,226,139,https://www.intensivregister.de/api/public/reporting/laendertabelle
1597240805,30478,21742,8736,228,139,https://www.intensivregister.de/api/public/reporting/laendertabelle
1597244405,30473,21744,8729,229,139,https://www.intensivregister.de/api/public/reporting/laendertabelle
1597248005,30439,21719,8720,229,139,https://www.intensivregister.de/api/public/reporting/laendertabelle
1597251605,30439,21713,8726,229,139,https://www.intensivregister.de/api/public/reporting/laendertabelle
1597255205,30407,21704,8703,228,138,https://www.intensivregister.de/api/public/reporting/laendertabelle
1597262405,30407,21705,8702,228,138,https://www.intensivregister.de/api/public/reporting/laendertabelle
1597266005,30407,21702,8705,228,138,https://www.intensivregister.de/api/public/reporting/laendertabelle
1597269605,30407,21709,8698,228,138,https://www.intensivregister.de/api/public/reporting/laendertabelle
1597273205,30407,21712,8695,228,138,https://www.intensivregister.de/api/public/reporting/laendertabelle
1597276805,30388,21695,8693,227,137,https://www.intensivregister.de/api/public/reporting/laendertabelle
1597280405,30388,21699,8689,227,137,https://www.intensivregister.de/api/public/reporting/laendertabelle
1597284005,30385,21696,8689,227,137,https://www.intensivregister.de/api/public/reporting/laendertabelle
1597287605,30375,21707,8668,229,138,https://www.intensivregister.de/api/public/reporting/laendertabelle
1597291206,30427,21747,8680,227,138,https://www.intensivregister.de/api/public/reporting/laendertabelle
1597294806,30436,21761,8675,228,139,https://www.intensivregister.de/api/public/reporting/laendertabelle
1597298405,30430,21784,8646,224,137,https://www.intensivregister.de/api/public/reporting/laendertabelle
1597302005,30421,21822,8599,225,137,https://www.intensivregister.de/api/public/reporting/laendertabelle
1597305606,30389,21829,8560,223,137,https://www.intensivregister.de/api/public/reporting/laendertabelle
1597309206,30387,21810,8577,224,137,https://www.intensivregister.de/api/public/reporting/laendertabelle
1597312806,30387,21805,8582,224,137,https://www.intensivregister.de/api/public/reporting/laendertabelle
1597316406,30384,21808,8576,225,137,https://www.intensivregister.de/api/public/reporting/laendertabelle
1597320006,30389,21813,8576,224,137,https://www.intensivregister.de/api/public/reporting/laendertabelle
1597323605,30389,21814,8575,223,137,https://www.intensivregister.de/api/public/reporting/laendertabelle
1597327205,30426,21847,8579,223,137,https://www.intensivregister.de/api/public/reporting/laendertabelle
1597330805,30416,21841,8575,223,137,https://www.intensivregister.de/api/public/reporting/laendertabelle
1597334405,30402,21830,8572,223,137,https://www.intensivregister.de/api/public/reporting/laendertabelle
1597338007,30402,21832,8570,223,137,https://www.intensivregister.de/api/public/reporting/laendertabelle
1597341605,30381,21818,8563,223,137,https://www.intensivregister.de/api/public/reporting/laendertabelle
1597345207,30367,21810,8557,222,136,https://www.intensivregister.de/api/public/reporting/laendertabelle
1597348805,30340,21796,8544,222,136,https://www.intensivregister.de/api/public/reporting/laendertabelle
1597352405,30339,21790,8549,222,136,https://www.intensivregister.de/api/public/reporting/laendertabelle
1597359605,30339,21787,8552,222,136,https://www.intensivregister.de/api/public/reporting/laendertabelle
1597363205,30339,21789,8550,222,136,https://www.intensivregister.de/api/public/reporting/laendertabelle
1597366805,30339,21793,8546,222,136,https://www.intensivregister.de/api/public/reporting/laendertabelle
1597370405,30349,21800,8549,222,136,https://www.intensivregister.de/api/public/reporting/laendertabelle
1597374006,30381,21846,8535,220,136,https://www.intensivregister.de/api/public/reporting/laendertabelle
1597377606,30378,21848,8530,224,136,https://www.intensivregister.de/api/public/reporting/laendertabelle
1597381206,30395,21882,8513,227,132,https://www.intensivregister.de/api/public/reporting/laendertabelle
1597384806,30442,21956,8486,230,135,https://www.intensivregister.de/api/public/reporting/laendertabelle
1597388405,30478,21942,8536,235,135,https://www.intensivregister.de/api/public/reporting/laendertabelle
1597392005,30502,21982,8520,232,134,https://www.intensivregister.de/api/public/reporting/laendertabelle
1597395606,30532,22005,8527,232,134,https://www.intensivregister.de/api/public/reporting/laendertabelle
1597399206,30562,22042,8520,231,134,https://www.intensivregister.de/api/public/reporting/laendertabelle
1597402806,30562,22039,8523,230,134,https://www.intensivregister.de/api/public/reporting/laendertabelle
1597406406,30561,22026,8535,230,134,https://www.intensivregister.de/api/public/reporting/laendertabelle
1597410006,30561,22023,8538,230,134,https://www.intensivregister.de/api/public/reporting/laendertabelle
1597413606,30561,22024,8537,231,134,https://www.intensivregister.de/api/public/reporting/laendertabelle
1597417205,30561,22023,8538,231,134,https://www.intensivregister.de/api/public/reporting/laendertabelle
1597420805,30551,22019,8532,231,134,https://www.intensivregister.de/api/public/reporting/laendertabelle
1597424405,30544,22017,8527,231,134,https://www.intensivregister.de/api/public/reporting/laendertabelle
1597428005,30500,21982,8518,231,134,https://www.intensivregister.de/api/public/reporting/laendertabelle
1597435205,30471,21963,8508,231,134,https://www.intensivregister.de/api/public/reporting/laendertabelle
1597438805,30455,21954,8501,231,134,https://www.intensivregister.de/api/public/reporting/laendertabelle
1597442405,30453,21953,8500,231,134,https://www.intensivregister.de/api/public/reporting/laendertabelle
1597446005,30453,21958,8495,231,134,https://www.intensivregister.de/api/public/reporting/laendertabelle
1597449605,30448,21959,8489,231,134,https://www.intensivregister.de/api/public/reporting/laendertabelle
1597453205,30448,21957,8491,231,134,https://www.intensivregister.de/api/public/reporting/laendertabelle
1597456805,30444,21955,8489,231,134,https://www.intensivregister.de/api/public/reporting/laendertabelle
1597460405,30438,21931,8507,234,135,https://www.intensivregister.de/api/public/reporting/laendertabelle
1597464005,30390,21855,8535,228,134,https://www.intensivregister.de/api/public/reporting/laendertabelle
1597467605,30390,21810,8580,224,132,https://www.intensivregister.de/api/public/reporting/laendertabelle
1597471205,30380,21695,8685,223,131,https://www.intensivregister.de/api/public/reporting/laendertabelle
1597474805,30368,21646,8722,227,133,https://www.intensivregister.de/api/public/reporting/laendertabelle
1597478405,30374,21638,8736,229,135,https://www.intensivregister.de/api/public/reporting/laendertabelle
1597482005,30393,21650,8743,228,134,https://www.intensivregister.de/api/public/reporting/laendertabelle
1597485606,30360,21615,8745,228,134,https://www.intensivregister.de/api/public/reporting/laendertabelle
1597489206,30360,21605,8755,228,134,https://www.intensivregister.de/api/public/reporting/laendertabelle
1597492805,30367,21614,8753,229,134,https://www.intensivregister.de/api/public/reporting/laendertabelle
1597496405,30374,21614,8760,229,134,https://www.intensivregister.de/api/public/reporting/laendertabelle
1597507205,30365,21607,8758,229,134,https://www.intensivregister.de/api/public/reporting/laendertabelle
1597510805,30353,21594,8759,229,134,https://www.intensivregister.de/api/public/reporting/laendertabelle
1597514405,30317,21579,8738,229,134,https://www.intensivregister.de/api/public/reporting/laendertabelle
1597518006,30315,21576,8739,229,134,https://www.intensivregister.de/api/public/reporting/laendertabelle
1597521605,30290,21558,8732,227,133,https://www.intensivregister.de/api/public/reporting/laendertabelle
1597525206,30254,21527,8727,227,133,https://www.intensivregister.de/api/public/reporting/laendertabelle
1597528805,30256,21526,8730,227,133,https://www.intensivregister.de/api/public/reporting/laendertabelle
1597532405,30256,21524,8732,227,133,https://www.intensivregister.de/api/public/reporting/laendertabelle
1597536005,30252,21523,8729,228,134,https://www.intensivregister.de/api/public/reporting/laendertabelle
1597543205,30218,21490,8728,228,134,https://www.intensivregister.de/api/public/reporting/laendertabelle
1597546805,30215,21473,8742,225,134,https://www.intensivregister.de/api/public/reporting/laendertabelle
1597550405,30221,21397,8824,225,132,https://www.intensivregister.de/api/public/reporting/laendertabelle
1597554005,30226,21266,8960,226,134,https://www.intensivregister.de/api/public/reporting/laendertabelle
1597557605,30208,21174,9034,222,132,https://www.intensivregister.de/api/public/reporting/laendertabelle
1597561205,30214,21143,9071,224,133,https://www.intensivregister.de/api/public/reporting/laendertabelle
1597564805,30217,21046,9171,225,135,https://www.intensivregister.de/api/public/reporting/laendertabelle
1597568405,30225,21053,9172,224,134,https://www.intensivregister.de/api/public/reporting/laendertabelle
1597572005,30235,21065,9170,225,134,https://www.intensivregister.de/api/public/reporting/laendertabelle
1597575605,30246,21071,9175,224,134,https://www.intensivregister.de/api/public/reporting/laendertabelle
1597579205,30246,21063,9183,224,134,https://www.intensivregister.de/api/public/reporting/laendertabelle
1597582805,30263,21077,9186,224,134,https://www.intensivregister.de/api/public/reporting/laendertabelle
1597586405,30260,21075,9185,224,133,https://www.intensivregister.de/api/public/reporting/laendertabelle
1597590005,30204,21049,9155,225,133,https://www.intensivregister.de/api/public/reporting/laendertabelle
1597593605,29940,20849,9091,225,133,https://www.intensivregister.de/api/public/reporting/laendertabelle
1597597205,29725,20688,9037,223,133,https://www.intensivregister.de/api/public/reporting/laendertabelle
1597600805,29628,20618,9010,223,133,https://www.intensivregister.de/api/public/reporting/laendertabelle
1597604405,29538,20574,8964,223,133,https://www.intensivregister.de/api/public/reporting/laendertabelle
1597608005,29456,20521,8935,223,133,https://www.intensivregister.de/api/public/reporting/laendertabelle
1597611605,29391,20459,8932,224,133,https://www.intensivregister.de/api/public/reporting/laendertabelle
1597615205,29349,20436,8913,225,133,https://www.intensivregister.de/api/public/reporting/laendertabelle
1597618805,29347,20435,8912,225,133,https://www.intensivregister.de/api/public/reporting/laendertabelle
1597622405,29346,20436,8910,225,133,https://www.intensivregister.de/api/public/reporting/laendertabelle
1597626005,29340,20430,8910,225,133,https://www.intensivregister.de/api/public/reporting/laendertabelle
1597629605,29352,20448,8904,225,133,https://www.intensivregister.de/api/public/reporting/laendertabelle
1597633205,29424,20505,8919,226,134,https://www.intensivregister.de/api/public/reporting/laendertabelle
1597636806,29700,20692,9008,225,134,https://www.intensivregister.de/api/public/reporting/laendertabelle
1597640405,29893,20730,9163,226,135,https://www.intensivregister.de/api/public/reporting/laendertabelle
1597644006,30108,20932,9176,223,133,https://www.intensivregister.de/api/public/reporting/laendertabelle
1597647606,30275,21040,9235,226,133,https://www.intensivregister.de/api/public/reporting/laendertabelle
1597651206,30314,21078,9236,228,134,https://www.intensivregister.de/api/public/reporting/laendertabelle
1597654805,30320,21078,9242,228,134,https://www.intensivregister.de/api/public/reporting/laendertabelle
1597658406,30334,21087,9247,228,134,https://www.intensivregister.de/api/public/reporting/laendertabelle
1597662006,30347,21088,9259,228,134,https://www.intensivregister.de/api/public/reporting/laendertabelle
1597665605,30371,21093,9278,227,134,https://www.intensivregister.de/api/public/reporting/laendertabelle
1597669205,30393,21112,9281,227,134,https://www.intensivregister.de/api/public/reporting/laendertabelle
1597672805,30427,21140,9287,227,134,https://www.intensivregister.de/api/public/reporting/laendertabelle
1597680005,30427,21140,9287,226,134,https://www.intensivregister.de/api/public/reporting/laendertabelle
1597683605,30451,21147,9304,226,134,https://www.intensivregister.de/api/public/reporting/laendertabelle
1597687206,30451,21147,9304,225,134,https://www.intensivregister.de/api/public/reporting/laendertabelle
1597690805,30433,21138,9295,225,134,https://www.intensivregister.de/api/public/reporting/laendertabelle
1597694405,30423,21132,9291,225,134,https://www.intensivregister.de/api/public/reporting/laendertabelle
1597698005,30415,21132,9283,225,134,https://www.intensivregister.de/api/public/reporting/laendertabelle
1597701605,30401,21121,9280,224,134,https://www.intensivregister.de/api/public/reporting/laendertabelle
1597705205,30401,21118,9283,224,134,https://www.intensivregister.de/api/public/reporting/laendertabelle
1597708805,30401,21116,9285,224,134,https://www.intensivregister.de/api/public/reporting/laendertabelle
1597712405,30401,21120,9281,224,134,https://www.intensivregister.de/api/public/reporting/laendertabelle
1597716005,30402,21131,9271,224,134,https://www.intensivregister.de/api/public/reporting/laendertabelle
1597719606,30435,21192,9243,226,134,https://www.intensivregister.de/api/public/reporting/laendertabelle
1597723205,30457,21356,9101,227,137,https://www.intensivregister.de/api/public/reporting/laendertabelle
1597726807,30495,21507,8988,232,137,https://www.intensivregister.de/api/public/reporting/laendertabelle
1597730407,30529,21602,8927,233,139,https://www.intensivregister.de/api/public/reporting/laendertabelle
1597734006,30569,21684,8885,229,136,https://www.intensivregister.de/api/public/reporting/laendertabelle
1597737606,30565,21706,8859,227,135,https://www.intensivregister.de/api/public/reporting/laendertabelle
1597741205,30582,21710,8872,228,135,https://www.intensivregister.de/api/public/reporting/laendertabelle
1597744806,30582,21717,8865,229,135,https://www.intensivregister.de/api/public/reporting/laendertabelle
1597748405,30588,21720,8868,229,135,https://www.intensivregister.de/api/public/reporting/laendertabelle
1597752005,30606,21732,8874,229,136,https://www.intensivregister.de/api/public/reporting/laendertabelle
1597755605,30606,21733,8873,229,136,https://www.intensivregister.de/api/public/reporting/laendertabelle
1597759205,30630,21759,8871,228,136,https://www.intensivregister.de/api/public/reporting/laendertabelle
1597762805,30630,21760,8870,228,136,https://www.intensivregister.de/api/public/reporting/laendertabelle
1597766405,30620,21753,8867,228,136,https://www.intensivregister.de/api/public/reporting/laendertabelle
1597770005,30606,21748,8858,228,136,https://www.intensivregister.de/api/public/reporting/laendertabelle
1597777205,30582,21730,8852,228,136,https://www.intensivregister.de/api/public/reporting/laendertabelle
1597780805,30561,21710,8851,226,134,https://www.intensivregister.de/api/public/reporting/laendertabelle
1597784405,30566,21709,8857,225,134,https://www.intensivregister.de/api/public/reporting/laendertabelle
1597791605,30555,21703,8852,225,134,https://www.intensivregister.de/api/public/reporting/laendertabelle
1597795205,30555,21702,8853,225,134,https://www.intensivregister.de/api/public/reporting/laendertabelle
1597798805,30543,21698,8845,225,134,https://www.intensivregister.de/api/public/reporting/laendertabelle
1597802405,30543,21700,8843,224,133,https://www.intensivregister.de/api/public/reporting/laendertabelle
1597806005,30544,21703,8841,226,135,https://www.intensivregister.de/api/public/reporting/laendertabelle
1597809605,30556,21720,8836,231,135,https://www.intensivregister.de/api/public/reporting/laendertabelle
1597813206,30587,21856,8731,234,140,https://www.intensivregister.de/api/public/reporting/laendertabelle
1597816806,30587,21865,8722,228,141,https://www.intensivregister.de/api/public/reporting/laendertabelle
1597820407,30617,21872,8745,230,141,https://www.intensivregister.de/api/public/reporting/laendertabelle
1597824006,30625,21891,8734,228,142,https://www.intensivregister.de/api/public/reporting/laendertabelle
1597827605,30627,21896,8731,228,142,https://www.intensivregister.de/api/public/reporting/laendertabelle
1597831206,30629,21891,8738,229,142,https://www.intensivregister.de/api/public/reporting/laendertabelle
1597834806,30630,21885,8745,229,142,https://www.intensivregister.de/api/public/reporting/laendertabelle
1597838406,30627,21887,8740,231,142,https://www.intensivregister.de/api/public/reporting/laendertabelle
1597842006,30627,21888,8739,231,142,https://www.intensivregister.de/api/public/reporting/laendertabelle
1597845605,30627,21892,8735,231,142,https://www.intensivregister.de/api/public/reporting/laendertabelle
1597849205,30627,21890,8737,231,142,https://www.intensivregister.de/api/public/reporting/laendertabelle
1597852805,30618,21883,8735,231,142,https://www.intensivregister.de/api/public/reporting/laendertabelle
1597856405,30582,21854,8728,230,141,https://www.intensivregister.de/api/public/reporting/laendertabelle
1597860005,30514,21822,8692,230,141,https://www.intensivregister.de/api/public/reporting/laendertabelle
1597863605,30500,21810,8690,230,141,https://www.intensivregister.de/api/public/reporting/laendertabelle
1597867205,30490,21806,8684,230,141,https://www.intensivregister.de/api/public/reporting/laendertabelle
1597870805,30458,21779,8679,230,141,https://www.intensivregister.de/api/public/reporting/laendertabelle
1597874405,30458,21782,8676,230,141,https://www.intensivregister.de/api/public/reporting/laendertabelle
1597878005,30445,21769,8676,230,141,https://www.intensivregister.de/api/public/reporting/laendertabelle
1597881605,30445,21770,8675,230,141,https://www.intensivregister.de/api/public/reporting/laendertabelle
1597885205,30445,21768,8677,230,141,https://www.intensivregister.de/api/public/reporting/laendertabelle
1597888805,30430,21740,8690,230,141,https://www.intensivregister.de/api/public/reporting/laendertabelle
1597892405,30431,21757,8674,232,139,https://www.intensivregister.de/api/public/reporting/laendertabelle
1597896007,30433,21778,8655,224,136,https://www.intensivregister.de/api/public/reporting/laendertabelle
1597899605,30575,21939,8636,223,136,https://www.intensivregister.de/api/public/reporting/laendertabelle
1597903206,30591,21986,8605,229,136,https://www.intensivregister.de/api/public/reporting/laendertabelle
1597906805,30673,22043,8630,230,138,https://www.intensivregister.de/api/public/reporting/laendertabelle
1597910406,30674,22015,8659,231,137,https://www.intensivregister.de/api/public/reporting/laendertabelle
1597914006,30670,22015,8655,231,137,https://www.intensivregister.de/api/public/reporting/laendertabelle
1597917605,30670,22015,8655,233,139,https://www.intensivregister.de/api/public/reporting/laendertabelle
1597921207,30680,22021,8659,233,139,https://www.intensivregister.de/api/public/reporting/laendertabelle
1597924806,30680,22024,8656,234,139,https://www.intensivregister.de/api/public/reporting/laendertabelle
1597928405,30704,22034,8670,234,140,https://www.intensivregister.de/api/public/reporting/laendertabelle
1597932006,30704,22030,8674,234,140,https://www.intensivregister.de/api/public/reporting/laendertabelle
1597935605,30690,22015,8675,234,140,https://www.intensivregister.de/api/public/reporting/laendertabelle
1597939205,30506,21853,8653,229,135,https://www.intensivregister.de/api/public/reporting/laendertabelle
1597942805,30506,21864,8642,229,135,https://www.intensivregister.de/api/public/reporting/laendertabelle
1597946405,30481,21841,8640,230,135,https://www.intensivregister.de/api/public/reporting/laendertabelle
1597950005,30471,21831,8640,230,135,https://www.intensivregister.de/api/public/reporting/laendertabelle
1597953605,30452,21813,8639,230,135,https://www.intensivregister.de/api/public/reporting/laendertabelle
1597957205,30423,21792,8631,230,135,https://www.intensivregister.de/api/public/reporting/laendertabelle
1597960805,30423,21789,8634,230,135,https://www.intensivregister.de/api/public/reporting/laendertabelle
1597964405,30398,21777,8621,230,135,https://www.intensivregister.de/api/public/reporting/laendertabelle
1597968005,30398,21780,8618,230,135,https://www.intensivregister.de/api/public/reporting/laendertabelle
1597971605,30394,21780,8614,230,135,https://www.intensivregister.de/api/public/reporting/laendertabelle
1597975205,30397,21776,8621,230,135,https://www.intensivregister.de/api/public/reporting/laendertabelle
1597978805,30402,21784,8618,228,136,https://www.intensivregister.de/api/public/reporting/laendertabelle
1597982405,30384,21775,8609,230,137,https://www.intensivregister.de/api/public/reporting/laendertabelle
1597986006,30581,21958,8623,233,141,https://www.intensivregister.de/api/public/reporting/laendertabelle
1597989606,30576,21943,8633,234,143,https://www.intensivregister.de/api/public/reporting/laendertabelle
1597993206,30589,21952,8637,233,143,https://www.intensivregister.de/api/public/reporting/laendertabelle
1597996806,30610,21964,8646,236,144,https://www.intensivregister.de/api/public/reporting/laendertabelle
1598000406,30621,21962,8659,236,144,https://www.intensivregister.de/api/public/reporting/laendertabelle
1598004006,30672,22002,8670,237,144,https://www.intensivregister.de/api/public/reporting/laendertabelle
1598007606,30667,21993,8674,237,144,https://www.intensivregister.de/api/public/reporting/laendertabelle
1598011206,30667,21983,8684,237,144,https://www.intensivregister.de/api/public/reporting/laendertabelle
1598014806,30667,21988,8679,237,144,https://www.intensivregister.de/api/public/reporting/laendertabelle
1598022006,30665,21986,8679,237,144,https://www.intensivregister.de/api/public/reporting/laendertabelle
1598025605,30655,21976,8679,237,144,https://www.intensivregister.de/api/public/reporting/laendertabelle
1598029206,30658,21981,8677,237,144,https://www.intensivregister.de/api/public/reporting/laendertabelle
1598032805,30627,21963,8664,237,144,https://www.intensivregister.de/api/public/reporting/laendertabelle
1598040005,30624,21967,8657,237,144,https://www.intensivregister.de/api/public/reporting/laendertabelle
1598043605,30624,21971,8653,237,144,https://www.intensivregister.de/api/public/reporting/laendertabelle
1598047205,30593,21957,8636,237,144,https://www.intensivregister.de/api/public/reporting/laendertabelle
1598050805,30594,21957,8637,237,144,https://www.intensivregister.de/api/public/reporting/laendertabelle
1598058005,30560,21955,8605,237,144,https://www.intensivregister.de/api/public/reporting/laendertabelle
1598061605,30560,21939,8621,237,144,https://www.intensivregister.de/api/public/reporting/laendertabelle
1598065205,30551,21931,8620,237,144,https://www.intensivregister.de/api/public/reporting/laendertabelle
1598068805,30552,21853,8699,235,143,https://www.intensivregister.de/api/public/reporting/laendertabelle
1598072405,30521,21681,8840,240,142,https://www.intensivregister.de/api/public/reporting/laendertabelle
1598076005,30477,21567,8910,239,140,https://www.intensivregister.de/api/public/reporting/laendertabelle
1598079605,30444,21536,8908,236,139,https://www.intensivregister.de/api/public/reporting/laendertabelle
1598083205,30443,21550,8893,234,140,https://www.intensivregister.de/api/public/reporting/laendertabelle
1598086805,30438,21516,8922,234,140,https://www.intensivregister.de/api/public/reporting/laendertabelle
1598090405,30464,21516,8948,234,140,https://www.intensivregister.de/api/public/reporting/laendertabelle
1598094005,30459,21509,8950,234,140,https://www.intensivregister.de/api/public/reporting/laendertabelle
1598097605,30459,21495,8964,234,140,https://www.intensivregister.de/api/public/reporting/laendertabelle
1598101205,30459,21491,8968,234,140,https://www.intensivregister.de/api/public/reporting/laendertabelle
1598104805,30459,21485,8974,234,140,https://www.intensivregister.de/api/public/reporting/laendertabelle
1598108405,30455,21492,8963,234,140,https://www.intensivregister.de/api/public/reporting/laendertabelle
1598112005,30434,21476,8958,234,140,https://www.intensivregister.de/api/public/reporting/laendertabelle
1598115605,30413,21458,8955,234,140,https://www.intensivregister.de/api/public/reporting/laendertabelle
1598119205,30417,21460,8957,234,140,https://www.intensivregister.de/api/public/reporting/laendertabelle
1598122805,30403,21448,8955,234,140,https://www.intensivregister.de/api/public/reporting/laendertabelle
1598126405,30383,21436,8947,234,140,https://www.intensivregister.de/api/public/reporting/laendertabelle
1598130005,30366,21429,8937,233,139,https://www.intensivregister.de/api/public/reporting/laendertabelle
1598133605,30272,21345,8927,229,138,https://www.intensivregister.de/api/public/reporting/laendertabelle
1598137205,30271,21338,8933,229,138,https://www.intensivregister.de/api/public/reporting/laendertabelle
1598144405,30248,21322,8926,229,138,https://www.intensivregister.de/api/public/reporting/laendertabelle
1598148005,30248,21312,8936,229,138,https://www.intensivregister.de/api/public/reporting/laendertabelle
1598151605,30248,21308,8940,230,137,https://www.intensivregister.de/api/public/reporting/laendertabelle
1598155205,30244,21242,9002,232,137,https://www.intensivregister.de/api/public/reporting/laendertabelle
1598158805,30305,21191,9114,235,138,https://www.intensivregister.de/api/public/reporting/laendertabelle
1598162405,30284,21047,9237,240,140,https://www.intensivregister.de/api/public/reporting/laendertabelle
1598166006,30272,20972,9300,243,138,https://www.intensivregister.de/api/public/reporting/laendertabelle
1598169605,30278,20947,9331,245,136,https://www.intensivregister.de/api/public/reporting/laendertabelle
1598173207,30273,20934,9339,245,136,https://www.intensivregister.de/api/public/reporting/laendertabelle
1598176805,30271,20926,9345,245,136,https://www.intensivregister.de/api/public/reporting/laendertabelle
1598180405,30271,20924,9347,245,136,https://www.intensivregister.de/api/public/reporting/laendertabelle
1598184005,30273,20917,9356,246,137,https://www.intensivregister.de/api/public/reporting/laendertabelle
1598187605,30273,20910,9363,245,136,https://www.intensivregister.de/api/public/reporting/laendertabelle
1598191205,30273,20907,9366,245,136,https://www.intensivregister.de/api/public/reporting/laendertabelle
1598194805,30226,20862,9364,245,136,https://www.intensivregister.de/api/public/reporting/laendertabelle
1598198405,30034,20712,9322,243,135,https://www.intensivregister.de/api/public/reporting/laendertabelle
1598202005,29837,20574,9263,243,135,https://www.intensivregister.de/api/public/reporting/laendertabelle
1598205605,29751,20512,9239,242,134,https://www.intensivregister.de/api/public/reporting/laendertabelle
1598209205,29590,20388,9202,242,134,https://www.intensivregister.de/api/public/reporting/laendertabelle
1598212805,29543,20361,9182,242,134,https://www.intensivregister.de/api/public/reporting/laendertabelle
1598216405,29499,20338,9161,241,134,https://www.intensivregister.de/api/public/reporting/laendertabelle
1598220005,29468,20314,9154,241,134,https://www.intensivregister.de/api/public/reporting/laendertabelle
1598223605,29461,20306,9155,241,134,https://www.intensivregister.de/api/public/reporting/laendertabelle
1598227205,29458,20301,9157,241,134,https://www.intensivregister.de/api/public/reporting/laendertabelle
1598230806,29460,20299,9161,241,134,https://www.intensivregister.de/api/public/reporting/laendertabelle
1598234405,29464,20302,9162,241,134,https://www.intensivregister.de/api/public/reporting/laendertabelle
1598238005,29490,20310,9180,239,133,https://www.intensivregister.de/api/public/reporting/laendertabelle
1598241606,29716,20430,9286,238,131,https://www.intensivregister.de/api/public/reporting/laendertabelle
1598245206,29883,20558,9325,240,130,https://www.intensivregister.de/api/public/reporting/laendertabelle
1598248807,30127,20672,9455,247,131,https://www.intensivregister.de/api/public/reporting/laendertabelle
1598252407,30220,20717,9503,245,133,https://www.intensivregister.de/api/public/reporting/laendertabelle
1598256007,30361,20774,9587,245,132,https://www.intensivregister.de/api/public/reporting/laendertabelle
1598259606,30364,20791,9573,245,132,https://www.intensivregister.de/api/public/reporting/laendertabelle
1598263206,30397,20817,9580,244,131,https://www.intensivregister.de/api/public/reporting/laendertabelle
1598266805,30412,20826,9586,244,131,https://www.intensivregister.de/api/public/reporting/laendertabelle
1598270408,30412,20824,9588,244,131,https://www.intensivregister.de/api/public/reporting/laendertabelle
1598274006,30424,20835,9589,244,131,https://www.intensivregister.de/api/public/reporting/laendertabelle
1598277605,30424,20841,9583,244,131,https://www.intensivregister.de/api/public/reporting/laendertabelle
1598281205,30424,20837,9587,244,131,https://www.intensivregister.de/api/public/reporting/laendertabelle
1598284805,30414,20824,9590,244,131,https://www.intensivregister.de/api/public/reporting/laendertabelle
1598288405,30414,20823,9591,244,131,https://www.intensivregister.de/api/public/reporting/laendertabelle
1598295605,30418,20825,9593,244,131,https://www.intensivregister.de/api/public/reporting/laendertabelle
1598302805,30421,20825,9596,244,131,https://www.intensivregister.de/api/public/reporting/laendertabelle
1598306405,30394,20810,9584,244,131,https://www.intensivregister.de/api/public/reporting/laendertabelle
1598310005,30394,20816,9578,244,131,https://www.intensivregister.de/api/public/reporting/laendertabelle
1598317205,30395,20817,9578,244,131,https://www.intensivregister.de/api/public/reporting/laendertabelle
1598320805,30392,20826,9566,244,131,https://www.intensivregister.de/api/public/reporting/laendertabelle
1598324406,30407,20895,9512,240,129,https://www.intensivregister.de/api/public/reporting/laendertabelle
1598328006,30434,20997,9437,238,134,https://www.intensivregister.de/api/public/reporting/laendertabelle
1598331606,30463,21261,9202,227,134,https://www.intensivregister.de/api/public/reporting/laendertabelle
1598335207,30484,21424,9060,220,132,https://www.intensivregister.de/api/public/reporting/laendertabelle
1598338806,30529,21463,9066,220,133,https://www.intensivregister.de/api/public/reporting/laendertabelle
1598342405,30532,21490,9042,223,133,https://www.intensivregister.de/api/public/reporting/laendertabelle
1598346006,30547,21519,9028,223,133,https://www.intensivregister.de/api/public/reporting/laendertabelle
1598349606,30546,21529,9017,223,133,https://www.intensivregister.de/api/public/reporting/laendertabelle
1598353207,30540,21524,9016,223,133,https://www.intensivregister.de/api/public/reporting/laendertabelle
1598356806,30540,21520,9020,223,133,https://www.intensivregister.de/api/public/reporting/laendertabelle
1598360405,30540,21522,9018,223,133,https://www.intensivregister.de/api/public/reporting/laendertabelle
1598364005,30540,21527,9013,223,133,https://www.intensivregister.de/api/public/reporting/laendertabelle
1598371205,30540,21529,9011,223,133,https://www.intensivregister.de/api/public/reporting/laendertabelle
1598374805,30552,21536,9016,223,133,https://www.intensivregister.de/api/public/reporting/laendertabelle
1598378405,30546,21534,9012,223,133,https://www.intensivregister.de/api/public/reporting/laendertabelle
1598382005,30545,21538,9007,224,133,https://www.intensivregister.de/api/public/reporting/laendertabelle
1598385605,30512,21511,9001,224,133,https://www.intensivregister.de/api/public/reporting/laendertabelle
1598389205,30510,21514,8996,224,133,https://www.intensivregister.de/api/public/reporting/laendertabelle
1598392805,30504,21508,8996,224,133,https://www.intensivregister.de/api/public/reporting/laendertabelle
1598396405,30504,21506,8998,224,133,https://www.intensivregister.de/api/public/reporting/laendertabelle
1598400005,30504,21504,9000,224,133,https://www.intensivregister.de/api/public/reporting/laendertabelle
1598403605,30504,21510,8994,225,134,https://www.intensivregister.de/api/public/reporting/laendertabelle
1598407205,30504,21516,8988,225,134,https://www.intensivregister.de/api/public/reporting/laendertabelle
1598410805,30507,21504,9003,224,133,https://www.intensivregister.de/api/public/reporting/laendertabelle
1598414405,30561,21645,8916,223,132,https://www.intensivregister.de/api/public/reporting/laendertabelle
1598418009,30636,21744,8892,228,134,https://www.intensivregister.de/api/public/reporting/laendertabelle
1598421607,30634,21758,8876,228,134,https://www.intensivregister.de/api/public/reporting/laendertabelle
1598425206,30630,21724,8906,227,134,https://www.intensivregister.de/api/public/reporting/laendertabelle
1598428807,30638,21727,8911,228,133,https://www.intensivregister.de/api/public/reporting/laendertabelle
1598432406,30647,21749,8898,228,133,https://www.intensivregister.de/api/public/reporting/laendertabelle
1598436006,30653,21762,8891,228,133,https://www.intensivregister.de/api/public/reporting/laendertabelle
1598439606,30652,21759,8893,228,133,https://www.intensivregister.de/api/public/reporting/laendertabelle
1598443206,30664,21764,8900,228,133,https://www.intensivregister.de/api/public/reporting/laendertabelle
1598446805,30664,21766,8898,228,133,https://www.intensivregister.de/api/public/reporting/laendertabelle
1598450405,30664,21765,8899,228,133,https://www.intensivregister.de/api/public/reporting/laendertabelle
1598454005,30646,21758,8888,228,133,https://www.intensivregister.de/api/public/reporting/laendertabelle
1598457605,30637,21756,8881,228,133,https://www.intensivregister.de/api/public/reporting/laendertabelle
1598464805,30637,21755,8882,228,133,https://www.intensivregister.de/api/public/reporting/laendertabelle
1598468405,30498,21669,8829,228,133,https://www.intensivregister.de/api/public/reporting/laendertabelle
1598472005,30482,21652,8830,228,133,https://www.intensivregister.de/api/public/reporting/laendertabelle
1598475605,30476,21649,8827,228,133,https://www.intensivregister.de/api/public/reporting/laendertabelle
1598482805,30479,21649,8830,228,133,https://www.intensivregister.de/api/public/reporting/laendertabelle
1598486405,30479,21645,8834,228,133,https://www.intensivregister.de/api/public/reporting/laendertabelle
1598490005,30465,21638,8827,228,133,https://www.intensivregister.de/api/public/reporting/laendertabelle
1598493605,30466,21640,8826,228,133,https://www.intensivregister.de/api/public/reporting/laendertabelle
1598497205,30464,21670,8794,230,134,https://www.intensivregister.de/api/public/reporting/laendertabelle
1598500805,30474,21672,8802,234,135,https://www.intensivregister.de/api/public/reporting/laendertabelle
1598504406,30532,21668,8864,238,139,https://www.intensivregister.de/api/public/reporting/laendertabelle
1598508006,30550,21634,8916,240,141,https://www.intensivregister.de/api/public/reporting/laendertabelle
1598511605,30554,21590,8964,243,142,https://www.intensivregister.de/api/public/reporting/laendertabelle
1598515206,30548,21575,8973,242,140,https://www.intensivregister.de/api/public/reporting/laendertabelle
1598518805,30549,21561,8988,241,140,https://www.intensivregister.de/api/public/reporting/laendertabelle
1598522407,30549,21562,8987,241,140,https://www.intensivregister.de/api/public/reporting/laendertabelle
1598526008,30588,21584,9004,241,140,https://www.intensivregister.de/api/public/reporting/laendertabelle
1598529606,30598,21585,9013,241,140,https://www.intensivregister.de/api/public/reporting/laendertabelle
1598533205,30598,21581,9017,241,140,https://www.intensivregister.de/api/public/reporting/laendertabelle
1598536806,30601,21587,9014,241,140,https://www.intensivregister.de/api/public/reporting/laendertabelle
1598544005,30601,21589,9012,241,140,https://www.intensivregister.de/api/public/reporting/laendertabelle
1598547606,30595,21588,9007,241,140,https://www.intensivregister.de/api/public/reporting/laendertabelle
1598551205,30589,21581,9008,241,140,https://www.intensivregister.de/api/public/reporting/laendertabelle
1598562005,30589,21579,9010,241,140,https://www.intensivregister.de/api/public/reporting/laendertabelle
1598565605,30583,21566,9017,242,140,https://www.intensivregister.de/api/public/reporting/laendertabelle
1598569205,30571,21556,9015,242,140,https://www.intensivregister.de/api/public/reporting/laendertabelle
1598572805,30570,21555,9015,242,140,https://www.intensivregister.de/api/public/reporting/laendertabelle
1598576405,30570,21558,9012,242,140,https://www.intensivregister.de/api/public/reporting/laendertabelle
1598580005,30576,21571,9005,242,140,https://www.intensivregister.de/api/public/reporting/laendertabelle
1598583605,30579,21577,9002,241,140,https://www.intensivregister.de/api/public/reporting/laendertabelle
1598587205,30578,21551,9027,239,140,https://www.intensivregister.de/api/public/reporting/laendertabelle
1598590806,30558,21550,9008,237,138,https://www.intensivregister.de/api/public/reporting/laendertabelle
1598594407,30556,21619,8937,236,139,https://www.intensivregister.de/api/public/reporting/laendertabelle
1598598006,30561,21622,8939,238,140,https://www.intensivregister.de/api/public/reporting/laendertabelle
1598601606,30580,21628,8952,236,140,https://www.intensivregister.de/api/public/reporting/laendertabelle
1598605209,30580,21621,8959,237,140,https://www.intensivregister.de/api/public/reporting/laendertabelle
1598608806,30580,21622,8958,237,140,https://www.intensivregister.de/api/public/reporting/laendertabelle
1598612406,30583,21619,8964,237,140,https://www.intensivregister.de/api/public/reporting/laendertabelle
1598616005,30579,21621,8958,237,140,https://www.intensivregister.de/api/public/reporting/laendertabelle
1598619606,30580,21626,8954,237,140,https://www.intensivregister.de/api/public/reporting/laendertabelle
1598623205,30580,21629,8951,237,140,https://www.intensivregister.de/api/public/reporting/laendertabelle
1598626806,30569,21625,8944,237,140,https://www.intensivregister.de/api/public/reporting/laendertabelle
1598630405,30540,21603,8937,237,140,https://www.intensivregister.de/api/public/reporting/laendertabelle
1598634005,30540,21600,8940,237,140,https://www.intensivregister.de/api/public/reporting/laendertabelle
1598637606,30534,21595,8939,237,140,https://www.intensivregister.de/api/public/reporting/laendertabelle
1598641205,30534,21596,8938,237,140,https://www.intensivregister.de/api/public/reporting/laendertabelle
1598644805,30527,21596,8931,237,140,https://www.intensivregister.de/api/public/reporting/laendertabelle
1598648405,30531,21597,8934,237,140,https://www.intensivregister.de/api/public/reporting/laendertabelle
1598652005,30531,21598,8933,237,140,https://www.intensivregister.de/api/public/reporting/laendertabelle
1598655605,30518,21585,8933,237,140,https://www.intensivregister.de/api/public/reporting/laendertabelle
1598659205,30518,21577,8941,237,140,https://www.intensivregister.de/api/public/reporting/laendertabelle
1598662805,30519,21576,8943,237,140,https://www.intensivregister.de/api/public/reporting/laendertabelle
1598666405,30519,21579,8940,236,140,https://www.intensivregister.de/api/public/reporting/laendertabelle
1598670005,30517,21573,8944,237,140,https://www.intensivregister.de/api/public/reporting/laendertabelle
1598673605,30490,21562,8928,238,140,https://www.intensivregister.de/api/public/reporting/laendertabelle
1598677205,30445,21541,8904,242,138,https://www.intensivregister.de/api/public/reporting/laendertabelle
1598680806,30439,21505,8934,242,135,https://www.intensivregister.de/api/public/reporting/laendertabelle
1598684406,30411,21498,8913,241,136,https://www.intensivregister.de/api/public/reporting/laendertabelle
1598688005,30427,21486,8941,241,134,https://www.intensivregister.de/api/public/reporting/laendertabelle
1598691605,30424,21490,8934,243,135,https://www.intensivregister.de/api/public/reporting/laendertabelle
1598695205,30424,21500,8924,243,135,https://www.intensivregister.de/api/public/reporting/laendertabelle
1598698806,30424,21501,8923,243,135,https://www.intensivregister.de/api/public/reporting/laendertabelle
1598702405,30424,21499,8925,243,135,https://www.intensivregister.de/api/public/reporting/laendertabelle
1598706005,30424,21499,8925,242,135,https://www.intensivregister.de/api/public/reporting/laendertabelle
1598709605,30424,21501,8923,242,135,https://www.intensivregister.de/api/public/reporting/laendertabelle
1598713205,30422,21500,8922,243,135,https://www.intensivregister.de/api/public/reporting/laendertabelle
1598716806,30410,21487,8923,243,135,https://www.intensivregister.de/api/public/reporting/laendertabelle
1598720405,30277,21387,8890,243,135,https://www.intensivregister.de/api/public/reporting/laendertabelle
1598724005,30242,21351,8891,242,135,https://www.intensivregister.de/api/public/reporting/laendertabelle
1598727605,30193,21326,8867,241,134,https://www.intensivregister.de/api/public/reporting/laendertabelle
1598731205,30183,21314,8869,241,134,https://www.intensivregister.de/api/public/reporting/laendertabelle
1598734805,30159,21307,8852,242,134,https://www.intensivregister.de/api/public/reporting/laendertabelle
1598738405,30159,21300,8859,242,134,https://www.intensivregister.de/api/public/reporting/laendertabelle
1598742005,30120,21275,8845,242,134,https://www.intensivregister.de/api/public/reporting/laendertabelle
1598745605,30112,21267,8845,242,134,https://www.intensivregister.de/api/public/reporting/laendertabelle
1598749206,30110,21261,8849,241,134,https://www.intensivregister.de/api/public/reporting/laendertabelle
1598752805,30108,21255,8853,241,134,https://www.intensivregister.de/api/public/reporting/laendertabelle
1598756405,30107,21243,8864,243,134,https://www.intensivregister.de/api/public/reporting/laendertabelle
1598760005,30121,21180,8941,244,134,https://www.intensivregister.de/api/public/reporting/laendertabelle
1598763605,30107,21066,9041,244,135,https://www.intensivregister.de/api/public/reporting/laendertabelle
1598767205,30128,20962,9166,243,134,https://www.intensivregister.de/api/public/reporting/laendertabelle
1598770805,30128,20849,9279,244,130,https://www.intensivregister.de/api/public/reporting/laendertabelle
1598774406,30137,20825,9312,244,130,https://www.intensivregister.de/api/public/reporting/laendertabelle
1598778005,30259,20913,9346,244,131,https://www.intensivregister.de/api/public/reporting/laendertabelle
1598781606,30298,20934,9364,244,131,https://www.intensivregister.de/api/public/reporting/laendertabelle
1598785205,30298,20928,9370,244,131,https://www.intensivregister.de/api/public/reporting/laendertabelle
1598792405,30298,20921,9377,245,131,https://www.intensivregister.de/api/public/reporting/laendertabelle
1598796005,30311,20924,9387,245,131,https://www.intensivregister.de/api/public/reporting/laendertabelle
1598799605,30270,20887,9383,245,131,https://www.intensivregister.de/api/public/reporting/laendertabelle
1598803205,30105,20779,9326,246,132,https://www.intensivregister.de/api/public/reporting/laendertabelle
1598806805,29964,20669,9295,244,130,https://www.intensivregister.de/api/public/reporting/laendertabelle
1598810405,29851,20596,9255,243,129,https://www.intensivregister.de/api/public/reporting/laendertabelle
1598814005,29800,20557,9243,240,129,https://www.intensivregister.de/api/public/reporting/laendertabelle
1598817605,29664,20467,9197,240,129,https://www.intensivregister.de/api/public/reporting/laendertabelle
1598821205,29664,20458,9206,239,129,https://www.intensivregister.de/api/public/reporting/laendertabelle
1598824805,29646,20446,9200,239,129,https://www.intensivregister.de/api/public/reporting/laendertabelle
1598828405,29653,20442,9211,239,129,https://www.intensivregister.de/api/public/reporting/laendertabelle
1598832005,29653,20439,9214,240,129,https://www.intensivregister.de/api/public/reporting/laendertabelle
1598835605,29646,20434,9212,240,129,https://www.intensivregister.de/api/public/reporting/laendertabelle
1598839205,29647,20429,9218,240,129,https://www.intensivregister.de/api/public/reporting/laendertabelle
1598842805,29667,20411,9256,238,129,https://www.intensivregister.de/api/public/reporting/laendertabelle
1598846406,29822,20503,9319,235,127,https://www.intensivregister.de/api/public/reporting/laendertabelle
1598850005,30019,20572,9447,236,128,https://www.intensivregister.de/api/public/reporting/laendertabelle
1598853605,30104,20662,9442,238,129,https://www.intensivregister.de/api/public/reporting/laendertabelle
1598857206,30221,20737,9484,242,129,https://www.intensivregister.de/api/public/reporting/laendertabelle
1598860806,30383,20848,9535,244,127,https://www.intensivregister.de/api/public/reporting/laendertabelle
1598864405,30432,20883,9549,246,128,https://www.intensivregister.de/api/public/reporting/laendertabelle
1598868005,30440,20875,9565,246,128,https://www.intensivregister.de/api/public/reporting/laendertabelle
1598871606,30481,20900,9581,246,128,https://www.intensivregister.de/api/public/reporting/laendertabelle
1598875206,30503,20915,9588,247,128,https://www.intensivregister.de/api/public/reporting/laendertabelle
1598878806,30504,20916,9588,247,128,https://www.intensivregister.de/api/public/reporting/laendertabelle
1598882406,30504,20917,9587,248,128,https://www.intensivregister.de/api/public/reporting/laendertabelle
1598886005,30504,20923,9581,248,128,https://www.intensivregister.de/api/public/reporting/laendertabelle
1598889606,30506,20926,9580,248,128,https://www.intensivregister.de/api/public/reporting/laendertabelle
1598893205,30497,20918,9579,248,128,https://www.intensivregister.de/api/public/reporting/laendertabelle
1598896805,30489,20915,9574,248,128,https://www.intensivregister.de/api/public/reporting/laendertabelle
1598900405,30480,20914,9566,248,128,https://www.intensivregister.de/api/public/reporting/laendertabelle
1598907605,30486,20914,9572,248,128,https://www.intensivregister.de/api/public/reporting/laendertabelle
1598911205,30486,20913,9573,248,128,https://www.intensivregister.de/api/public/reporting/laendertabelle
1598914805,30483,20913,9570,248,128,https://www.intensivregister.de/api/public/reporting/laendertabelle
1598918405,30483,20917,9566,248,128,https://www.intensivregister.de/api/public/reporting/laendertabelle
1598922005,30483,20918,9565,248,128,https://www.intensivregister.de/api/public/reporting/laendertabelle
1598925605,30483,20924,9559,248,128,https://www.intensivregister.de/api/public/reporting/laendertabelle
1598929205,30476,20971,9505,247,130,https://www.intensivregister.de/api/public/reporting/laendertabelle
1598932806,30523,21183,9340,241,129,https://www.intensivregister.de/api/public/reporting/laendertabelle
1598936405,30568,21417,9151,239,131,https://www.intensivregister.de/api/public/reporting/laendertabelle
1598940007,30613,21532,9081,239,132,https://www.intensivregister.de/api/public/reporting/laendertabelle
1598943606,30636,21607,9029,237,132,https://www.intensivregister.de/api/public/reporting/laendertabelle
1598947208,30639,21627,9012,235,132,https://www.intensivregister.de/api/public/reporting/laendertabelle
1598950807,30643,21630,9013,233,132,https://www.intensivregister.de/api/public/reporting/laendertabelle
1598954406,30664,21644,9020,233,132,https://www.intensivregister.de/api/public/reporting/laendertabelle
1598958006,30670,21648,9022,233,132,https://www.intensivregister.de/api/public/reporting/laendertabelle
1598961605,30688,21650,9038,233,132,https://www.intensivregister.de/api/public/reporting/laendertabelle
1598965206,30693,21653,9040,233,132,https://www.intensivregister.de/api/public/reporting/laendertabelle
1598968806,30693,21656,9037,234,132,https://www.intensivregister.de/api/public/reporting/laendertabelle
1598976005,30693,21651,9042,234,132,https://www.intensivregister.de/api/public/reporting/laendertabelle
1598979605,30672,21641,9031,234,132,https://www.intensivregister.de/api/public/reporting/laendertabelle
1598986806,30648,21632,9016,233,132,https://www.intensivregister.de/api/public/reporting/laendertabelle
1598990405,30648,21633,9015,233,132,https://www.intensivregister.de/api/public/reporting/laendertabelle
1598994005,30645,21641,9004,233,132,https://www.intensivregister.de/api/public/reporting/laendertabelle
1598997605,30649,21645,9004,233,132,https://www.intensivregister.de/api/public/reporting/laendertabelle
1599001205,30649,21641,9008,233,132,https://www.intensivregister.de/api/public/reporting/laendertabelle
1599004805,30649,21645,9004,233,132,https://www.intensivregister.de/api/public/reporting/laendertabelle
1599008405,30631,21634,8997,232,132,https://www.intensivregister.de/api/public/reporting/laendertabelle
1599012005,30631,21632,8999,231,131,https://www.intensivregister.de/api/public/reporting/laendertabelle
1599015605,30636,21656,8980,228,130,https://www.intensivregister.de/api/public/reporting/laendertabelle
1599019205,30693,21687,9006,224,128,https://www.intensivregister.de/api/public/reporting/laendertabelle
1599022805,30695,21771,8924,222,130,https://www.intensivregister.de/api/public/reporting/laendertabelle
1599026406,30713,21791,8922,223,127,https://www.intensivregister.de/api/public/reporting/laendertabelle
1599030006,30724,21810,8914,225,127,https://www.intensivregister.de/api/public/reporting/laendertabelle
1599033606,30735,21801,8934,227,125,https://www.intensivregister.de/api/public/reporting/laendertabelle
1599037206,30731,21796,8935,227,125,https://www.intensivregister.de/api/public/reporting/laendertabelle
1599040806,30732,21789,8943,227,125,https://www.intensivregister.de/api/public/reporting/laendertabelle
1599044412,30732,21788,8944,227,125,https://www.intensivregister.de/api/public/reporting/laendertabelle
1599048005,30710,21775,8935,227,125,https://www.intensivregister.de/api/public/reporting/laendertabelle
1599051605,30708,21768,8940,227,125,https://www.intensivregister.de/api/public/reporting/laendertabelle
1599055205,30708,21769,8939,227,125,https://www.intensivregister.de/api/public/reporting/laendertabelle
1599058805,30708,21771,8937,227,125,https://www.intensivregister.de/api/public/reporting/laendertabelle
1599062405,30609,21706,8903,227,125,https://www.intensivregister.de/api/public/reporting/laendertabelle
1599066005,30592,21702,8890,227,125,https://www.intensivregister.de/api/public/reporting/laendertabelle
1599069605,30644,21734,8910,227,125,https://www.intensivregister.de/api/public/reporting/laendertabelle
1599076805,30584,21692,8892,226,125,https://www.intensivregister.de/api/public/reporting/laendertabelle
1599080405,30572,21680,8892,225,124,https://www.intensivregister.de/api/public/reporting/laendertabelle
1599084005,30572,21678,8894,225,124,https://www.intensivregister.de/api/public/reporting/laendertabelle
1599091205,30570,21681,8889,225,124,https://www.intensivregister.de/api/public/reporting/laendertabelle
1599094805,30552,21669,8883,225,124,https://www.intensivregister.de/api/public/reporting/laendertabelle
1599098405,30551,21659,8892,225,124,https://www.intensivregister.de/api/public/reporting/laendertabelle
1599102005,30558,21642,8916,225,124,https://www.intensivregister.de/api/public/reporting/laendertabelle
1599105605,30568,21636,8932,224,125,https://www.intensivregister.de/api/public/reporting/laendertabelle
1599109206,30576,21724,8852,225,126,https://www.intensivregister.de/api/public/reporting/laendertabelle
1599112806,30578,21704,8874,227,125,https://www.intensivregister.de/api/public/reporting/laendertabelle
1599116407,30578,21688,8890,221,126,https://www.intensivregister.de/api/public/reporting/laendertabelle
1599120005,30572,21699,8873,220,126,https://www.intensivregister.de/api/public/reporting/laendertabelle
1599123605,30559,21700,8859,220,126,https://www.intensivregister.de/api/public/reporting/laendertabelle
1599127206,30589,21726,8863,220,126,https://www.intensivregister.de/api/public/reporting/laendertabelle
1599130806,30589,21720,8869,220,126,https://www.intensivregister.de/api/public/reporting/laendertabelle
1599134405,30586,21711,8875,220,126,https://www.intensivregister.de/api/public/reporting/laendertabelle
1599138006,30588,21712,8876,220,126,https://www.intensivregister.de/api/public/reporting/laendertabelle
1599141606,30588,21718,8870,220,126,https://www.intensivregister.de/api/public/reporting/laendertabelle
1599148805,30588,21720,8868,220,126,https://www.intensivregister.de/api/public/reporting/laendertabelle
1599152405,30552,21697,8855,220,126,https://www.intensivregister.de/api/public/reporting/laendertabelle
1599156005,30507,21665,8842,220,126,https://www.intensivregister.de/api/public/reporting/laendertabelle
1599159605,30507,21662,8845,220,126,https://www.intensivregister.de/api/public/reporting/laendertabelle
1599163205,30515,21666,8849,220,126,https://www.intensivregister.de/api/public/reporting/laendertabelle
1599166805,30504,21666,8838,220,126,https://www.intensivregister.de/api/public/reporting/laendertabelle
1599170405,30500,21666,8834,220,126,https://www.intensivregister.de/api/public/reporting/laendertabelle
1599174005,30500,21669,8831,220,126,https://www.intensivregister.de/api/public/reporting/laendertabelle
1599177605,30490,21664,8826,220,126,https://www.intensivregister.de/api/public/reporting/laendertabelle
1599181205,30490,21667,8823,227,126,https://www.intensivregister.de/api/public/reporting/laendertabelle
1599184805,30489,21670,8819,226,126,https://www.intensivregister.de/api/public/reporting/laendertabelle
1599188405,30493,21674,8819,229,126,https://www.intensivregister.de/api/public/reporting/laendertabelle
1599192006,30502,21633,8869,227,128,https://www.intensivregister.de/api/public/reporting/laendertabelle
1599195606,30561,21668,8893,222,125,https://www.intensivregister.de/api/public/reporting/laendertabelle
1599199205,30584,21665,8919,224,127,https://www.intensivregister.de/api/public/reporting/laendertabelle
1599202806,30573,21659,8914,224,127,https://www.intensivregister.de/api/public/reporting/laendertabelle
1599206406,30561,21659,8902,222,127,https://www.intensivregister.de/api/public/reporting/laendertabelle
1599210006,30562,21652,8910,222,127,https://www.intensivregister.de/api/public/reporting/laendertabelle
1599213606,30568,21665,8903,221,126,https://www.intensivregister.de/api/public/reporting/laendertabelle
1599217205,30589,21690,8899,222,126,https://www.intensivregister.de/api/public/reporting/laendertabelle
1599220805,30598,21688,8910,222,126,https://www.intensivregister.de/api/public/reporting/laendertabelle
1599224405,30598,21689,8909,222,126,https://www.intensivregister.de/api/public/reporting/laendertabelle
1599228006,30598,21693,8905,223,126,https://www.intensivregister.de/api/public/reporting/laendertabelle
1599231605,30559,21665,8894,223,126,https://www.intensivregister.de/api/public/reporting/laendertabelle
1599235205,30529,21640,8889,222,126,https://www.intensivregister.de/api/public/reporting/laendertabelle
1599238805,30498,21619,8879,222,126,https://www.intensivregister.de/api/public/reporting/laendertabelle
1599242405,30498,21620,8878,222,126,https://www.intensivregister.de/api/public/reporting/laendertabelle
1599246005,30481,21603,8878,220,125,https://www.intensivregister.de/api/public/reporting/laendertabelle
1599249605,30473,21595,8878,220,125,https://www.intensivregister.de/api/public/reporting/laendertabelle
1599253205,30473,21591,8882,220,125,https://www.intensivregister.de/api/public/reporting/laendertabelle
1599256805,30461,21582,8879,220,125,https://www.intensivregister.de/api/public/reporting/laendertabelle
1599260405,30462,21585,8877,220,125,https://www.intensivregister.de/api/public/reporting/laendertabelle
1599267605,30463,21586,8877,220,125,https://www.intensivregister.de/api/public/reporting/laendertabelle
1599271205,30466,21598,8868,220,125,https://www.intensivregister.de/api/public/reporting/laendertabelle
1599274805,30465,21602,8863,220,125,https://www.intensivregister.de/api/public/reporting/laendertabelle
1599278405,30462,21611,8851,219,126,https://www.intensivregister.de/api/public/reporting/laendertabelle
1599282005,30418,21492,8926,217,128,https://www.intensivregister.de/api/public/reporting/laendertabelle
1599285606,30399,21461,8938,220,127,https://www.intensivregister.de/api/public/reporting/laendertabelle
1599289205,30399,21503,8896,220,127,https://www.intensivregister.de/api/public/reporting/laendertabelle
1599292805,30382,21463,8919,221,126,https://www.intensivregister.de/api/public/reporting/laendertabelle
1599296405,30374,21447,8927,221,126,https://www.intensivregister.de/api/public/reporting/laendertabelle
1599300005,30376,21452,8924,221,126,https://www.intensivregister.de/api/public/reporting/laendertabelle
1599303605,30376,21441,8935,221,126,https://www.intensivregister.de/api/public/reporting/laendertabelle
1599307205,30376,21443,8933,221,126,https://www.intensivregister.de/api/public/reporting/laendertabelle
1599310805,30376,21441,8935,221,125,https://www.intensivregister.de/api/public/reporting/laendertabelle
1599314405,30376,21429,8947,221,125,https://www.intensivregister.de/api/public/reporting/laendertabelle
1599318005,30376,21424,8952,221,125,https://www.intensivregister.de/api/public/reporting/laendertabelle
1599321605,30357,21411,8946,221,125,https://www.intensivregister.de/api/public/reporting/laendertabelle
1599325205,30320,21384,8936,221,125,https://www.intensivregister.de/api/public/reporting/laendertabelle
1599328805,30320,21385,8935,221,125,https://www.intensivregister.de/api/public/reporting/laendertabelle
1599332405,30305,21376,8929,221,125,https://www.intensivregister.de/api/public/reporting/laendertabelle
1599336005,30299,21368,8931,221,125,https://www.intensivregister.de/api/public/reporting/laendertabelle
1599339605,30290,21351,8939,220,124,https://www.intensivregister.de/api/public/reporting/laendertabelle
1599343205,30288,21345,8943,220,124,https://www.intensivregister.de/api/public/reporting/laendertabelle
1599350405,30244,21308,8936,219,124,https://www.intensivregister.de/api/public/reporting/laendertabelle
1599354005,30239,21298,8941,219,124,https://www.intensivregister.de/api/public/reporting/laendertabelle
1599357605,30236,21294,8942,219,124,https://www.intensivregister.de/api/public/reporting/laendertabelle
1599361205,30238,21263,8975,218,123,https://www.intensivregister.de/api/public/reporting/laendertabelle
1599364805,30236,21206,9030,219,124,https://www.intensivregister.de/api/public/reporting/laendertabelle
1599368405,30243,21029,9214,219,124,https://www.intensivregister.de/api/public/reporting/laendertabelle
1599372005,30270,20905,9365,214,121,https://www.intensivregister.de/api/public/reporting/laendertabelle
1599375605,30276,20839,9437,214,123,https://www.intensivregister.de/api/public/reporting/laendertabelle
1599379205,30310,20840,9470,215,125,https://www.intensivregister.de/api/public/reporting/laendertabelle
1599382805,30324,20872,9452,215,125,https://www.intensivregister.de/api/public/reporting/laendertabelle
1599386405,30340,20880,9460,216,125,https://www.intensivregister.de/api/public/reporting/laendertabelle
1599390006,30340,20874,9466,216,126,https://www.intensivregister.de/api/public/reporting/laendertabelle
1599393606,30341,20875,9466,216,126,https://www.intensivregister.de/api/public/reporting/laendertabelle
1599397205,30341,20870,9471,216,126,https://www.intensivregister.de/api/public/reporting/laendertabelle
1599400805,30341,20874,9467,217,127,https://www.intensivregister.de/api/public/reporting/laendertabelle
1599404405,30351,20878,9473,217,127,https://www.intensivregister.de/api/public/reporting/laendertabelle
1599408005,30246,20807,9439,217,128,https://www.intensivregister.de/api/public/reporting/laendertabelle
1599411605,30078,20695,9383,216,127,https://www.intensivregister.de/api/public/reporting/laendertabelle
1599415205,29941,20600,9341,216,127,https://www.intensivregister.de/api/public/reporting/laendertabelle
1599418805,29902,20555,9347,214,125,https://www.intensivregister.de/api/public/reporting/laendertabelle
1599422405,29852,20524,9328,214,125,https://www.intensivregister.de/api/public/reporting/laendertabelle
1599426005,29828,20514,9314,214,125,https://www.intensivregister.de/api/public/reporting/laendertabelle
1599429605,29762,20476,9286,214,125,https://www.intensivregister.de/api/public/reporting/laendertabelle
1599433205,29718,20439,9279,213,125,https://www.intensivregister.de/api/public/reporting/laendertabelle
1599436805,29693,20432,9261,213,125,https://www.intensivregister.de/api/public/reporting/laendertabelle
1599440405,29685,20426,9259,213,125,https://www.intensivregister.de/api/public/reporting/laendertabelle
1599444005,29692,20429,9263,213,125,https://www.intensivregister.de/api/public/reporting/laendertabelle
1599447605,29730,20376,9354,213,126,https://www.intensivregister.de/api/public/reporting/laendertabelle
1599451206,29885,20512,9373,219,128,https://www.intensivregister.de/api/public/reporting/laendertabelle
1599454806,30184,20707,9477,224,132,https://www.intensivregister.de/api/public/reporting/laendertabelle
1599458406,30264,20790,9474,226,133,https://www.intensivregister.de/api/public/reporting/laendertabelle
1599462006,30302,20830,9472,225,134,https://www.intensivregister.de/api/public/reporting/laendertabelle
1599465605,30400,20934,9466,226,134,https://www.intensivregister.de/api/public/reporting/laendertabelle
1599469206,30393,20930,9463,226,134,https://www.intensivregister.de/api/public/reporting/laendertabelle
1599472805,30429,20950,9479,225,134,https://www.intensivregister.de/api/public/reporting/laendertabelle
1599476407,30439,20946,9493,225,134,https://www.intensivregister.de/api/public/reporting/laendertabelle
1599483605,30434,20942,9492,225,134,https://www.intensivregister.de/api/public/reporting/laendertabelle
1599487205,30438,20936,9502,224,134,https://www.intensivregister.de/api/public/reporting/laendertabelle
1599498005,30428,20926,9502,224,134,https://www.intensivregister.de/api/public/reporting/laendertabelle
1599501605,30428,20925,9503,224,134,https://www.intensivregister.de/api/public/reporting/laendertabelle
1599505205,30391,20897,9494,224,134,https://www.intensivregister.de/api/public/reporting/laendertabelle
1599512405,30391,20908,9483,224,134,https://www.intensivregister.de/api/public/reporting/laendertabelle
1599516005,30387,20906,9481,224,134,https://www.intensivregister.de/api/public/reporting/laendertabelle
1599519605,30387,20905,9482,224,134,https://www.intensivregister.de/api/public/reporting/laendertabelle
1599523205,30388,20908,9480,224,134,https://www.intensivregister.de/api/public/reporting/laendertabelle
1599526805,30388,20917,9471,224,134,https://www.intensivregister.de/api/public/reporting/laendertabelle
1599530405,30388,20924,9464,224,134,https://www.intensivregister.de/api/public/reporting/laendertabelle
1599534005,30397,21005,9392,222,133,https://www.intensivregister.de/api/public/reporting/laendertabelle
1599537605,30435,21260,9175,221,131,https://www.intensivregister.de/api/public/reporting/laendertabelle
1599541205,30455,21461,8994,223,131,https://www.intensivregister.de/api/public/reporting/laendertabelle
1599544805,30510,21612,8898,228,133,https://www.intensivregister.de/api/public/reporting/laendertabelle
1599548406,30498,21648,8850,227,130,https://www.intensivregister.de/api/public/reporting/laendertabelle
1599552006,30498,21645,8853,228,130,https://www.intensivregister.de/api/public/reporting/laendertabelle
1599555606,30512,21657,8855,228,130,https://www.intensivregister.de/api/public/reporting/laendertabelle
1599559206,30531,21667,8864,228,130,https://www.intensivregister.de/api/public/reporting/laendertabelle
1599562806,30532,21661,8871,227,130,https://www.intensivregister.de/api/public/reporting/laendertabelle
1599566406,30542,21660,8882,226,130,https://www.intensivregister.de/api/public/reporting/laendertabelle
1599570006,30544,21659,8885,226,130,https://www.intensivregister.de/api/public/reporting/laendertabelle
1599577205,30522,21660,8862,226,130,https://www.intensivregister.de/api/public/reporting/laendertabelle
1599580805,30522,21659,8863,226,130,https://www.intensivregister.de/api/public/reporting/laendertabelle
1599584405,30513,21652,8861,225,129,https://www.intensivregister.de/api/public/reporting/laendertabelle
1599588005,30513,21653,8860,225,129,https://www.intensivregister.de/api/public/reporting/laendertabelle
1599591605,30498,21646,8852,225,129,https://www.intensivregister.de/api/public/reporting/laendertabelle
1599595205,30498,21644,8854,226,130,https://www.intensivregister.de/api/public/reporting/laendertabelle
1599598805,30501,21643,8858,226,130,https://www.intensivregister.de/api/public/reporting/laendertabelle
1599602405,30487,21627,8860,226,130,https://www.intensivregister.de/api/public/reporting/laendertabelle
1599606005,30487,21622,8865,226,130,https://www.intensivregister.de/api/public/reporting/laendertabelle
1599609605,30487,21627,8860,226,130,https://www.intensivregister.de/api/public/reporting/laendertabelle
1599613205,30487,21630,8857,226,130,https://www.intensivregister.de/api/public/reporting/laendertabelle
1599616805,30490,21646,8844,226,130,https://www.intensivregister.de/api/public/reporting/laendertabelle
1599620405,30477,21628,8849,226,130,https://www.intensivregister.de/api/public/reporting/laendertabelle
1599624005,30456,21673,8783,226,132,https://www.intensivregister.de/api/public/reporting/laendertabelle
1599627606,30468,21736,8732,226,131,https://www.intensivregister.de/api/public/reporting/laendertabelle
1599631206,30518,21794,8724,226,133,https://www.intensivregister.de/api/public/reporting/laendertabelle
1599634806,30514,21818,8696,226,132,https://www.intensivregister.de/api/public/reporting/laendertabelle
1599638407,30516,21788,8728,226,132,https://www.intensivregister.de/api/public/reporting/laendertabelle
1599642006,30677,21894,8783,229,135,https://www.intensivregister.de/api/public/reporting/laendertabelle
1599645606,30676,21898,8778,229,135,https://www.intensivregister.de/api/public/reporting/laendertabelle
1599649205,30676,21895,8781,228,135,https://www.intensivregister.de/api/public/reporting/laendertabelle
1599652806,30674,21889,8785,228,135,https://www.intensivregister.de/api/public/reporting/laendertabelle
1599656406,30674,21885,8789,228,135,https://www.intensivregister.de/api/public/reporting/laendertabelle
1599660006,30674,21890,8784,228,135,https://www.intensivregister.de/api/public/reporting/laendertabelle
1599667205,30675,21890,8785,228,135,https://www.intensivregister.de/api/public/reporting/laendertabelle
1599678005,30675,21892,8783,228,135,https://www.intensivregister.de/api/public/reporting/laendertabelle
1599685205,30675,21887,8788,228,135,https://www.intensivregister.de/api/public/reporting/laendertabelle
1599688805,30675,21889,8786,228,135,https://www.intensivregister.de/api/public/reporting/laendertabelle
1599696005,30675,21885,8790,228,135,https://www.intensivregister.de/api/public/reporting/laendertabelle
1599699605,30675,21886,8789,228,135,https://www.intensivregister.de/api/public/reporting/laendertabelle
1599703205,30676,21892,8784,228,135,https://www.intensivregister.de/api/public/reporting/laendertabelle
1599706805,30671,21908,8763,229,136,https://www.intensivregister.de/api/public/reporting/laendertabelle
1599710406,30678,21964,8714,231,135,https://www.intensivregister.de/api/public/reporting/laendertabelle
1599714007,30679,22016,8663,233,135,https://www.intensivregister.de/api/public/reporting/laendertabelle
1599717606,30675,22016,8659,227,133,https://www.intensivregister.de/api/public/reporting/laendertabelle
1599721207,30679,21995,8684,233,131,https://www.intensivregister.de/api/public/reporting/laendertabelle
1599724806,30731,22047,8684,233,129,https://www.intensivregister.de/api/public/reporting/laendertabelle
1599728408,30733,22030,8703,233,129,https://www.intensivregister.de/api/public/reporting/laendertabelle
1599732007,30735,22029,8706,234,129,https://www.intensivregister.de/api/public/reporting/laendertabelle
1599735605,30734,22031,8703,234,129,https://www.intensivregister.de/api/public/reporting/laendertabelle
1599742806,30735,22035,8700,234,129,https://www.intensivregister.de/api/public/reporting/laendertabelle
1599746405,30735,22031,8704,234,129,https://www.intensivregister.de/api/public/reporting/laendertabelle
1599753606,30735,22028,8707,234,129,https://www.intensivregister.de/api/public/reporting/laendertabelle
1599760805,30734,22027,8707,233,128,https://www.intensivregister.de/api/public/reporting/laendertabelle
1599771605,30734,22032,8702,233,128,https://www.intensivregister.de/api/public/reporting/laendertabelle
1599775205,30734,22033,8701,233,128,https://www.intensivregister.de/api/public/reporting/laendertabelle
1599778805,30734,22037,8697,233,128,https://www.intensivregister.de/api/public/reporting/laendertabelle
1599782405,30734,22035,8699,233,128,https://www.intensivregister.de/api/public/reporting/laendertabelle
1599786005,30734,22033,8701,233,128,https://www.intensivregister.de/api/public/reporting/laendertabelle
1599789605,30735,22033,8702,232,127,https://www.intensivregister.de/api/public/reporting/laendertabelle
1599793205,30727,22035,8692,232,127,https://www.intensivregister.de/api/public/reporting/laendertabelle
1599796805,30716,22055,8661,226,126,https://www.intensivregister.de/api/public/reporting/laendertabelle
1599800406,30714,22124,8590,225,123,https://www.intensivregister.de/api/public/reporting/laendertabelle
1599804006,30701,22108,8593,220,119,https://www.intensivregister.de/api/public/reporting/laendertabelle
1599807605,30705,22102,8603,220,119,https://www.intensivregister.de/api/public/reporting/laendertabelle
1599811206,30700,22108,8592,220,119,https://www.intensivregister.de/api/public/reporting/laendertabelle
1599814806,30700,22118,8582,220,119,https://www.intensivregister.de/api/public/reporting/laendertabelle
1599818405,30699,22116,8583,220,119,https://www.intensivregister.de/api/public/reporting/laendertabelle
1599822006,30667,22088,8579,219,119,https://www.intensivregister.de/api/public/reporting/laendertabelle
1599825605,30667,22074,8593,219,119,https://www.intensivregister.de/api/public/reporting/laendertabelle
1599829205,30667,22065,8602,219,119,https://www.intensivregister.de/api/public/reporting/laendertabelle
1599832805,30667,22063,8604,219,119,https://www.intensivregister.de/api/public/reporting/laendertabelle
1599836405,30651,22050,8601,219,119,https://www.intensivregister.de/api/public/reporting/laendertabelle
1599840005,30651,22051,8600,219,119,https://www.intensivregister.de/api/public/reporting/laendertabelle
1599847205,30651,22050,8601,219,119,https://www.intensivregister.de/api/public/reporting/laendertabelle
1599854405,30651,22049,8602,219,119,https://www.intensivregister.de/api/public/reporting/laendertabelle
1599858005,30653,22043,8610,220,120,https://www.intensivregister.de/api/public/reporting/laendertabelle
1599861605,30654,22040,8614,220,120,https://www.intensivregister.de/api/public/reporting/laendertabelle
1599865205,30651,22035,8616,220,120,https://www.intensivregister.de/api/public/reporting/laendertabelle
1599868805,30651,22036,8615,220,120,https://www.intensivregister.de/api/public/reporting/laendertabelle
1599872405,30651,22028,8623,220,120,https://www.intensivregister.de/api/public/reporting/laendertabelle
1599879605,30638,22021,8617,219,120,https://www.intensivregister.de/api/public/reporting/laendertabelle
1599883205,30646,21954,8692,226,119,https://www.intensivregister.de/api/public/reporting/laendertabelle
1599886805,30599,21871,8728,226,120,https://www.intensivregister.de/api/public/reporting/laendertabelle
1599890405,30599,21821,8778,228,119,https://www.intensivregister.de/api/public/reporting/laendertabelle
1599894005,30586,21781,8805,233,119,https://www.intensivregister.de/api/public/reporting/laendertabelle
1599897605,30573,21734,8839,233,117,https://www.intensivregister.de/api/public/reporting/laendertabelle
1599901205,30573,21719,8854,233,118,https://www.intensivregister.de/api/public/reporting/laendertabelle
1599904805,30573,21721,8852,233,118,https://www.intensivregister.de/api/public/reporting/laendertabelle
1599908405,30573,21708,8865,233,118,https://www.intensivregister.de/api/public/reporting/laendertabelle
1599915605,30574,21706,8868,233,118,https://www.intensivregister.de/api/public/reporting/laendertabelle
1599919205,30563,21705,8858,233,118,https://www.intensivregister.de/api/public/reporting/laendertabelle
1599922806,30563,21699,8864,233,118,https://www.intensivregister.de/api/public/reporting/laendertabelle
1599926406,30563,21700,8863,233,118,https://www.intensivregister.de/api/public/reporting/laendertabelle
1599933605,30563,21701,8862,233,118,https://www.intensivregister.de/api/public/reporting/laendertabelle
1599940805,30585,21714,8871,234,118,https://www.intensivregister.de/api/public/reporting/laendertabelle
1599944405,30582,21716,8866,235,119,https://www.intensivregister.de/api/public/reporting/laendertabelle
1599948005,30582,21712,8870,235,119,https://www.intensivregister.de/api/public/reporting/laendertabelle
1599951605,30582,21713,8869,235,119,https://www.intensivregister.de/api/public/reporting/laendertabelle
1599955205,30583,21715,8868,235,119,https://www.intensivregister.de/api/public/reporting/laendertabelle
1599958805,30583,21717,8866,235,119,https://www.intensivregister.de/api/public/reporting/laendertabelle
1599962405,30580,21710,8870,235,119,https://www.intensivregister.de/api/public/reporting/laendertabelle
1599966005,30546,21685,8861,235,119,https://www.intensivregister.de/api/public/reporting/laendertabelle
1599969605,30544,21638,8906,236,119,https://www.intensivregister.de/api/public/reporting/laendertabelle
1599973205,30538,21465,9073,232,117,https://www.intensivregister.de/api/public/reporting/laendertabelle
1599976806,30534,21372,9162,235,120,https://www.intensivregister.de/api/public/reporting/laendertabelle
1599980405,30540,21310,9230,238,122,https://www.intensivregister.de/api/public/reporting/laendertabelle
1599984005,30538,21270,9268,236,122,https://www.intensivregister.de/api/public/reporting/laendertabelle
1599987605,30534,21245,9289,236,123,https://www.intensivregister.de/api/public/reporting/laendertabelle
1599991205,30534,21243,9291,237,123,https://www.intensivregister.de/api/public/reporting/laendertabelle
1599994805,30532,21234,9298,237,123,https://www.intensivregister.de/api/public/reporting/laendertabelle
1599998405,30532,21226,9306,236,123,https://www.intensivregister.de/api/public/reporting/laendertabelle
1600005605,30533,21228,9305,235,122,https://www.intensivregister.de/api/public/reporting/laendertabelle
1600009205,30533,21230,9303,235,122,https://www.intensivregister.de/api/public/reporting/laendertabelle
1600012805,30533,21232,9301,235,122,https://www.intensivregister.de/api/public/reporting/laendertabelle
1600020005,30533,21229,9304,235,122,https://www.intensivregister.de/api/public/reporting/laendertabelle
1600023605,30533,21228,9305,235,122,https://www.intensivregister.de/api/public/reporting/laendertabelle
1600030805,30533,21224,9309,235,122,https://www.intensivregister.de/api/public/reporting/laendertabelle
1600034405,30533,21226,9307,236,123,https://www.intensivregister.de/api/public/reporting/laendertabelle
1600038005,30528,21231,9297,236,123,https://www.intensivregister.de/api/public/reporting/laendertabelle
1600041605,30528,21230,9298,236,123,https://www.intensivregister.de/api/public/reporting/laendertabelle
1600045205,30518,21228,9290,236,123,https://www.intensivregister.de/api/public/reporting/laendertabelle
1600048805,30521,21232,9289,236,123,https://www.intensivregister.de/api/public/reporting/laendertabelle
1600052405,30530,21201,9329,238,125,https://www.intensivregister.de/api/public/reporting/laendertabelle
1600056005,30563,21184,9379,237,125,https://www.intensivregister.de/api/public/reporting/laendertabelle
1600059605,30630,21146,9484,241,126,https://www.intensivregister.de/api/public/reporting/laendertabelle
1600063206,30630,21131,9499,242,126,https://www.intensivregister.de/api/public/reporting/laendertabelle
1600066805,30620,21111,9509,237,124,https://www.intensivregister.de/api/public/reporting/laendertabelle
1600070406,30622,21113,9509,237,124,https://www.intensivregister.de/api/public/reporting/laendertabelle
1600074005,30631,21110,9521,237,124,https://www.intensivregister.de/api/public/reporting/laendertabelle
1600077606,30627,21106,9521,238,123,https://www.intensivregister.de/api/public/reporting/laendertabelle
1600081205,30629,21104,9525,237,123,https://www.intensivregister.de/api/public/reporting/laendertabelle
1600084805,30629,21100,9529,237,123,https://www.intensivregister.de/api/public/reporting/laendertabelle
1600088405,30631,21093,9538,238,123,https://www.intensivregister.de/api/public/reporting/laendertabelle
1600092005,30631,21095,9536,238,123,https://www.intensivregister.de/api/public/reporting/laendertabelle
1600095605,30631,21092,9539,238,123,https://www.intensivregister.de/api/public/reporting/laendertabelle
1600099205,30631,21090,9541,238,123,https://www.intensivregister.de/api/public/reporting/laendertabelle
1600110005,30631,21091,9540,238,123,https://www.intensivregister.de/api/public/reporting/laendertabelle
1600113605,30631,21089,9542,238,123,https://www.intensivregister.de/api/public/reporting/laendertabelle
1600117205,30631,21083,9548,238,123,https://www.intensivregister.de/api/public/reporting/laendertabelle
1600120805,30631,21084,9547,238,123,https://www.intensivregister.de/api/public/reporting/laendertabelle
1600124405,30631,21082,9549,238,123,https://www.intensivregister.de/api/public/reporting/laendertabelle
1600128005,30631,21085,9546,238,123,https://www.intensivregister.de/api/public/reporting/laendertabelle
1600131605,30630,21086,9544,239,123,https://www.intensivregister.de/api/public/reporting/laendertabelle
1600135205,30634,21092,9542,238,122,https://www.intensivregister.de/api/public/reporting/laendertabelle
1600138805,30647,21214,9433,242,125,https://www.intensivregister.de/api/public/reporting/laendertabelle
1600142405,30624,21433,9191,242,127,https://www.intensivregister.de/api/public/reporting/laendertabelle
1600146005,30626,21636,8990,243,127,https://www.intensivregister.de/api/public/reporting/laendertabelle
1600149605,30628,21768,8860,234,127,https://www.intensivregister.de/api/public/reporting/laendertabelle
1600153205,30633,21832,8801,236,128,https://www.intensivregister.de/api/public/reporting/laendertabelle
1600156805,30643,21835,8808,237,129,https://www.intensivregister.de/api/public/reporting/laendertabelle
1600160406,30645,21839,8806,236,129,https://www.intensivregister.de/api/public/reporting/laendertabelle
1600164006,30645,21837,8808,236,129,https://www.intensivregister.de/api/public/reporting/laendertabelle
1600167606,30649,21839,8810,236,129,https://www.intensivregister.de/api/public/reporting/laendertabelle
1600171206,30649,21847,8802,236,129,https://www.intensivregister.de/api/public/reporting/laendertabelle
1600174805,30673,21876,8797,236,129,https://www.intensivregister.de/api/public/reporting/laendertabelle
1600178405,30673,21877,8796,236,129,https://www.intensivregister.de/api/public/reporting/laendertabelle
1600189205,30673,21874,8799,236,129,https://www.intensivregister.de/api/public/reporting/laendertabelle
1600200005,30673,21873,8800,236,129,https://www.intensivregister.de/api/public/reporting/laendertabelle
1600203605,30676,21867,8809,235,129,https://www.intensivregister.de/api/public/reporting/laendertabelle
1600207205,30676,21876,8800,235,129,https://www.intensivregister.de/api/public/reporting/laendertabelle
1600214405,30676,21875,8801,235,129,https://www.intensivregister.de/api/public/reporting/laendertabelle
1600218005,30685,21876,8809,234,129,https://www.intensivregister.de/api/public/reporting/laendertabelle
1600221605,30685,21886,8799,234,129,https://www.intensivregister.de/api/public/reporting/laendertabelle
1600225205,30691,21894,8797,233,127,https://www.intensivregister.de/api/public/reporting/laendertabelle
1600228805,30700,21921,8779,235,128,https://www.intensivregister.de/api/public/reporting/laendertabelle
1600232405,30717,22013,8704,234,127,https://www.intensivregister.de/api/public/reporting/laendertabelle
1600236006,30709,22086,8623,235,129,https://www.intensivregister.de/api/public/reporting/laendertabelle
1600239606,30748,22125,8623,236,130,https://www.intensivregister.de/api/public/reporting/laendertabelle
1600243206,30759,22152,8607,235,128,https://www.intensivregister.de/api/public/reporting/laendertabelle
1600246806,30759,22147,8612,233,128,https://www.intensivregister.de/api/public/reporting/laendertabelle
1600250405,30759,22150,8609,233,128,https://www.intensivregister.de/api/public/reporting/laendertabelle
1600254005,30767,22155,8612,234,129,https://www.intensivregister.de/api/public/reporting/laendertabelle
1600257605,30768,22150,8618,234,129,https://www.intensivregister.de/api/public/reporting/laendertabelle
1600261206,30779,22153,8626,235,129,https://www.intensivregister.de/api/public/reporting/laendertabelle
1600268406,30779,22155,8624,235,129,https://www.intensivregister.de/api/public/reporting/laendertabelle
1600272005,30776,22148,8628,235,129,https://www.intensivregister.de/api/public/reporting/laendertabelle
1600275605,30776,22145,8631,235,129,https://www.intensivregister.de/api/public/reporting/laendertabelle
1600286405,30776,22149,8627,235,129,https://www.intensivregister.de/api/public/reporting/laendertabelle
1600290005,30776,22149,8627,237,130,https://www.intensivregister.de/api/public/reporting/laendertabelle
1600293605,30778,22155,8623,237,130,https://www.intensivregister.de/api/public/reporting/laendertabelle
1600297206,30778,22152,8626,237,130,https://www.intensivregister.de/api/public/reporting/laendertabelle
1600300805,30778,22160,8618,238,130,https://www.intensivregister.de/api/public/reporting/laendertabelle
1600304405,30778,22165,8613,238,130,https://www.intensivregister.de/api/public/reporting/laendertabelle
1600308005,30778,22169,8609,237,129,https://www.intensivregister.de/api/public/reporting/laendertabelle
1600311605,30776,22216,8560,235,129,https://www.intensivregister.de/api/public/reporting/laendertabelle
1600315205,30766,22249,8517,234,128,https://www.intensivregister.de/api/public/reporting/laendertabelle
1600318806,30758,22296,8462,229,128,https://www.intensivregister.de/api/public/reporting/laendertabelle
1600322405,30753,22281,8472,225,128,https://www.intensivregister.de/api/public/reporting/laendertabelle
1600326005,30771,22310,8461,231,130,https://www.intensivregister.de/api/public/reporting/laendertabelle
1600329606,30785,22300,8485,237,134,https://www.intensivregister.de/api/public/reporting/laendertabelle
1600333205,30789,22312,8477,238,135,https://www.intensivregister.de/api/public/reporting/laendertabelle
1600336806,30789,22308,8481,237,135,https://www.intensivregister.de/api/public/reporting/laendertabelle
1600340405,30752,22280,8472,237,135,https://www.intensivregister.de/api/public/reporting/laendertabelle
1600344005,30752,22277,8475,237,135,https://www.intensivregister.de/api/public/reporting/laendertabelle
1600347605,30749,22269,8480,238,135,https://www.intensivregister.de/api/public/reporting/laendertabelle
1600351205,30749,22271,8478,239,135,https://www.intensivregister.de/api/public/reporting/laendertabelle
1600354805,30749,22266,8483,240,135,https://www.intensivregister.de/api/public/reporting/laendertabelle
1600358405,30749,22269,8480,240,135,https://www.intensivregister.de/api/public/reporting/laendertabelle
1600362005,30749,22271,8478,240,135,https://www.intensivregister.de/api/public/reporting/laendertabelle
1600365605,30745,22267,8478,240,135,https://www.intensivregister.de/api/public/reporting/laendertabelle
1600380005,30742,22266,8476,240,135,https://www.intensivregister.de/api/public/reporting/laendertabelle
1600383606,30742,22269,8473,240,135,https://www.intensivregister.de/api/public/reporting/laendertabelle
1600387205,30740,22269,8471,240,135,https://www.intensivregister.de/api/public/reporting/laendertabelle
1600390805,30741,22269,8472,240,135,https://www.intensivregister.de/api/public/reporting/laendertabelle
1600394405,30742,22262,8480,241,135,https://www.intensivregister.de/api/public/reporting/laendertabelle
1600398005,30723,22260,8463,242,135,https://www.intensivregister.de/api/public/reporting/laendertabelle
1600401605,30724,22269,8455,244,136,https://www.intensivregister.de/api/public/reporting/laendertabelle
1600405206,30715,22163,8552,243,132,https://www.intensivregister.de/api/public/reporting/laendertabelle
1600408805,30711,22115,8596,248,134,https://www.intensivregister.de/api/public/reporting/laendertabelle
1600412405,30705,22095,8610,246,133,https://www.intensivregister.de/api/public/reporting/laendertabelle
1600416005,30699,22102,8597,246,134,https://www.intensivregister.de/api/public/reporting/laendertabelle
1600419605,30706,22074,8632,245,133,https://www.intensivregister.de/api/public/reporting/laendertabelle
1600423205,30706,22072,8634,245,136,https://www.intensivregister.de/api/public/reporting/laendertabelle
1600426806,30706,22077,8629,245,136,https://www.intensivregister.de/api/public/reporting/laendertabelle
1600430405,30706,22072,8634,245,136,https://www.intensivregister.de/api/public/reporting/laendertabelle
1600434006,30704,22081,8623,245,136,https://www.intensivregister.de/api/public/reporting/laendertabelle
1600437605,30702,22081,8621,245,136,https://www.intensivregister.de/api/public/reporting/laendertabelle
1600462805,30700,22077,8623,247,137,https://www.intensivregister.de/api/public/reporting/laendertabelle
1600466406,30700,22071,8629,247,137,https://www.intensivregister.de/api/public/reporting/laendertabelle
1600470005,30694,22069,8625,248,138,https://www.intensivregister.de/api/public/reporting/laendertabelle
1600473605,30694,22066,8628,247,137,https://www.intensivregister.de/api/public/reporting/laendertabelle
1600477205,30694,22064,8630,247,137,https://www.intensivregister.de/api/public/reporting/laendertabelle
1600480805,30694,22065,8629,247,137,https://www.intensivregister.de/api/public/reporting/laendertabelle
1600484405,30686,22024,8662,244,136,https://www.intensivregister.de/api/public/reporting/laendertabelle
1600488005,30675,21926,8749,242,137,https://www.intensivregister.de/api/public/reporting/laendertabelle
1600491605,30649,21803,8846,246,138,https://www.intensivregister.de/api/public/reporting/laendertabelle
1600495206,30612,21701,8911,251,143,https://www.intensivregister.de/api/public/reporting/laendertabelle
1600498805,30581,21638,8943,256,143,https://www.intensivregister.de/api/public/reporting/laendertabelle
1600502405,30581,21647,8934,256,144,https://www.intensivregister.de/api/public/reporting/laendertabelle
1600506006,30575,21629,8946,257,144,https://www.intensivregister.de/api/public/reporting/laendertabelle
1600509606,30571,21627,8944,257,144,https://www.intensivregister.de/api/public/reporting/laendertabelle
1600513206,30571,21627,8944,259,144,https://www.intensivregister.de/api/public/reporting/laendertabelle
1600516805,30571,21624,8947,259,144,https://www.intensivregister.de/api/public/reporting/laendertabelle
1600524005,30571,21624,8947,260,144,https://www.intensivregister.de/api/public/reporting/laendertabelle
1600527605,30571,21623,8948,260,144,https://www.intensivregister.de/api/public/reporting/laendertabelle
1600534805,30571,21625,8946,259,144,https://www.intensivregister.de/api/public/reporting/laendertabelle
1600549205,30575,21624,8951,259,144,https://www.intensivregister.de/api/public/reporting/laendertabelle
1600552805,30575,21621,8954,259,144,https://www.intensivregister.de/api/public/reporting/laendertabelle
1600556405,30575,21622,8953,259,144,https://www.intensivregister.de/api/public/reporting/laendertabelle
1600567207,30576,21617,8959,260,144,https://www.intensivregister.de/api/public/reporting/laendertabelle
1600570805,30568,21595,8973,261,144,https://www.intensivregister.de/api/public/reporting/laendertabelle
1600574405,30568,21542,9026,261,144,https://www.intensivregister.de/api/public/reporting/laendertabelle
1600578005,30565,21428,9137,263,144,https://www.intensivregister.de/api/public/reporting/laendertabelle
1600581605,30558,21271,9287,264,144,https://www.intensivregister.de/api/public/reporting/laendertabelle
1600585205,30550,21243,9307,267,144,https://www.intensivregister.de/api/public/reporting/laendertabelle
1600588805,30544,21196,9348,268,144,https://www.intensivregister.de/api/public/reporting/laendertabelle
1600592406,30544,21184,9360,268,144,https://www.intensivregister.de/api/public/reporting/laendertabelle
1600596005,30542,21181,9361,269,145,https://www.intensivregister.de/api/public/reporting/laendertabelle
1600599605,30542,21179,9363,269,145,https://www.intensivregister.de/api/public/reporting/laendertabelle
1600603206,30542,21177,9365,269,145,https://www.intensivregister.de/api/public/reporting/laendertabelle
1600606805,30540,21172,9368,269,144,https://www.intensivregister.de/api/public/reporting/laendertabelle
1600610405,30540,21170,9370,269,144,https://www.intensivregister.de/api/public/reporting/laendertabelle
1600614005,30537,21166,9371,269,144,https://www.intensivregister.de/api/public/reporting/laendertabelle
1600617605,30537,21168,9369,269,144,https://www.intensivregister.de/api/public/reporting/laendertabelle
1600624805,30535,21168,9367,269,144,https://www.intensivregister.de/api/public/reporting/laendertabelle
1600628405,30535,21169,9366,269,144,https://www.intensivregister.de/api/public/reporting/laendertabelle
1600632005,30535,21172,9363,269,144,https://www.intensivregister.de/api/public/reporting/laendertabelle
1600635605,30534,21175,9359,270,144,https://www.intensivregister.de/api/public/reporting/laendertabelle
1600639205,30535,21177,9358,270,144,https://www.intensivregister.de/api/public/reporting/laendertabelle
1600642805,30535,21182,9353,270,144,https://www.intensivregister.de/api/public/reporting/laendertabelle
1600646405,30535,21176,9359,270,144,https://www.intensivregister.de/api/public/reporting/laendertabelle
1600650005,30535,21174,9361,271,145,https://www.intensivregister.de/api/public/reporting/laendertabelle
1600653605,30538,21183,9355,270,145,https://www.intensivregister.de/api/public/reporting/laendertabelle
1600657205,30550,21162,9388,268,143,https://www.intensivregister.de/api/public/reporting/laendertabelle
1600660805,30577,21125,9452,264,146,https://www.intensivregister.de/api/public/reporting/laendertabelle
1600664405,30606,21114,9492,271,148,https://www.intensivregister.de/api/public/reporting/laendertabelle
1600668006,30627,21132,9495,266,150,https://www.intensivregister.de/api/public/reporting/laendertabelle
1600671605,30615,21139,9476,266,147,https://www.intensivregister.de/api/public/reporting/laendertabelle
1600675206,30619,21152,9467,267,146,https://www.intensivregister.de/api/public/reporting/laendertabelle
1600678805,30627,21155,9472,267,146,https://www.intensivregister.de/api/public/reporting/laendertabelle
1600682406,30590,21150,9440,265,146,https://www.intensivregister.de/api/public/reporting/laendertabelle
1600686006,30590,21149,9441,266,147,https://www.intensivregister.de/api/public/reporting/laendertabelle
1600689606,30590,21150,9440,267,148,https://www.intensivregister.de/api/public/reporting/laendertabelle
1600693206,30584,21147,9437,268,148,https://www.intensivregister.de/api/public/reporting/laendertabelle
1600700405,30588,21151,9437,268,148,https://www.intensivregister.de/api/public/reporting/laendertabelle
1600704005,30588,21152,9436,268,149,https://www.intensivregister.de/api/public/reporting/laendertabelle
1600722005,30588,21154,9434,268,149,https://www.intensivregister.de/api/public/reporting/laendertabelle
1600725605,30589,21152,9437,269,149,https://www.intensivregister.de/api/public/reporting/laendertabelle
1600729205,30589,21159,9430,269,149,https://www.intensivregister.de/api/public/reporting/laendertabelle
1600732805,30589,21161,9428,269,149,https://www.intensivregister.de/api/public/reporting/laendertabelle
1600736405,30589,21162,9427,269,149,https://www.intensivregister.de/api/public/reporting/laendertabelle
1600740005,30594,21178,9416,268,149,https://www.intensivregister.de/api/public/reporting/laendertabelle
1600743606,30595,21227,9368,267,147,https://www.intensivregister.de/api/public/reporting/laendertabelle
1600747206,30576,21420,9156,266,145,https://www.intensivregister.de/api/public/reporting/laendertabelle
1600750806,30604,21644,8960,270,146,https://www.intensivregister.de/api/public/reporting/laendertabelle
1600754406,30609,21694,8915,273,148,https://www.intensivregister.de/api/public/reporting/laendertabelle
1600758006,30612,21764,8848,276,151,https://www.intensivregister.de/api/public/reporting/laendertabelle
1600761606,30621,21765,8856,278,151,https://www.intensivregister.de/api/public/reporting/laendertabelle
1600765206,30621,21767,8854,279,152,https://www.intensivregister.de/api/public/reporting/laendertabelle
1600768806,30621,21771,8850,279,152,https://www.intensivregister.de/api/public/reporting/laendertabelle
1600772406,30616,21769,8847,279,152,https://www.intensivregister.de/api/public/reporting/laendertabelle
1600776006,30624,21781,8843,279,152,https://www.intensivregister.de/api/public/reporting/laendertabelle
1600779606,30625,21776,8849,279,152,https://www.intensivregister.de/api/public/reporting/laendertabelle
1600783206,30626,21772,8854,279,152,https://www.intensivregister.de/api/public/reporting/laendertabelle
1600790405,30626,21769,8857,279,152,https://www.intensivregister.de/api/public/reporting/laendertabelle
1600801205,30626,21770,8856,279,152,https://www.intensivregister.de/api/public/reporting/laendertabelle
1600808405,30626,21780,8846,278,152,https://www.intensivregister.de/api/public/reporting/laendertabelle
1600812005,30629,21778,8851,278,152,https://www.intensivregister.de/api/public/reporting/laendertabelle
1600815605,30629,21779,8850,278,152,https://www.intensivregister.de/api/public/reporting/laendertabelle
1600819205,30629,21780,8849,278,152,https://www.intensivregister.de/api/public/reporting/laendertabelle
1600822805,30628,21770,8858,278,152,https://www.intensivregister.de/api/public/reporting/laendertabelle
1600826405,30628,21761,8867,278,152,https://www.intensivregister.de/api/public/reporting/laendertabelle
1600830005,30626,21816,8810,282,155,https://www.intensivregister.de/api/public/reporting/laendertabelle
1600833606,30599,21862,8737,289,155,https://www.intensivregister.de/api/public/reporting/laendertabelle
1600837205,30592,21903,8689,287,157,https://www.intensivregister.de/api/public/reporting/laendertabelle
1600840806,30583,21917,8666,286,157,https://www.intensivregister.de/api/public/reporting/laendertabelle
1600844405,30587,21901,8686,292,157,https://www.intensivregister.de/api/public/reporting/laendertabelle
1600848006,30591,21897,8694,292,156,https://www.intensivregister.de/api/public/reporting/laendertabelle
1600851606,30595,21895,8700,293,159,https://www.intensivregister.de/api/public/reporting/laendertabelle
1600855206,30609,21903,8706,293,159,https://www.intensivregister.de/api/public/reporting/laendertabelle
1600862406,30591,21901,8690,296,160,https://www.intensivregister.de/api/public/reporting/laendertabelle
1600866005,30566,21890,8676,294,159,https://www.intensivregister.de/api/public/reporting/laendertabelle
1600869606,30580,21889,8691,294,159,https://www.intensivregister.de/api/public/reporting/laendertabelle
1600876805,30572,21886,8686,294,159,https://www.intensivregister.de/api/public/reporting/laendertabelle
1600887605,30569,21886,8683,294,159,https://www.intensivregister.de/api/public/reporting/laendertabelle
1600891205,30569,21888,8681,294,159,https://www.intensivregister.de/api/public/reporting/laendertabelle
1600898405,30569,21884,8685,294,159,https://www.intensivregister.de/api/public/reporting/laendertabelle
1600905605,30569,21886,8683,294,159,https://www.intensivregister.de/api/public/reporting/laendertabelle
1600912805,30570,21890,8680,294,159,https://www.intensivregister.de/api/public/reporting/laendertabelle
1600916405,30579,21892,8687,291,159,https://www.intensivregister.de/api/public/reporting/laendertabelle
1600920005,30586,21896,8690,291,161,https://www.intensivregister.de/api/public/reporting/laendertabelle
1600923606,30583,21930,8653,291,163,https://www.intensivregister.de/api/public/reporting/laendertabelle
1600927206,30574,21908,8666,291,167,https://www.intensivregister.de/api/public/reporting/laendertabelle
1600930806,30588,21928,8660,294,167,https://www.intensivregister.de/api/public/reporting/laendertabelle
1600934406,30592,21929,8663,296,166,https://www.intensivregister.de/api/public/reporting/laendertabelle
1600938006,30592,21914,8678,296,166,https://www.intensivregister.de/api/public/reporting/laendertabelle
1600941606,30592,21915,8677,297,166,https://www.intensivregister.de/api/public/reporting/laendertabelle
1600945206,30597,21925,8672,297,166,https://www.intensivregister.de/api/public/reporting/laendertabelle
1600948805,30597,21924,8673,297,166,https://www.intensivregister.de/api/public/reporting/laendertabelle
1600952406,30608,21931,8677,297,167,https://www.intensivregister.de/api/public/reporting/laendertabelle
1600956005,30608,21929,8679,297,167,https://www.intensivregister.de/api/public/reporting/laendertabelle
1600966805,30608,21929,8679,298,167,https://www.intensivregister.de/api/public/reporting/laendertabelle
1600981205,30608,21937,8671,298,167,https://www.intensivregister.de/api/public/reporting/laendertabelle
1600984805,30608,21934,8674,298,167,https://www.intensivregister.de/api/public/reporting/laendertabelle
1600992005,30608,21939,8669,297,167,https://www.intensivregister.de/api/public/reporting/laendertabelle
1600995605,30609,21941,8668,297,167,https://www.intensivregister.de/api/public/reporting/laendertabelle
1600999205,30607,21945,8662,299,168,https://www.intensivregister.de/api/public/reporting/laendertabelle
1601002805,30603,21990,8613,299,168,https://www.intensivregister.de/api/public/reporting/laendertabelle
1601006405,30599,22018,8581,299,168,https://www.intensivregister.de/api/public/reporting/laendertabelle
1601010005,30581,22043,8538,298,166,https://www.intensivregister.de/api/public/reporting/laendertabelle
1601013605,30577,22002,8575,297,162,https://www.intensivregister.de/api/public/reporting/laendertabelle
1601017205,30581,21980,8601,301,162,https://www.intensivregister.de/api/public/reporting/laendertabelle
1601020805,30578,22000,8578,304,164,https://www.intensivregister.de/api/public/reporting/laendertabelle
1601024405,30598,22011,8587,304,164,https://www.intensivregister.de/api/public/reporting/laendertabelle
1601028005,30598,22009,8589,304,164,https://www.intensivregister.de/api/public/reporting/laendertabelle
1601031606,30598,22007,8591,304,164,https://www.intensivregister.de/api/public/reporting/laendertabelle
1601035206,30620,22019,8601,302,163,https://www.intensivregister.de/api/public/reporting/laendertabelle
1601038805,30620,22013,8607,302,163,https://www.intensivregister.de/api/public/reporting/laendertabelle
1601042405,30620,22011,8609,302,163,https://www.intensivregister.de/api/public/reporting/laendertabelle
1601046005,30610,22003,8607,302,163,https://www.intensivregister.de/api/public/reporting/laendertabelle
1601053206,30610,22002,8608,301,163,https://www.intensivregister.de/api/public/reporting/laendertabelle
1601056805,30610,22003,8607,301,163,https://www.intensivregister.de/api/public/reporting/laendertabelle
1601060405,30614,22003,8611,301,163,https://www.intensivregister.de/api/public/reporting/laendertabelle
1601064005,30614,22004,8610,301,163,https://www.intensivregister.de/api/public/reporting/laendertabelle
1601067605,30611,22003,8608,301,163,https://www.intensivregister.de/api/public/reporting/laendertabelle
1601071205,30611,21998,8613,301,163,https://www.intensivregister.de/api/public/reporting/laendertabelle
1601074805,30611,22001,8610,301,163,https://www.intensivregister.de/api/public/reporting/laendertabelle
1601078405,30611,21995,8616,301,163,https://www.intensivregister.de/api/public/reporting/laendertabelle
1601082005,30610,21992,8618,301,163,https://www.intensivregister.de/api/public/reporting/laendertabelle
1601085605,30606,21972,8634,301,163,https://www.intensivregister.de/api/public/reporting/laendertabelle
1601089205,30608,21968,8640,300,163,https://www.intensivregister.de/api/public/reporting/laendertabelle
1601092805,30567,21866,8701,302,166,https://www.intensivregister.de/api/public/reporting/laendertabelle
1601096405,30538,21827,8711,299,171,https://www.intensivregister.de/api/public/reporting/laendertabelle
1601100005,30542,21770,8772,308,169,https://www.intensivregister.de/api/public/reporting/laendertabelle
1601103605,30512,21774,8738,309,167,https://www.intensivregister.de/api/public/reporting/laendertabelle
1601107206,30498,21756,8742,313,173,https://www.intensivregister.de/api/public/reporting/laendertabelle
1601110805,30495,21758,8737,313,173,https://www.intensivregister.de/api/public/reporting/laendertabelle
1601114405,30494,21740,8754,314,173,https://www.intensivregister.de/api/public/reporting/laendertabelle
1601118005,30493,21727,8766,314,173,https://www.intensivregister.de/api/public/reporting/laendertabelle
1601121605,30488,21727,8761,316,173,https://www.intensivregister.de/api/public/reporting/laendertabelle
1601125205,30490,21721,8769,316,173,https://www.intensivregister.de/api/public/reporting/laendertabelle
1601128805,30490,21712,8778,317,173,https://www.intensivregister.de/api/public/reporting/laendertabelle
1601132405,30490,21713,8777,317,173,https://www.intensivregister.de/api/public/reporting/laendertabelle
1601136005,30490,21712,8778,317,173,https://www.intensivregister.de/api/public/reporting/laendertabelle
1601143205,30490,21713,8777,317,173,https://www.intensivregister.de/api/public/reporting/laendertabelle
1601154005,30490,21711,8779,317,173,https://www.intensivregister.de/api/public/reporting/laendertabelle
1601157605,30494,21706,8788,317,173,https://www.intensivregister.de/api/public/reporting/laendertabelle
1601161205,30494,21707,8787,317,173,https://www.intensivregister.de/api/public/reporting/laendertabelle
1601164805,30494,21705,8789,317,173,https://www.intensivregister.de/api/public/reporting/laendertabelle
1601168405,30495,21706,8789,317,173,https://www.intensivregister.de/api/public/reporting/laendertabelle
1601172005,30496,21705,8791,317,173,https://www.intensivregister.de/api/public/reporting/laendertabelle
1601175606,30490,21693,8797,317,173,https://www.intensivregister.de/api/public/reporting/laendertabelle
1601179205,30482,21561,8921,317,176,https://www.intensivregister.de/api/public/reporting/laendertabelle
1601182805,30475,21382,9093,324,178,https://www.intensivregister.de/api/public/reporting/laendertabelle
1601186405,30469,21282,9187,326,180,https://www.intensivregister.de/api/public/reporting/laendertabelle
1601190005,30463,21156,9307,326,180,https://www.intensivregister.de/api/public/reporting/laendertabelle
1601193605,30458,21116,9342,324,179,https://www.intensivregister.de/api/public/reporting/laendertabelle
1601197205,30458,21097,9361,326,180,https://www.intensivregister.de/api/public/reporting/laendertabelle
1601200805,30457,21101,9356,327,180,https://www.intensivregister.de/api/public/reporting/laendertabelle
1601204405,30459,21104,9355,327,180,https://www.intensivregister.de/api/public/reporting/laendertabelle
1601208005,30459,21106,9353,328,180,https://www.intensivregister.de/api/public/reporting/laendertabelle
1601233205,30459,21103,9356,328,180,https://www.intensivregister.de/api/public/reporting/laendertabelle
1601240405,30459,21095,9364,327,180,https://www.intensivregister.de/api/public/reporting/laendertabelle
1601244005,30459,21097,9362,328,180,https://www.intensivregister.de/api/public/reporting/laendertabelle
1601247605,30459,21096,9363,328,180,https://www.intensivregister.de/api/public/reporting/laendertabelle
1601251205,30456,21105,9351,328,180,https://www.intensivregister.de/api/public/reporting/laendertabelle
1601254805,30451,21108,9343,328,180,https://www.intensivregister.de/api/public/reporting/laendertabelle
1601258405,30449,21109,9340,328,180,https://www.intensivregister.de/api/public/reporting/laendertabelle
1601262005,30459,21074,9385,330,179,https://www.intensivregister.de/api/public/reporting/laendertabelle
1601265605,30508,21025,9483,336,177,https://www.intensivregister.de/api/public/reporting/laendertabelle
1601269205,30549,21011,9538,342,181,https://www.intensivregister.de/api/public/reporting/laendertabelle
1601272806,30558,21065,9493,347,187,https://www.intensivregister.de/api/public/reporting/laendertabelle
1601276405,30584,21095,9489,353,191,https://www.intensivregister.de/api/public/reporting/laendertabelle
1601280005,30642,21101,9541,354,191,https://www.intensivregister.de/api/public/reporting/laendertabelle
1601283605,30647,21099,9548,353,191,https://www.intensivregister.de/api/public/reporting/laendertabelle
1601287206,30647,21095,9552,353,191,https://www.intensivregister.de/api/public/reporting/laendertabelle
1601290806,30647,21094,9553,353,191,https://www.intensivregister.de/api/public/reporting/laendertabelle
1601294406,30642,21076,9566,352,190,https://www.intensivregister.de/api/public/reporting/laendertabelle
1601298006,30638,21080,9558,352,191,https://www.intensivregister.de/api/public/reporting/laendertabelle
1601301605,30638,21079,9559,352,191,https://www.intensivregister.de/api/public/reporting/laendertabelle
1601305206,30638,21079,9559,353,192,https://www.intensivregister.de/api/public/reporting/laendertabelle
1601312405,30669,21097,9572,353,192,https://www.intensivregister.de/api/public/reporting/laendertabelle
1601316005,30669,21098,9571,353,192,https://www.intensivregister.de/api/public/reporting/laendertabelle
1601319605,30669,21097,9572,353,192,https://www.intensivregister.de/api/public/reporting/laendertabelle
1601323205,30669,21099,9570,354,192,https://www.intensivregister.de/api/public/reporting/laendertabelle
1601330405,30669,21102,9567,354,192,https://www.intensivregister.de/api/public/reporting/laendertabelle
1601334005,30669,21101,9568,354,192,https://www.intensivregister.de/api/public/reporting/laendertabelle
1601337605,30669,21102,9567,354,192,https://www.intensivregister.de/api/public/reporting/laendertabelle
1601341205,30671,21101,9570,354,192,https://www.intensivregister.de/api/public/reporting/laendertabelle
1601344805,30674,21104,9570,354,192,https://www.intensivregister.de/api/public/reporting/laendertabelle
1601348405,30681,21180,9501,354,193,https://www.intensivregister.de/api/public/reporting/laendertabelle
1601352006,30687,21414,9273,352,191,https://www.intensivregister.de/api/public/reporting/laendertabelle
1601355606,30722,21732,8990,348,191,https://www.intensivregister.de/api/public/reporting/laendertabelle
1601359205,30730,21801,8929,351,193,https://www.intensivregister.de/api/public/reporting/laendertabelle
1601362805,30740,21830,8910,350,194,https://www.intensivregister.de/api/public/reporting/laendertabelle
1601366405,30744,21851,8893,351,194,https://www.intensivregister.de/api/public/reporting/laendertabelle
1601370005,30745,21848,8897,354,197,https://www.intensivregister.de/api/public/reporting/laendertabelle
1601373606,30745,21851,8894,355,198,https://www.intensivregister.de/api/public/reporting/laendertabelle
1601377205,30716,21819,8897,356,199,https://www.intensivregister.de/api/public/reporting/laendertabelle
1601380806,30716,21814,8902,356,200,https://www.intensivregister.de/api/public/reporting/laendertabelle
1601384406,30716,21817,8899,356,200,https://www.intensivregister.de/api/public/reporting/laendertabelle
1601388006,30716,21820,8896,356,201,https://www.intensivregister.de/api/public/reporting/laendertabelle
1601391607,30745,21847,8898,356,201,https://www.intensivregister.de/api/public/reporting/laendertabelle
1601395205,30745,21843,8902,355,201,https://www.intensivregister.de/api/public/reporting/laendertabelle
1601398805,30745,21848,8897,355,201,https://www.intensivregister.de/api/public/reporting/laendertabelle
1601406005,30745,21847,8898,355,201,https://www.intensivregister.de/api/public/reporting/laendertabelle
1601413205,30751,21843,8908,354,200,https://www.intensivregister.de/api/public/reporting/laendertabelle
1601424005,30749,21839,8910,354,200,https://www.intensivregister.de/api/public/reporting/laendertabelle
1601427605,30748,21850,8898,355,200,https://www.intensivregister.de/api/public/reporting/laendertabelle
1601431205,30695,21803,8892,356,200,https://www.intensivregister.de/api/public/reporting/laendertabelle
1601434805,30692,21863,8829,353,201,https://www.intensivregister.de/api/public/reporting/laendertabelle
1601438406,30694,21891,8803,349,202,https://www.intensivregister.de/api/public/reporting/laendertabelle
1601442006,30684,21912,8772,347,200,https://www.intensivregister.de/api/public/reporting/laendertabelle
1601445605,30694,21947,8747,352,200,https://www.intensivregister.de/api/public/reporting/laendertabelle
1601449205,30672,21968,8704,354,199,https://www.intensivregister.de/api/public/reporting/laendertabelle
1601452806,30674,21964,8710,354,195,https://www.intensivregister.de/api/public/reporting/laendertabelle
1601456406,30671,21968,8703,355,195,https://www.intensivregister.de/api/public/reporting/laendertabelle
1601460005,30667,21969,8698,355,195,https://www.intensivregister.de/api/public/reporting/laendertabelle
1601463605,30667,21963,8704,354,194,https://www.intensivregister.de/api/public/reporting/laendertabelle
1601467206,30589,21897,8692,354,194,https://www.intensivregister.de/api/public/reporting/laendertabelle
1601470805,30604,21904,8700,354,193,https://www.intensivregister.de/api/public/reporting/laendertabelle
1601474407,30612,21911,8701,354,193,https://www.intensivregister.de/api/public/reporting/laendertabelle
1601478005,30613,21913,8700,354,193,https://www.intensivregister.de/api/public/reporting/laendertabelle
1601496005,30613,21920,8693,354,193,https://www.intensivregister.de/api/public/reporting/laendertabelle
1601499605,30613,21928,8685,354,193,https://www.intensivregister.de/api/public/reporting/laendertabelle
1601503205,30613,21927,8686,354,193,https://www.intensivregister.de/api/public/reporting/laendertabelle
1601506805,30613,21928,8685,354,193,https://www.intensivregister.de/api/public/reporting/laendertabelle
1601510405,30613,21932,8681,354,193,https://www.intensivregister.de/api/public/reporting/laendertabelle
1601514005,30607,21937,8670,353,193,https://www.intensivregister.de/api/public/reporting/laendertabelle
1601517605,30612,21938,8674,353,193,https://www.intensivregister.de/api/public/reporting/laendertabelle
1601521205,30588,21939,8649,353,194,https://www.intensivregister.de/api/public/reporting/laendertabelle
1601524805,30588,21865,8723,353,194,https://www.intensivregister.de/api/public/reporting/laendertabelle
1601528406,30566,21930,8636,361,195,https://www.intensivregister.de/api/public/reporting/laendertabelle
1601532006,30545,21911,8634,364,194,https://www.intensivregister.de/api/public/reporting/laendertabelle
1601535606,30542,21868,8674,365,194,https://www.intensivregister.de/api/public/reporting/laendertabelle
1601539205,30538,21832,8706,363,193,https://www.intensivregister.de/api/public/reporting/laendertabelle
1601542805,30538,21836,8702,358,193,https://www.intensivregister.de/api/public/reporting/laendertabelle
1601546406,30536,21835,8701,358,193,https://www.intensivregister.de/api/public/reporting/laendertabelle
1601550005,30537,21824,8713,358,193,https://www.intensivregister.de/api/public/reporting/laendertabelle
1601553606,30539,21821,8718,358,193,https://www.intensivregister.de/api/public/reporting/laendertabelle
1601557205,30534,21827,8707,358,193,https://www.intensivregister.de/api/public/reporting/laendertabelle
1601564405,30534,21828,8706,358,193,https://www.intensivregister.de/api/public/reporting/laendertabelle
1601568005,30534,21829,8705,358,193,https://www.intensivregister.de/api/public/reporting/laendertabelle
1601586005,30537,21825,8712,358,193,https://www.intensivregister.de/api/public/reporting/laendertabelle
1601589605,30537,21823,8714,358,193,https://www.intensivregister.de/api/public/reporting/laendertabelle
1601593205,30537,21817,8720,358,193,https://www.intensivregister.de/api/public/reporting/laendertabelle
1601596805,30537,21816,8721,358,193,https://www.intensivregister.de/api/public/reporting/laendertabelle
1601600405,30538,21821,8717,358,193,https://www.intensivregister.de/api/public/reporting/laendertabelle
1601604005,30538,21823,8715,359,193,https://www.intensivregister.de/api/public/reporting/laendertabelle
1601607605,30520,21838,8682,356,193,https://www.intensivregister.de/api/public/reporting/laendertabelle
1601611205,30522,21826,8696,359,195,https://www.intensivregister.de/api/public/reporting/laendertabelle
1601614806,30481,21836,8645,367,195,https://www.intensivregister.de/api/public/reporting/laendertabelle
1601618406,30473,21817,8656,372,199,https://www.intensivregister.de/api/public/reporting/laendertabelle
1601622005,30485,21820,8665,371,198,https://www.intensivregister.de/api/public/reporting/laendertabelle
1601625605,30482,21801,8681,374,199,https://www.intensivregister.de/api/public/reporting/laendertabelle
1601629206,30482,21806,8676,374,199,https://www.intensivregister.de/api/public/reporting/laendertabelle
1601632806,30480,21801,8679,374,199,https://www.intensivregister.de/api/public/reporting/laendertabelle
1601636405,30480,21799,8681,374,199,https://www.intensivregister.de/api/public/reporting/laendertabelle
1601640005,30480,21808,8672,374,200,https://www.intensivregister.de/api/public/reporting/laendertabelle
1601643605,30480,21802,8678,374,200,https://www.intensivregister.de/api/public/reporting/laendertabelle
1601647205,30474,21795,8679,376,200,https://www.intensivregister.de/api/public/reporting/laendertabelle
1601650806,30474,21786,8688,376,200,https://www.intensivregister.de/api/public/reporting/laendertabelle
1601654406,30469,21789,8680,376,200,https://www.intensivregister.de/api/public/reporting/laendertabelle
1601658005,30468,21785,8683,376,200,https://www.intensivregister.de/api/public/reporting/laendertabelle
1601668805,30468,21787,8681,376,200,https://www.intensivregister.de/api/public/reporting/laendertabelle
1601672405,30474,21784,8690,377,200,https://www.intensivregister.de/api/public/reporting/laendertabelle
1601676005,30478,21784,8694,377,200,https://www.intensivregister.de/api/public/reporting/laendertabelle
1601683205,30478,21786,8692,377,200,https://www.intensivregister.de/api/public/reporting/laendertabelle
1601686805,30478,21788,8690,377,200,https://www.intensivregister.de/api/public/reporting/laendertabelle
1601690405,30478,21784,8694,376,200,https://www.intensivregister.de/api/public/reporting/laendertabelle
1601694005,30468,21766,8702,375,200,https://www.intensivregister.de/api/public/reporting/laendertabelle
1601697605,30447,21734,8713,376,202,https://www.intensivregister.de/api/public/reporting/laendertabelle
1601701205,30402,21676,8726,383,202,https://www.intensivregister.de/api/public/reporting/laendertabelle
1601704805,30373,21606,8767,397,203,https://www.intensivregister.de/api/public/reporting/laendertabelle
1601708405,30351,21564,8787,401,205,https://www.intensivregister.de/api/public/reporting/laendertabelle
1601712005,30334,21523,8811,403,204,https://www.intensivregister.de/api/public/reporting/laendertabelle
1601715605,30328,21503,8825,404,204,https://www.intensivregister.de/api/public/reporting/laendertabelle
1601719205,30275,21465,8810,404,204,https://www.intensivregister.de/api/public/reporting/laendertabelle
1601722805,30270,21463,8807,404,204,https://www.intensivregister.de/api/public/reporting/laendertabelle
1601726405,30270,21460,8810,404,204,https://www.intensivregister.de/api/public/reporting/laendertabelle
1601730005,30270,21459,8811,404,204,https://www.intensivregister.de/api/public/reporting/laendertabelle
1601733605,30270,21450,8820,404,204,https://www.intensivregister.de/api/public/reporting/laendertabelle
1601737205,30270,21449,8821,404,204,https://www.intensivregister.de/api/public/reporting/laendertabelle
1601740805,30270,21447,8823,404,204,https://www.intensivregister.de/api/public/reporting/laendertabelle
1601744405,30270,21446,8824,404,204,https://www.intensivregister.de/api/public/reporting/laendertabelle
1601748005,30270,21445,8825,404,204,https://www.intensivregister.de/api/public/reporting/laendertabelle
1601751605,30270,21442,8828,404,204,https://www.intensivregister.de/api/public/reporting/laendertabelle
1601758805,30270,21434,8836,404,204,https://www.intensivregister.de/api/public/reporting/laendertabelle
1601762405,30270,21432,8838,404,204,https://www.intensivregister.de/api/public/reporting/laendertabelle
1601773205,30268,21431,8837,404,204,https://www.intensivregister.de/api/public/reporting/laendertabelle
1601776805,30268,21422,8846,404,204,https://www.intensivregister.de/api/public/reporting/laendertabelle
1601780405,30263,21399,8864,408,204,https://www.intensivregister.de/api/public/reporting/laendertabelle
1601784005,30268,21311,8957,410,205,https://www.intensivregister.de/api/public/reporting/laendertabelle
1601787605,30263,21211,9052,410,207,https://www.intensivregister.de/api/public/reporting/laendertabelle
1601791205,30273,21101,9172,420,211,https://www.intensivregister.de/api/public/reporting/laendertabelle
1601794805,30281,21029,9252,424,212,https://www.intensivregister.de/api/public/reporting/laendertabelle
1601798405,30272,20983,9289,424,212,https://www.intensivregister.de/api/public/reporting/laendertabelle
1601802005,30272,20976,9296,424,211,https://www.intensivregister.de/api/public/reporting/laendertabelle
1601805605,30269,20971,9298,424,211,https://www.intensivregister.de/api/public/reporting/laendertabelle
1601809205,30268,20964,9304,425,211,https://www.intensivregister.de/api/public/reporting/laendertabelle
1601812805,30268,20965,9303,425,211,https://www.intensivregister.de/api/public/reporting/laendertabelle
1601816405,30268,20962,9306,426,211,https://www.intensivregister.de/api/public/reporting/laendertabelle
1601820005,30268,20963,9305,426,211,https://www.intensivregister.de/api/public/reporting/laendertabelle
1601823605,30268,20960,9308,426,211,https://www.intensivregister.de/api/public/reporting/laendertabelle
1601827205,30268,20958,9310,426,211,https://www.intensivregister.de/api/public/reporting/laendertabelle
1601830805,30268,20959,9309,426,211,https://www.intensivregister.de/api/public/reporting/laendertabelle
1601838005,30270,20958,9312,426,211,https://www.intensivregister.de/api/public/reporting/laendertabelle
1601845205,30262,20951,9311,426,211,https://www.intensivregister.de/api/public/reporting/laendertabelle
1601848805,30265,20949,9316,426,211,https://www.intensivregister.de/api/public/reporting/laendertabelle
1601852405,30266,20951,9315,427,212,https://www.intensivregister.de/api/public/reporting/laendertabelle
1601863205,30266,20952,9314,427,212,https://www.intensivregister.de/api/public/reporting/laendertabelle
1601866805,30281,20991,9290,430,214,https://www.intensivregister.de/api/public/reporting/laendertabelle
1601870405,30304,20926,9378,442,211,https://www.intensivregister.de/api/public/reporting/laendertabelle
1601874005,30345,20908,9437,442,211,https://www.intensivregister.de/api/public/reporting/laendertabelle
1601877605,30345,20860,9485,440,209,https://www.intensivregister.de/api/public/reporting/laendertabelle
1601881205,30351,20855,9496,447,210,https://www.intensivregister.de/api/public/reporting/laendertabelle
1601884805,30353,20913,9440,447,210,https://www.intensivregister.de/api/public/reporting/laendertabelle
1601888405,30353,20917,9436,447,210,https://www.intensivregister.de/api/public/reporting/laendertabelle
1601892005,30353,20918,9435,447,210,https://www.intensivregister.de/api/public/reporting/laendertabelle
1601895605,30353,20921,9432,447,210,https://www.intensivregister.de/api/public/reporting/laendertabelle
1601899205,30330,20898,9432,447,211,https://www.intensivregister.de/api/public/reporting/laendertabelle
1601906405,30330,20899,9431,447,212,https://www.intensivregister.de/api/public/reporting/laendertabelle
1601913605,30330,20902,9428,447,212,https://www.intensivregister.de/api/public/reporting/laendertabelle
1601928005,30330,20901,9429,447,212,https://www.intensivregister.de/api/public/reporting/laendertabelle
1601931605,30337,20918,9419,447,212,https://www.intensivregister.de/api/public/reporting/laendertabelle
1601935205,30337,20918,9419,448,213,https://www.intensivregister.de/api/public/reporting/laendertabelle
1601938805,30337,20915,9422,448,213,https://www.intensivregister.de/api/public/reporting/laendertabelle
1601946005,30337,20918,9419,448,213,https://www.intensivregister.de/api/public/reporting/laendertabelle
1601949605,30339,20927,9412,448,213,https://www.intensivregister.de/api/public/reporting/laendertabelle
1601953205,30344,21035,9309,449,213,https://www.intensivregister.de/api/public/reporting/laendertabelle
1601956805,30354,21190,9164,442,211,https://www.intensivregister.de/api/public/reporting/laendertabelle
1601960405,30355,21315,9040,442,217,https://www.intensivregister.de/api/public/reporting/laendertabelle
1601964005,30359,21429,8930,444,218,https://www.intensivregister.de/api/public/reporting/laendertabelle
1601967605,30359,21475,8884,453,221,https://www.intensivregister.de/api/public/reporting/laendertabelle
1601971205,30348,21499,8849,452,219,https://www.intensivregister.de/api/public/reporting/laendertabelle
1601974805,30345,21491,8854,449,219,https://www.intensivregister.de/api/public/reporting/laendertabelle
1601978405,30347,21495,8852,449,219,https://www.intensivregister.de/api/public/reporting/laendertabelle
1601982005,30347,21499,8848,450,220,https://www.intensivregister.de/api/public/reporting/laendertabelle
1601985605,30347,21496,8851,451,220,https://www.intensivregister.de/api/public/reporting/laendertabelle
1601989205,30347,21498,8849,452,220,https://www.intensivregister.de/api/public/reporting/laendertabelle
1601992805,30334,21480,8854,452,220,https://www.intensivregister.de/api/public/reporting/laendertabelle
1602000005,30334,21480,8854,453,221,https://www.intensivregister.de/api/public/reporting/laendertabelle
1602018005,30334,21494,8840,453,221,https://www.intensivregister.de/api/public/reporting/laendertabelle
1602021605,30334,21487,8847,453,221,https://www.intensivregister.de/api/public/reporting/laendertabelle
1602025205,30334,21491,8843,453,221,https://www.intensivregister.de/api/public/reporting/laendertabelle
1602028805,30334,21490,8844,453,221,https://www.intensivregister.de/api/public/reporting/laendertabelle
1602032405,30334,21495,8839,453,221,https://www.intensivregister.de/api/public/reporting/laendertabelle
1602036005,30331,21495,8836,452,221,https://www.intensivregister.de/api/public/reporting/laendertabelle
1602039605,30331,21566,8765,452,225,https://www.intensivregister.de/api/public/reporting/laendertabelle
1602043206,30318,21629,8689,462,224,https://www.intensivregister.de/api/public/reporting/laendertabelle
1602046805,30344,21727,8617,457,226,https://www.intensivregister.de/api/public/reporting/laendertabelle
1602050405,30344,21815,8529,465,229,https://www.intensivregister.de/api/public/reporting/laendertabelle
1602054005,30336,21849,8487,467,232,https://www.intensivregister.de/api/public/reporting/laendertabelle
1602057605,30314,21827,8487,469,233,https://www.intensivregister.de/api/public/reporting/laendertabelle
1602061205,30312,21829,8483,469,232,https://www.intensivregister.de/api/public/reporting/laendertabelle
1602064805,30312,21817,8495,469,232,https://www.intensivregister.de/api/public/reporting/laendertabelle
1602068406,30310,21832,8478,469,232,https://www.intensivregister.de/api/public/reporting/laendertabelle
1602072005,30310,21832,8478,468,231,https://www.intensivregister.de/api/public/reporting/laendertabelle
1602075605,30310,21834,8476,468,231,https://www.intensivregister.de/api/public/reporting/laendertabelle
1602079205,30323,21843,8480,469,231,https://www.intensivregister.de/api/public/reporting/laendertabelle
1602086405,30323,21849,8474,469,231,https://www.intensivregister.de/api/public/reporting/laendertabelle
1602090005,30323,21853,8470,469,231,https://www.intensivregister.de/api/public/reporting/laendertabelle
1602097205,30323,21854,8469,469,231,https://www.intensivregister.de/api/public/reporting/laendertabelle
1602104405,30323,21848,8475,468,231,https://www.intensivregister.de/api/public/reporting/laendertabelle
1602108005,30322,21855,8467,470,231,https://www.intensivregister.de/api/public/reporting/laendertabelle
1602111605,30324,21850,8474,470,231,https://www.intensivregister.de/api/public/reporting/laendertabelle
1602115205,30324,21854,8470,470,231,https://www.intensivregister.de/api/public/reporting/laendertabelle
1602118805,30320,21851,8469,470,231,https://www.intensivregister.de/api/public/reporting/laendertabelle
1602122405,30323,21858,8465,467,231,https://www.intensivregister.de/api/public/reporting/laendertabelle
1602126005,30319,21825,8494,466,230,https://www.intensivregister.de/api/public/reporting/laendertabelle
1602129605,30274,21756,8518,469,232,https://www.intensivregister.de/api/public/reporting/laendertabelle
1602133205,30274,21773,8501,464,231,https://www.intensivregister.de/api/public/reporting/laendertabelle
1602136805,30250,21766,8484,471,234,https://www.intensivregister.de/api/public/reporting/laendertabelle
1602140405,30258,21778,8480,484,239,https://www.intensivregister.de/api/public/reporting/laendertabelle
1602144005,30259,21784,8475,487,239,https://www.intensivregister.de/api/public/reporting/laendertabelle
1602151205,30254,21778,8476,484,237,https://www.intensivregister.de/api/public/reporting/laendertabelle
1602154805,30254,21784,8470,487,237,https://www.intensivregister.de/api/public/reporting/laendertabelle
1602158405,30254,21782,8472,487,237,https://www.intensivregister.de/api/public/reporting/laendertabelle
1602165605,30254,21785,8469,487,237,https://www.intensivregister.de/api/public/reporting/laendertabelle
1602169205,30255,21784,8471,487,237,https://www.intensivregister.de/api/public/reporting/laendertabelle
1602172805,30255,21787,8468,487,237,https://www.intensivregister.de/api/public/reporting/laendertabelle
1602176405,30254,21793,8461,486,237,https://www.intensivregister.de/api/public/reporting/laendertabelle
1602180005,30252,21793,8459,487,237,https://www.intensivregister.de/api/public/reporting/laendertabelle
1602187205,30252,21791,8461,487,237,https://www.intensivregister.de/api/public/reporting/laendertabelle
1602190805,30252,21784,8468,487,237,https://www.intensivregister.de/api/public/reporting/laendertabelle
1602194405,30252,21790,8462,488,238,https://www.intensivregister.de/api/public/reporting/laendertabelle
1602198005,30256,21797,8459,489,238,https://www.intensivregister.de/api/public/reporting/laendertabelle
1602201605,30256,21798,8458,489,238,https://www.intensivregister.de/api/public/reporting/laendertabelle
1602205205,30256,21801,8455,489,238,https://www.intensivregister.de/api/public/reporting/laendertabelle
1602208805,30256,21794,8462,490,238,https://www.intensivregister.de/api/public/reporting/laendertabelle
1602212405,30248,21787,8461,492,241,https://www.intensivregister.de/api/public/reporting/laendertabelle
1602216005,30249,21782,8467,499,247,https://www.intensivregister.de/api/public/reporting/laendertabelle
1602219605,30243,21779,8464,502,245,https://www.intensivregister.de/api/public/reporting/laendertabelle
1602223205,30274,21769,8505,512,253,https://www.intensivregister.de/api/public/reporting/laendertabelle
1602226805,30269,21764,8505,513,255,https://www.intensivregister.de/api/public/reporting/laendertabelle
1602230405,30258,21739,8519,510,252,https://www.intensivregister.de/api/public/reporting/laendertabelle
1602234005,30255,21742,8513,509,252,https://www.intensivregister.de/api/public/reporting/laendertabelle
1602237605,30255,21735,8520,509,252,https://www.intensivregister.de/api/public/reporting/laendertabelle
1602241205,30255,21722,8533,509,252,https://www.intensivregister.de/api/public/reporting/laendertabelle
1602244805,30245,21714,8531,510,252,https://www.intensivregister.de/api/public/reporting/laendertabelle
1602248405,30245,21714,8531,511,252,https://www.intensivregister.de/api/public/reporting/laendertabelle
1602252005,30246,21714,8532,510,252,https://www.intensivregister.de/api/public/reporting/laendertabelle
1602255605,30247,21714,8533,510,252,https://www.intensivregister.de/api/public/reporting/laendertabelle
1602259205,30247,21720,8527,510,252,https://www.intensivregister.de/api/public/reporting/laendertabelle
1602266405,30247,21721,8526,510,252,https://www.intensivregister.de/api/public/reporting/laendertabelle
1602270005,30247,21724,8523,511,252,https://www.intensivregister.de/api/public/reporting/laendertabelle
1602277205,30247,21718,8529,511,251,https://www.intensivregister.de/api/public/reporting/laendertabelle
1602280805,30247,21716,8531,511,251,https://www.intensivregister.de/api/public/reporting/laendertabelle
1602284405,30247,21715,8532,511,251,https://www.intensivregister.de/api/public/reporting/laendertabelle
1602288005,30242,21712,8530,511,251,https://www.intensivregister.de/api/public/reporting/laendertabelle
1602295205,30247,21718,8529,511,252,https://www.intensivregister.de/api/public/reporting/laendertabelle
1602298805,30248,21690,8558,512,253,https://www.intensivregister.de/api/public/reporting/laendertabelle
1602302405,30279,21593,8686,513,255,https://www.intensivregister.de/api/public/reporting/laendertabelle
1602306005,30274,21555,8719,515,261,https://www.intensivregister.de/api/public/reporting/laendertabelle
1602309605,30270,21473,8797,521,269,https://www.intensivregister.de/api/public/reporting/laendertabelle
1602313205,30246,21461,8785,529,275,https://www.intensivregister.de/api/public/reporting/laendertabelle
1602316805,30266,21466,8800,533,278,https://www.intensivregister.de/api/public/reporting/laendertabelle
1602320405,30268,21437,8831,531,278,https://www.intensivregister.de/api/public/reporting/laendertabelle
1602324005,30272,21428,8844,532,279,https://www.intensivregister.de/api/public/reporting/laendertabelle
1602327605,30273,21425,8848,534,280,https://www.intensivregister.de/api/public/reporting/laendertabelle
1602331205,30276,21425,8851,534,280,https://www.intensivregister.de/api/public/reporting/laendertabelle
1602334805,30276,21423,8853,533,280,https://www.intensivregister.de/api/public/reporting/laendertabelle
1602338405,30276,21421,8855,533,280,https://www.intensivregister.de/api/public/reporting/laendertabelle
1602342005,30276,21416,8860,533,280,https://www.intensivregister.de/api/public/reporting/laendertabelle
1602356405,30276,21417,8859,533,280,https://www.intensivregister.de/api/public/reporting/laendertabelle
1602360005,30276,21415,8861,533,280,https://www.intensivregister.de/api/public/reporting/laendertabelle
1602363605,30272,21406,8866,533,280,https://www.intensivregister.de/api/public/reporting/laendertabelle
1602367205,30271,21403,8868,533,280,https://www.intensivregister.de/api/public/reporting/laendertabelle
1602370805,30279,21405,8874,532,280,https://www.intensivregister.de/api/public/reporting/laendertabelle
1602374405,30279,21403,8876,532,280,https://www.intensivregister.de/api/public/reporting/laendertabelle
1602381605,30277,21396,8881,532,280,https://www.intensivregister.de/api/public/reporting/laendertabelle
1602385205,30273,21374,8899,531,279,https://www.intensivregister.de/api/public/reporting/laendertabelle
1602388805,30256,21318,8938,532,281,https://www.intensivregister.de/api/public/reporting/laendertabelle
1602392405,30252,21168,9084,538,280,https://www.intensivregister.de/api/public/reporting/laendertabelle
1602396005,30241,21002,9239,536,280,https://www.intensivregister.de/api/public/reporting/laendertabelle
1602399605,30222,20921,9301,541,279,https://www.intensivregister.de/api/public/reporting/laendertabelle
1602403205,30203,20880,9323,544,276,https://www.intensivregister.de/api/public/reporting/laendertabelle
1602406805,30200,20878,9322,545,275,https://www.intensivregister.de/api/public/reporting/laendertabelle
1602410405,30200,20872,9328,545,275,https://www.intensivregister.de/api/public/reporting/laendertabelle
1602414005,30198,20867,9331,545,275,https://www.intensivregister.de/api/public/reporting/laendertabelle
1602417605,30198,20865,9333,546,275,https://www.intensivregister.de/api/public/reporting/laendertabelle
1602421205,30198,20863,9335,546,275,https://www.intensivregister.de/api/public/reporting/laendertabelle
1602424805,30198,20867,9331,547,277,https://www.intensivregister.de/api/public/reporting/laendertabelle
1602442805,30198,20861,9337,547,277,https://www.intensivregister.de/api/public/reporting/laendertabelle
1602446405,30198,20858,9340,548,277,https://www.intensivregister.de/api/public/reporting/laendertabelle
1602450005,30199,20852,9347,549,277,https://www.intensivregister.de/api/public/reporting/laendertabelle
1602453605,30199,20849,9350,550,278,https://www.intensivregister.de/api/public/reporting/laendertabelle
1602457205,30199,20853,9346,550,278,https://www.intensivregister.de/api/public/reporting/laendertabelle
1602460805,30200,20860,9340,550,278,https://www.intensivregister.de/api/public/reporting/laendertabelle
1602464405,30202,20860,9342,549,277,https://www.intensivregister.de/api/public/reporting/laendertabelle
1602468005,30205,20858,9347,549,277,https://www.intensivregister.de/api/public/reporting/laendertabelle
1602471605,30223,20829,9394,552,279,https://www.intensivregister.de/api/public/reporting/laendertabelle
1602475205,30263,20855,9408,559,280,https://www.intensivregister.de/api/public/reporting/laendertabelle
1602478805,30279,20882,9397,572,284,https://www.intensivregister.de/api/public/reporting/laendertabelle
1602482405,30262,20885,9377,568,278,https://www.intensivregister.de/api/public/reporting/laendertabelle
1602486005,30266,20918,9348,572,283,https://www.intensivregister.de/api/public/reporting/laendertabelle
1602489605,30236,20900,9336,590,286,https://www.intensivregister.de/api/public/reporting/laendertabelle
1602493205,30244,20901,9343,590,286,https://www.intensivregister.de/api/public/reporting/laendertabelle
1602496805,30244,20900,9344,590,286,https://www.intensivregister.de/api/public/reporting/laendertabelle
1602500405,30244,20897,9347,591,286,https://www.intensivregister.de/api/public/reporting/laendertabelle
1602504005,30244,20877,9367,587,286,https://www.intensivregister.de/api/public/reporting/laendertabelle
1602507605,30243,20871,9372,586,286,https://www.intensivregister.de/api/public/reporting/laendertabelle
1602511205,30243,20869,9374,585,287,https://www.intensivregister.de/api/public/reporting/laendertabelle
1602514805,30243,20870,9373,585,287,https://www.intensivregister.de/api/public/reporting/laendertabelle
1602522005,30238,20868,9370,585,287,https://www.intensivregister.de/api/public/reporting/laendertabelle
1602525605,30248,20877,9371,585,287,https://www.intensivregister.de/api/public/reporting/laendertabelle
1602529205,30248,20879,9369,585,287,https://www.intensivregister.de/api/public/reporting/laendertabelle
1602536405,30248,20876,9372,584,287,https://www.intensivregister.de/api/public/reporting/laendertabelle
1602540005,30248,20875,9373,584,287,https://www.intensivregister.de/api/public/reporting/laendertabelle
1602543605,30247,20870,9377,584,287,https://www.intensivregister.de/api/public/reporting/laendertabelle
1602547205,30247,20874,9373,584,287,https://www.intensivregister.de/api/public/reporting/laendertabelle
1602550805,30252,20878,9374,585,288,https://www.intensivregister.de/api/public/reporting/laendertabelle
1602554405,30256,20890,9366,586,288,https://www.intensivregister.de/api/public/reporting/laendertabelle
1602558005,30258,20956,9302,584,289,https://www.intensivregister.de/api/public/reporting/laendertabelle
1602561605,30278,21091,9187,592,294,https://www.intensivregister.de/api/public/reporting/laendertabelle
1602565205,30278,21194,9084,601,301,https://www.intensivregister.de/api/public/reporting/laendertabelle
1602568805,30277,21258,9019,605,308,https://www.intensivregister.de/api/public/reporting/laendertabelle
1602572405,30287,21302,8985,613,313,https://www.intensivregister.de/api/public/reporting/laendertabelle
1602576005,30276,21326,8950,616,318,https://www.intensivregister.de/api/public/reporting/laendertabelle
1602579605,30276,21329,8947,619,320,https://www.intensivregister.de/api/public/reporting/laendertabelle
1602583205,30276,21332,8944,621,320,https://www.intensivregister.de/api/public/reporting/laendertabelle
1602586805,30276,21328,8948,620,320,https://www.intensivregister.de/api/public/reporting/laendertabelle
1602590405,30275,21330,8945,620,320,https://www.intensivregister.de/api/public/reporting/laendertabelle
1602594005,30275,21335,8940,619,320,https://www.intensivregister.de/api/public/reporting/laendertabelle
1602601205,30275,21334,8941,619,320,https://www.intensivregister.de/api/public/reporting/laendertabelle
1602604805,30275,21336,8939,619,320,https://www.intensivregister.de/api/public/reporting/laendertabelle
1602612005,30275,21337,8938,619,320,https://www.intensivregister.de/api/public/reporting/laendertabelle
1602615605,30277,21340,8937,619,320,https://www.intensivregister.de/api/public/reporting/laendertabelle
1602622805,30277,21334,8943,619,320,https://www.intensivregister.de/api/public/reporting/laendertabelle
1602626405,30277,21337,8940,619,320,https://www.intensivregister.de/api/public/reporting/laendertabelle
1602630005,30274,21347,8927,619,320,https://www.intensivregister.de/api/public/reporting/laendertabelle
1602633605,30274,21351,8923,619,320,https://www.intensivregister.de/api/public/reporting/laendertabelle
1602637205,30275,21351,8924,619,320,https://www.intensivregister.de/api/public/reporting/laendertabelle
1602640805,30271,21354,8917,620,320,https://www.intensivregister.de/api/public/reporting/laendertabelle
1602644405,30266,21411,8855,625,322,https://www.intensivregister.de/api/public/reporting/laendertabelle
1602648005,30260,21434,8826,607,320,https://www.intensivregister.de/api/public/reporting/laendertabelle
1602651605,30251,21524,8727,603,321,https://www.intensivregister.de/api/public/reporting/laendertabelle
1602655205,30231,21528,8703,597,321,https://www.intensivregister.de/api/public/reporting/laendertabelle
1602658805,30217,21501,8716,601,322,https://www.intensivregister.de/api/public/reporting/laendertabelle
1602662405,30208,21493,8715,602,323,https://www.intensivregister.de/api/public/reporting/laendertabelle
1602666005,30207,21498,8709,603,324,https://www.intensivregister.de/api/public/reporting/laendertabelle
1602669605,30207,21500,8707,604,323,https://www.intensivregister.de/api/public/reporting/laendertabelle
1602673205,30209,21489,8720,604,323,https://www.intensivregister.de/api/public/reporting/laendertabelle
1602676805,30209,21480,8729,605,324,https://www.intensivregister.de/api/public/reporting/laendertabelle
1602680405,30209,21479,8730,604,324,https://www.intensivregister.de/api/public/reporting/laendertabelle
1602684005,30223,21488,8735,604,324,https://www.intensivregister.de/api/public/reporting/laendertabelle
1602687605,30223,21492,8731,604,324,https://www.intensivregister.de/api/public/reporting/laendertabelle
1602694805,30223,21491,8732,604,323,https://www.intensivregister.de/api/public/reporting/laendertabelle
1602709205,30223,21488,8735,604,323,https://www.intensivregister.de/api/public/reporting/laendertabelle
1602712805,30223,21493,8730,604,323,https://www.intensivregister.de/api/public/reporting/laendertabelle
1602716405,30224,21493,8731,604,323,https://www.intensivregister.de/api/public/reporting/laendertabelle
1602720005,30224,21492,8732,604,323,https://www.intensivregister.de/api/public/reporting/laendertabelle
1602723605,30224,21493,8731,604,323,https://www.intensivregister.de/api/public/reporting/laendertabelle
1602727205,30224,21489,8735,604,322,https://www.intensivregister.de/api/public/reporting/laendertabelle
1602730805,30226,21456,8770,616,323,https://www.intensivregister.de/api/public/reporting/laendertabelle
1602734405,30224,21482,8742,618,328,https://www.intensivregister.de/api/public/reporting/laendertabelle
1602738005,30229,21473,8756,626,325,https://www.intensivregister.de/api/public/reporting/laendertabelle
1602741605,30217,21463,8754,649,331,https://www.intensivregister.de/api/public/reporting/laendertabelle
1602745205,30236,21523,8713,653,329,https://www.intensivregister.de/api/public/reporting/laendertabelle
1602748805,30233,21523,8710,655,329,https://www.intensivregister.de/api/public/reporting/laendertabelle
1602752405,30232,21513,8719,659,332,https://www.intensivregister.de/api/public/reporting/laendertabelle
1602759605,30233,21513,8720,659,332,https://www.intensivregister.de/api/public/reporting/laendertabelle
1602763205,30233,21509,8724,659,332,https://www.intensivregister.de/api/public/reporting/laendertabelle
1602766805,30233,21504,8729,659,333,https://www.intensivregister.de/api/public/reporting/laendertabelle
1602770405,30233,21502,8731,659,333,https://www.intensivregister.de/api/public/reporting/laendertabelle
1602774005,30233,21504,8729,659,333,https://www.intensivregister.de/api/public/reporting/laendertabelle
1602777605,30233,21509,8724,659,333,https://www.intensivregister.de/api/public/reporting/laendertabelle
1602781205,30233,21507,8726,659,333,https://www.intensivregister.de/api/public/reporting/laendertabelle
1602795605,30240,21507,8733,659,333,https://www.intensivregister.de/api/public/reporting/laendertabelle
1602799205,30240,21507,8733,660,334,https://www.intensivregister.de/api/public/reporting/laendertabelle
1602802805,30243,21515,8728,660,334,https://www.intensivregister.de/api/public/reporting/laendertabelle
1602806405,30243,21511,8732,660,334,https://www.intensivregister.de/api/public/reporting/laendertabelle
1602810005,30248,21515,8733,658,334,https://www.intensivregister.de/api/public/reporting/laendertabelle
1602813605,30248,21522,8726,658,333,https://www.intensivregister.de/api/public/reporting/laendertabelle
1602817205,30248,21534,8714,660,331,https://www.intensivregister.de/api/public/reporting/laendertabelle
1602820805,30217,21518,8699,665,335,https://www.intensivregister.de/api/public/reporting/laendertabelle
1602824405,30220,21502,8718,685,345,https://www.intensivregister.de/api/public/reporting/laendertabelle
1602828005,30226,21593,8633,689,346,https://www.intensivregister.de/api/public/reporting/laendertabelle
1602831605,30231,21583,8648,691,344,https://www.intensivregister.de/api/public/reporting/laendertabelle
1602835205,30220,21561,8659,692,342,https://www.intensivregister.de/api/public/reporting/laendertabelle
1602838805,30224,21567,8657,688,340,https://www.intensivregister.de/api/public/reporting/laendertabelle
1602842405,30220,21559,8661,689,340,https://www.intensivregister.de/api/public/reporting/laendertabelle
1602846005,30220,21558,8662,689,341,https://www.intensivregister.de/api/public/reporting/laendertabelle
1602849605,30216,21557,8659,688,341,https://www.intensivregister.de/api/public/reporting/laendertabelle
1602853205,30216,21552,8664,688,341,https://www.intensivregister.de/api/public/reporting/laendertabelle
1602856805,30216,21554,8662,688,341,https://www.intensivregister.de/api/public/reporting/laendertabelle
1602860405,30216,21555,8661,688,341,https://www.intensivregister.de/api/public/reporting/laendertabelle
1602871205,30216,21550,8666,688,341,https://www.intensivregister.de/api/public/reporting/laendertabelle
1602874805,30216,21549,8667,688,341,https://www.intensivregister.de/api/public/reporting/laendertabelle
1602882005,30219,21554,8665,688,341,https://www.intensivregister.de/api/public/reporting/laendertabelle
1602885605,30219,21553,8666,688,341,https://www.intensivregister.de/api/public/reporting/laendertabelle
1602889205,30219,21552,8667,688,341,https://www.intensivregister.de/api/public/reporting/laendertabelle
1602892805,30216,21542,8674,688,341,https://www.intensivregister.de/api/public/reporting/laendertabelle
1602896405,30216,21545,8671,688,341,https://www.intensivregister.de/api/public/reporting/laendertabelle
1602900005,30218,21536,8682,689,341,https://www.intensivregister.de/api/public/reporting/laendertabelle
1602903605,30202,21526,8676,687,342,https://www.intensivregister.de/api/public/reporting/laendertabelle
1602907206,30179,21453,8726,681,339,https://www.intensivregister.de/api/public/reporting/laendertabelle
1602910805,30140,21416,8724,703,340,https://www.intensivregister.de/api/public/reporting/laendertabelle
1602914405,30111,21334,8777,718,345,https://www.intensivregister.de/api/public/reporting/laendertabelle
1602918005,30091,21311,8780,725,344,https://www.intensivregister.de/api/public/reporting/laendertabelle
1602921605,30084,21262,8822,729,344,https://www.intensivregister.de/api/public/reporting/laendertabelle
1602925205,30076,21237,8839,729,345,https://www.intensivregister.de/api/public/reporting/laendertabelle
1602928805,30073,21230,8843,732,345,https://www.intensivregister.de/api/public/reporting/laendertabelle
1602932405,30072,21231,8841,732,345,https://www.intensivregister.de/api/public/reporting/laendertabelle
1602936005,30072,21232,8840,731,345,https://www.intensivregister.de/api/public/reporting/laendertabelle
1602939605,30067,21230,8837,731,345,https://www.intensivregister.de/api/public/reporting/laendertabelle
1602946805,30067,21227,8840,731,345,https://www.intensivregister.de/api/public/reporting/laendertabelle
1602954005,30067,21226,8841,731,345,https://www.intensivregister.de/api/public/reporting/laendertabelle
1602957605,30067,21228,8839,731,345,https://www.intensivregister.de/api/public/reporting/laendertabelle
1602961205,30067,21227,8840,732,346,https://www.intensivregister.de/api/public/reporting/laendertabelle
1602964805,30067,21224,8843,732,346,https://www.intensivregister.de/api/public/reporting/laendertabelle
1602968405,30063,21216,8847,732,346,https://www.intensivregister.de/api/public/reporting/laendertabelle
1602975605,30064,21215,8849,733,346,https://www.intensivregister.de/api/public/reporting/laendertabelle
1602979205,30064,21204,8860,732,346,https://www.intensivregister.de/api/public/reporting/laendertabelle
1602982805,30064,21199,8865,733,347,https://www.intensivregister.de/api/public/reporting/laendertabelle
1602986405,30064,21195,8869,734,348,https://www.intensivregister.de/api/public/reporting/laendertabelle
1602990005,30063,21177,8886,733,347,https://www.intensivregister.de/api/public/reporting/laendertabelle
1602993605,30062,21093,8969,731,347,https://www.intensivregister.de/api/public/reporting/laendertabelle
1602997205,30063,20933,9130,737,351,https://www.intensivregister.de/api/public/reporting/laendertabelle
1603000805,30050,20825,9225,751,351,https://www.intensivregister.de/api/public/reporting/laendertabelle
1603004405,30032,20731,9301,759,354,https://www.intensivregister.de/api/public/reporting/laendertabelle
1603008005,30040,20675,9365,769,354,https://www.intensivregister.de/api/public/reporting/laendertabelle
1603011605,30041,20677,9364,771,355,https://www.intensivregister.de/api/public/reporting/laendertabelle
1603015205,30033,20666,9367,770,355,https://www.intensivregister.de/api/public/reporting/laendertabelle
1603018805,30033,20665,9368,770,355,https://www.intensivregister.de/api/public/reporting/laendertabelle
1603022405,30033,20660,9373,770,355,https://www.intensivregister.de/api/public/reporting/laendertabelle
1603026005,30033,20662,9371,769,354,https://www.intensivregister.de/api/public/reporting/laendertabelle
1603029605,30033,20661,9372,769,354,https://www.intensivregister.de/api/public/reporting/laendertabelle
1603033205,30032,20656,9376,768,354,https://www.intensivregister.de/api/public/reporting/laendertabelle
1603036805,30033,20652,9381,769,354,https://www.intensivregister.de/api/public/reporting/laendertabelle
1603047605,30033,20653,9380,769,354,https://www.intensivregister.de/api/public/reporting/laendertabelle
1603054805,30035,20655,9380,769,353,https://www.intensivregister.de/api/public/reporting/laendertabelle
1603058405,30033,20661,9372,769,353,https://www.intensivregister.de/api/public/reporting/laendertabelle
1603062005,30033,20662,9371,769,353,https://www.intensivregister.de/api/public/reporting/laendertabelle
1603065605,30033,20666,9367,769,353,https://www.intensivregister.de/api/public/reporting/laendertabelle
1603069205,30034,20666,9368,769,353,https://www.intensivregister.de/api/public/reporting/laendertabelle
1603072805,30039,20670,9369,770,354,https://www.intensivregister.de/api/public/reporting/laendertabelle
1603076405,30092,20713,9379,782,359,https://www.intensivregister.de/api/public/reporting/laendertabelle
1603080005,30118,20706,9412,797,364,https://www.intensivregister.de/api/public/reporting/laendertabelle
1603083605,30153,20726,9427,815,373,https://www.intensivregister.de/api/public/reporting/laendertabelle
1603087205,30143,20729,9414,830,378,https://www.intensivregister.de/api/public/reporting/laendertabelle
1603090805,30150,20761,9389,835,379,https://www.intensivregister.de/api/public/reporting/laendertabelle
1603094405,30170,20723,9447,850,389,https://www.intensivregister.de/api/public/reporting/laendertabelle
1603098005,30170,20727,9443,852,389,https://www.intensivregister.de/api/public/reporting/laendertabelle
1603101605,30170,20714,9456,852,389,https://www.intensivregister.de/api/public/reporting/laendertabelle
1603105205,30170,20714,9456,853,389,https://www.intensivregister.de/api/public/reporting/laendertabelle
1603108805,30168,20714,9454,853,389,https://www.intensivregister.de/api/public/reporting/laendertabelle
1603112405,30168,20715,9453,854,389,https://www.intensivregister.de/api/public/reporting/laendertabelle
1603116005,30168,20712,9456,854,388,https://www.intensivregister.de/api/public/reporting/laendertabelle
1603119605,30169,20715,9454,855,388,https://www.intensivregister.de/api/public/reporting/laendertabelle
1603123205,30169,20717,9452,855,388,https://www.intensivregister.de/api/public/reporting/laendertabelle
1603126805,30169,20716,9453,856,388,https://www.intensivregister.de/api/public/reporting/laendertabelle
1603130405,30169,20712,9457,855,387,https://www.intensivregister.de/api/public/reporting/laendertabelle
1603137605,30170,20717,9453,855,387,https://www.intensivregister.de/api/public/reporting/laendertabelle
1603141205,30170,20717,9453,856,387,https://www.intensivregister.de/api/public/reporting/laendertabelle
1603144805,30170,20725,9445,856,387,https://www.intensivregister.de/api/public/reporting/laendertabelle
1603148405,30173,20726,9447,856,388,https://www.intensivregister.de/api/public/reporting/laendertabelle
1603152005,30173,20730,9443,857,388,https://www.intensivregister.de/api/public/reporting/laendertabelle
1603155605,30173,20739,9434,855,388,https://www.intensivregister.de/api/public/reporting/laendertabelle
1603159205,30168,20745,9423,853,389,https://www.intensivregister.de/api/public/reporting/laendertabelle
1603162805,30169,20843,9326,855,393,https://www.intensivregister.de/api/public/reporting/laendertabelle
1603166405,30168,20955,9213,863,399,https://www.intensivregister.de/api/public/reporting/laendertabelle
1603170005,30180,21141,9039,875,405,https://www.intensivregister.de/api/public/reporting/laendertabelle
1603173605,30199,21236,8963,880,410,https://www.intensivregister.de/api/public/reporting/laendertabelle
1603177205,30177,21271,8906,878,411,https://www.intensivregister.de/api/public/reporting/laendertabelle
1603180805,30190,21309,8881,879,411,https://www.intensivregister.de/api/public/reporting/laendertabelle
1603184405,30190,21316,8874,880,411,https://www.intensivregister.de/api/public/reporting/laendertabelle
1603188005,30188,21318,8870,881,412,https://www.intensivregister.de/api/public/reporting/laendertabelle
1603191605,30195,21322,8873,881,412,https://www.intensivregister.de/api/public/reporting/laendertabelle
1603195205,30189,21311,8878,880,412,https://www.intensivregister.de/api/public/reporting/laendertabelle
1603198805,30189,21323,8866,880,412,https://www.intensivregister.de/api/public/reporting/laendertabelle
1603202405,30184,21317,8867,880,413,https://www.intensivregister.de/api/public/reporting/laendertabelle
1603209605,30184,21318,8866,880,413,https://www.intensivregister.de/api/public/reporting/laendertabelle
1603213205,30178,21318,8860,880,413,https://www.intensivregister.de/api/public/reporting/laendertabelle
1603220405,30178,21319,8859,881,413,https://www.intensivregister.de/api/public/reporting/laendertabelle
1603224005,30178,21316,8862,881,413,https://www.intensivregister.de/api/public/reporting/laendertabelle
1603227605,30172,21314,8858,883,414,https://www.intensivregister.de/api/public/reporting/laendertabelle
1603231205,30171,21312,8859,883,414,https://www.intensivregister.de/api/public/reporting/laendertabelle
1603234805,30171,21313,8858,883,414,https://www.intensivregister.de/api/public/reporting/laendertabelle
1603238405,30168,21305,8863,883,414,https://www.intensivregister.de/api/public/reporting/laendertabelle
1603242005,30167,21304,8863,883,414,https://www.intensivregister.de/api/public/reporting/laendertabelle
1603245605,30167,21310,8857,886,415,https://www.intensivregister.de/api/public/reporting/laendertabelle
1603249205,30139,21324,8815,880,413,https://www.intensivregister.de/api/public/reporting/laendertabelle
1603252805,30071,21343,8728,889,419,https://www.intensivregister.de/api/public/reporting/laendertabelle
1603256405,30000,21369,8631,884,420,https://www.intensivregister.de/api/public/reporting/laendertabelle
1603260005,29951,21386,8565,902,419,https://www.intensivregister.de/api/public/reporting/laendertabelle
1603263605,29936,21397,8539,908,421,https://www.intensivregister.de/api/public/reporting/laendertabelle
1603267205,29899,21418,8481,943,425,https://www.intensivregister.de/api/public/reporting/laendertabelle
1603270805,29859,21401,8458,947,426,https://www.intensivregister.de/api/public/reporting/laendertabelle
1603278005,29853,21403,8450,946,426,https://www.intensivregister.de/api/public/reporting/laendertabelle
1603281605,29864,21412,8452,945,426,https://www.intensivregister.de/api/public/reporting/laendertabelle
1603285205,29864,21411,8453,946,426,https://www.intensivregister.de/api/public/reporting/laendertabelle
1603288805,29863,21414,8449,946,426,https://www.intensivregister.de/api/public/reporting/laendertabelle
1603306805,29861,21412,8449,947,426,https://www.intensivregister.de/api/public/reporting/laendertabelle
1603310405,29861,21410,8451,947,426,https://www.intensivregister.de/api/public/reporting/laendertabelle
1603314005,29859,21399,8460,949,427,https://www.intensivregister.de/api/public/reporting/laendertabelle
1603317605,29859,21402,8457,949,427,https://www.intensivregister.de/api/public/reporting/laendertabelle
1603321205,29859,21404,8455,949,427,https://www.intensivregister.de/api/public/reporting/laendertabelle
1603324805,29859,21405,8454,949,427,https://www.intensivregister.de/api/public/reporting/laendertabelle
1603328405,29859,21407,8452,947,427,https://www.intensivregister.de/api/public/reporting/laendertabelle
1603332005,29857,21409,8448,950,427,https://www.intensivregister.de/api/public/reporting/laendertabelle
1603335605,29825,21438,8387,964,430,https://www.intensivregister.de/api/public/reporting/laendertabelle
1603339205,29799,21401,8398,983,438,https://www.intensivregister.de/api/public/reporting/laendertabelle
1603342805,29782,21377,8405,997,447,https://www.intensivregister.de/api/public/reporting/laendertabelle
1603346405,29754,21392,8362,1015,450,https://www.intensivregister.de/api/public/reporting/laendertabelle
1603350005,29687,21431,8256,1015,453,https://www.intensivregister.de/api/public/reporting/laendertabelle
1603353605,29673,21480,8193,1029,459,https://www.intensivregister.de/api/public/reporting/laendertabelle
1603357205,29660,21467,8193,1030,459,https://www.intensivregister.de/api/public/reporting/laendertabelle
1603360805,29660,21461,8199,1030,460,https://www.intensivregister.de/api/public/reporting/laendertabelle
1603364405,29652,21461,8191,1031,462,https://www.intensivregister.de/api/public/reporting/laendertabelle
1603368005,29651,21463,8188,1031,462,https://www.intensivregister.de/api/public/reporting/laendertabelle
1603371605,29653,21459,8194,1032,462,https://www.intensivregister.de/api/public/reporting/laendertabelle
1603375205,29697,21499,8198,1032,462,https://www.intensivregister.de/api/public/reporting/laendertabelle
1603378805,29694,21496,8198,1033,464,https://www.intensivregister.de/api/public/reporting/laendertabelle
1603382405,29694,21494,8200,1033,464,https://www.intensivregister.de/api/public/reporting/laendertabelle
1603389605,29694,21495,8199,1034,464,https://www.intensivregister.de/api/public/reporting/laendertabelle
1603393205,29694,21492,8202,1034,464,https://www.intensivregister.de/api/public/reporting/laendertabelle
1603396805,29693,21491,8202,1034,464,https://www.intensivregister.de/api/public/reporting/laendertabelle
1603400405,29696,21502,8194,1034,463,https://www.intensivregister.de/api/public/reporting/laendertabelle
1603404005,29694,21502,8192,1035,464,https://www.intensivregister.de/api/public/reporting/laendertabelle
1603407605,29694,21501,8193,1035,464,https://www.intensivregister.de/api/public/reporting/laendertabelle
1603411205,29693,21505,8188,1035,465,https://www.intensivregister.de/api/public/reporting/laendertabelle
1603414805,29693,21515,8178,1035,465,https://www.intensivregister.de/api/public/reporting/laendertabelle
1603418405,29693,21521,8172,1039,466,https://www.intensivregister.de/api/public/reporting/laendertabelle
1603422005,29677,21546,8131,1040,464,https://www.intensivregister.de/api/public/reporting/laendertabelle
1603425605,29641,21591,8050,1054,474,https://www.intensivregister.de/api/public/reporting/laendertabelle
1603429205,29591,21737,7854,1084,471,https://www.intensivregister.de/api/public/reporting/laendertabelle
1603432805,29570,21775,7795,1109,467,https://www.intensivregister.de/api/public/reporting/laendertabelle
1603436405,29541,21766,7775,1115,474,https://www.intensivregister.de/api/public/reporting/laendertabelle
1603440005,29519,21736,7783,1122,478,https://www.intensivregister.de/api/public/reporting/laendertabelle
1603443605,29502,21734,7768,1121,479,https://www.intensivregister.de/api/public/reporting/laendertabelle
1603447205,29498,21718,7780,1122,480,https://www.intensivregister.de/api/public/reporting/laendertabelle
1603450805,29486,21713,7773,1121,479,https://www.intensivregister.de/api/public/reporting/laendertabelle
1603454405,29484,21708,7776,1120,479,https://www.intensivregister.de/api/public/reporting/laendertabelle
1603458005,29483,21706,7777,1120,484,https://www.intensivregister.de/api/public/reporting/laendertabelle
1603461605,29479,21713,7766,1120,484,https://www.intensivregister.de/api/public/reporting/laendertabelle
1603465205,29483,21710,7773,1119,484,https://www.intensivregister.de/api/public/reporting/laendertabelle
1603468805,29483,21703,7780,1119,484,https://www.intensivregister.de/api/public/reporting/laendertabelle
1603472405,29483,21699,7784,1119,484,https://www.intensivregister.de/api/public/reporting/laendertabelle
1603476005,29483,21697,7786,1118,484,https://www.intensivregister.de/api/public/reporting/laendertabelle
1603479605,29483,21695,7788,1118,485,https://www.intensivregister.de/api/public/reporting/laendertabelle
1603483205,29481,21693,7788,1118,485,https://www.intensivregister.de/api/public/reporting/laendertabelle
1603486805,29472,21675,7797,1117,483,https://www.intensivregister.de/api/public/reporting/laendertabelle
1603490405,29472,21678,7794,1118,484,https://www.intensivregister.de/api/public/reporting/laendertabelle
1603494005,29481,21674,7807,1118,484,https://www.intensivregister.de/api/public/reporting/laendertabelle
1603501205,29480,21673,7807,1121,484,https://www.intensivregister.de/api/public/reporting/laendertabelle
1603504805,29480,21661,7819,1119,484,https://www.intensivregister.de/api/public/reporting/laendertabelle
1603508405,29481,21656,7825,1113,482,https://www.intensivregister.de/api/public/reporting/laendertabelle
1603512005,29451,21649,7802,1119,487,https://www.intensivregister.de/api/public/reporting/laendertabelle
1603515605,29447,21611,7836,1151,503,https://www.intensivregister.de/api/public/reporting/laendertabelle
1603519205,29405,21508,7897,1165,507,https://www.intensivregister.de/api/public/reporting/laendertabelle
1603522805,29383,21487,7896,1188,524,https://www.intensivregister.de/api/public/reporting/laendertabelle
1603526405,29358,21423,7935,1201,533,https://www.intensivregister.de/api/public/reporting/laendertabelle
1603530005,29350,21411,7939,1205,533,https://www.intensivregister.de/api/public/reporting/laendertabelle
1603533605,29350,21414,7936,1207,530,https://www.intensivregister.de/api/public/reporting/laendertabelle
1603537205,29350,21417,7933,1208,530,https://www.intensivregister.de/api/public/reporting/laendertabelle
1603540805,29350,21408,7942,1208,532,https://www.intensivregister.de/api/public/reporting/laendertabelle
1603548005,29350,21405,7945,1206,531,https://www.intensivregister.de/api/public/reporting/laendertabelle
1603551605,29350,21407,7943,1203,529,https://www.intensivregister.de/api/public/reporting/laendertabelle
1603555205,29350,21410,7940,1204,530,https://www.intensivregister.de/api/public/reporting/laendertabelle
1603558805,29350,21409,7941,1205,531,https://www.intensivregister.de/api/public/reporting/laendertabelle
1603562405,29350,21409,7941,1206,531,https://www.intensivregister.de/api/public/reporting/laendertabelle
1603566005,29350,21410,7940,1206,531,https://www.intensivregister.de/api/public/reporting/laendertabelle
1603569605,29342,21403,7939,1206,531,https://www.intensivregister.de/api/public/reporting/laendertabelle
1603573205,29339,21391,7948,1210,532,https://www.intensivregister.de/api/public/reporting/laendertabelle
1603580405,29335,21407,7928,1211,532,https://www.intensivregister.de/api/public/reporting/laendertabelle
1603587605,29336,21403,7933,1211,532,https://www.intensivregister.de/api/public/reporting/laendertabelle
1603591205,29337,21398,7939,1211,532,https://www.intensivregister.de/api/public/reporting/laendertabelle
1603594805,29337,21395,7942,1210,533,https://www.intensivregister.de/api/public/reporting/laendertabelle
1603598405,29337,21389,7948,1210,534,https://www.intensivregister.de/api/public/reporting/laendertabelle
1603602005,29345,21318,8027,1211,534,https://www.intensivregister.de/api/public/reporting/laendertabelle
1603605605,29325,21224,8101,1228,540,https://www.intensivregister.de/api/public/reporting/laendertabelle
1603609205,29305,21070,8235,1242,554,https://www.intensivregister.de/api/public/reporting/laendertabelle
1603612805,29302,20980,8322,1259,566,https://www.intensivregister.de/api/public/reporting/laendertabelle
1603616405,29299,20947,8352,1283,568,https://www.intensivregister.de/api/public/reporting/laendertabelle
1603620005,29294,20907,8387,1294,578,https://www.intensivregister.de/api/public/reporting/laendertabelle
1603623605,29294,20898,8396,1295,578,https://www.intensivregister.de/api/public/reporting/laendertabelle
1603627205,29284,20897,8387,1297,578,https://www.intensivregister.de/api/public/reporting/laendertabelle
1603630805,29285,20884,8401,1299,579,https://www.intensivregister.de/api/public/reporting/laendertabelle
1603634405,29285,20883,8402,1300,579,https://www.intensivregister.de/api/public/reporting/laendertabelle
1603638005,29285,20884,8401,1300,579,https://www.intensivregister.de/api/public/reporting/laendertabelle
1603641605,29286,20877,8409,1300,580,https://www.intensivregister.de/api/public/reporting/laendertabelle
1603645205,29286,20875,8411,1302,583,https://www.intensivregister.de/api/public/reporting/laendertabelle
1603648805,29286,20872,8414,1303,583,https://www.intensivregister.de/api/public/reporting/laendertabelle
1603652405,29281,20877,8404,1303,583,https://www.intensivregister.de/api/public/reporting/laendertabelle
1603656005,29283,20875,8408,1303,583,https://www.intensivregister.de/api/public/reporting/laendertabelle
1603659605,29283,20878,8405,1304,584,https://www.intensivregister.de/api/public/reporting/laendertabelle
1603663205,29283,20879,8404,1304,584,https://www.intensivregister.de/api/public/reporting/laendertabelle
1603666805,29283,20877,8406,1303,585,https://www.intensivregister.de/api/public/reporting/laendertabelle
1603670405,29283,20871,8412,1303,586,https://www.intensivregister.de/api/public/reporting/laendertabelle
1603674005,29289,20870,8419,1303,586,https://www.intensivregister.de/api/public/reporting/laendertabelle
1603677605,29289,20873,8416,1303,586,https://www.intensivregister.de/api/public/reporting/laendertabelle
1603681205,29291,20878,8413,1302,585,https://www.intensivregister.de/api/public/reporting/laendertabelle
1603684805,29283,20883,8400,1298,584,https://www.intensivregister.de/api/public/reporting/laendertabelle
1603688405,29321,20864,8457,1303,589,https://www.intensivregister.de/api/public/reporting/laendertabelle
1603692005,29306,20865,8441,1304,592,https://www.intensivregister.de/api/public/reporting/laendertabelle
1603695605,29332,20894,8438,1315,608,https://www.intensivregister.de/api/public/reporting/laendertabelle
1603699205,29390,20945,8445,1340,614,https://www.intensivregister.de/api/public/reporting/laendertabelle
1603702805,29403,20997,8406,1354,621,https://www.intensivregister.de/api/public/reporting/laendertabelle
1603706405,29425,21022,8403,1362,622,https://www.intensivregister.de/api/public/reporting/laendertabelle
1603710005,29395,21031,8364,1367,623,https://www.intensivregister.de/api/public/reporting/laendertabelle
1603713605,29398,21027,8371,1369,625,https://www.intensivregister.de/api/public/reporting/laendertabelle
1603717205,29398,21040,8358,1370,624,https://www.intensivregister.de/api/public/reporting/laendertabelle
1603720805,29394,21061,8333,1370,623,https://www.intensivregister.de/api/public/reporting/laendertabelle
1603724405,29398,21066,8332,1370,623,https://www.intensivregister.de/api/public/reporting/laendertabelle
1603728005,29420,21069,8351,1372,623,https://www.intensivregister.de/api/public/reporting/laendertabelle
1603731605,29420,21068,8352,1372,623,https://www.intensivregister.de/api/public/reporting/laendertabelle
1603735205,29420,21067,8353,1372,623,https://www.intensivregister.de/api/public/reporting/laendertabelle
1603738805,29420,21065,8355,1372,623,https://www.intensivregister.de/api/public/reporting/laendertabelle
1603742405,29420,21064,8356,1371,622,https://www.intensivregister.de/api/public/reporting/laendertabelle
1603746007,29420,21066,8354,1371,622,https://www.intensivregister.de/api/public/reporting/laendertabelle
1603753205,29417,21071,8346,1372,622,https://www.intensivregister.de/api/public/reporting/laendertabelle
1603760405,29417,21073,8344,1372,622,https://www.intensivregister.de/api/public/reporting/laendertabelle
1603767605,29417,21074,8343,1373,622,https://www.intensivregister.de/api/public/reporting/laendertabelle
1603771205,29419,21069,8350,1371,622,https://www.intensivregister.de/api/public/reporting/laendertabelle
1603774805,29423,21173,8250,1378,628,https://www.intensivregister.de/api/public/reporting/laendertabelle
1603778405,29414,21308,8106,1418,642,https://www.intensivregister.de/api/public/reporting/laendertabelle
1603782005,29411,21527,7884,1432,653,https://www.intensivregister.de/api/public/reporting/laendertabelle
1603785605,29414,21647,7767,1451,670,https://www.intensivregister.de/api/public/reporting/laendertabelle
1603789205,29411,21676,7735,1457,679,https://www.intensivregister.de/api/public/reporting/laendertabelle
1603792805,29399,21718,7681,1469,685,https://www.intensivregister.de/api/public/reporting/laendertabelle
1603796405,29393,21724,7669,1470,689,https://www.intensivregister.de/api/public/reporting/laendertabelle
1603800005,29384,21717,7667,1474,690,https://www.intensivregister.de/api/public/reporting/laendertabelle
1603803605,29376,21720,7656,1470,691,https://www.intensivregister.de/api/public/reporting/laendertabelle
1603807205,29383,21727,7656,1470,692,https://www.intensivregister.de/api/public/reporting/laendertabelle
1603810805,29390,21735,7655,1469,694,https://www.intensivregister.de/api/public/reporting/laendertabelle
1603814405,29390,21734,7656,1472,693,https://www.intensivregister.de/api/public/reporting/laendertabelle
1603818005,29392,21734,7658,1473,694,https://www.intensivregister.de/api/public/reporting/laendertabelle
1603821605,29390,21737,7653,1474,695,https://www.intensivregister.de/api/public/reporting/laendertabelle
1603825205,29390,21737,7653,1475,695,https://www.intensivregister.de/api/public/reporting/laendertabelle
1603832405,29390,21738,7652,1476,696,https://www.intensivregister.de/api/public/reporting/laendertabelle
1603836005,29390,21734,7656,1477,697,https://www.intensivregister.de/api/public/reporting/laendertabelle
1603839605,29392,21732,7660,1477,697,https://www.intensivregister.de/api/public/reporting/laendertabelle
1603843205,29392,21731,7661,1477,697,https://www.intensivregister.de/api/public/reporting/laendertabelle
1603846805,29392,21733,7659,1477,697,https://www.intensivregister.de/api/public/reporting/laendertabelle
1603850405,29398,21734,7664,1477,697,https://www.intensivregister.de/api/public/reporting/laendertabelle
1603854005,29398,21732,7666,1474,698,https://www.intensivregister.de/api/public/reporting/laendertabelle
1603857605,29398,21740,7658,1474,699,https://www.intensivregister.de/api/public/reporting/laendertabelle
1603861205,29389,21747,7642,1481,698,https://www.intensivregister.de/api/public/reporting/laendertabelle
1603864805,29371,21765,7606,1489,710,https://www.intensivregister.de/api/public/reporting/laendertabelle
1603868405,29363,21773,7590,1526,732,https://www.intensivregister.de/api/public/reporting/laendertabelle
1603872005,29325,21780,7545,1547,751,https://www.intensivregister.de/api/public/reporting/laendertabelle
1603875605,29314,21772,7542,1550,758,https://www.intensivregister.de/api/public/reporting/laendertabelle
1603879205,29340,21798,7542,1570,764,https://www.intensivregister.de/api/public/reporting/laendertabelle
1603882805,29336,21792,7544,1570,764,https://www.intensivregister.de/api/public/reporting/laendertabelle
1603886405,29338,21787,7551,1574,766,https://www.intensivregister.de/api/public/reporting/laendertabelle
1603890005,29322,21770,7552,1576,766,https://www.intensivregister.de/api/public/reporting/laendertabelle
1603893605,29322,21770,7552,1574,767,https://www.intensivregister.de/api/public/reporting/laendertabelle
1603897205,29320,21772,7548,1573,768,https://www.intensivregister.de/api/public/reporting/laendertabelle
1603900805,29320,21769,7551,1577,768,https://www.intensivregister.de/api/public/reporting/laendertabelle
1603904405,29320,21773,7547,1577,768,https://www.intensivregister.de/api/public/reporting/laendertabelle
1603911605,29320,21774,7546,1576,769,https://www.intensivregister.de/api/public/reporting/laendertabelle
1603915205,29320,21774,7546,1577,770,https://www.intensivregister.de/api/public/reporting/laendertabelle
1603922405,29320,21775,7545,1578,771,https://www.intensivregister.de/api/public/reporting/laendertabelle
1603926005,29324,21767,7557,1577,773,https://www.intensivregister.de/api/public/reporting/laendertabelle
1603929605,29324,21769,7555,1578,774,https://www.intensivregister.de/api/public/reporting/laendertabelle
1603933206,29324,21770,7554,1578,774,https://www.intensivregister.de/api/public/reporting/laendertabelle
1603936805,29324,21778,7546,1578,774,https://www.intensivregister.de/api/public/reporting/laendertabelle
1603940405,29324,21781,7543,1578,774,https://www.intensivregister.de/api/public/reporting/laendertabelle
1603944005,29327,21777,7550,1579,774,https://www.intensivregister.de/api/public/reporting/laendertabelle
1603947605,29358,21762,7596,1579,774,https://www.intensivregister.de/api/public/reporting/laendertabelle
1603951205,29355,21782,7573,1632,796,https://www.intensivregister.de/api/public/reporting/laendertabelle
1603954805,29361,21805,7556,1662,806,https://www.intensivregister.de/api/public/reporting/laendertabelle
1603958405,29356,21807,7549,1669,811,https://www.intensivregister.de/api/public/reporting/laendertabelle
1603962005,29363,21827,7536,1689,817,https://www.intensivregister.de/api/public/reporting/laendertabelle
1603965605,29344,21787,7557,1696,827,https://www.intensivregister.de/api/public/reporting/laendertabelle
1603969205,29338,21771,7567,1696,828,https://www.intensivregister.de/api/public/reporting/laendertabelle
1603972805,29342,21761,7581,1697,829,https://www.intensivregister.de/api/public/reporting/laendertabelle
1603976405,29343,21762,7581,1700,829,https://www.intensivregister.de/api/public/reporting/laendertabelle
1603980005,29343,21758,7585,1699,829,https://www.intensivregister.de/api/public/reporting/laendertabelle
1603983605,29321,21741,7580,1703,832,https://www.intensivregister.de/api/public/reporting/laendertabelle
1603987205,29321,21731,7590,1700,832,https://www.intensivregister.de/api/public/reporting/laendertabelle
1603990805,29321,21737,7584,1701,832,https://www.intensivregister.de/api/public/reporting/laendertabelle
1603994405,29321,21737,7584,1699,832,https://www.intensivregister.de/api/public/reporting/laendertabelle
1603998005,29321,21735,7586,1700,832,https://www.intensivregister.de/api/public/reporting/laendertabelle
1604008805,29321,21737,7584,1700,832,https://www.intensivregister.de/api/public/reporting/laendertabelle
1604012405,29322,21737,7585,1703,833,https://www.intensivregister.de/api/public/reporting/laendertabelle
1604019605,29322,21739,7583,1704,834,https://www.intensivregister.de/api/public/reporting/laendertabelle
1604023205,29322,21732,7590,1705,835,https://www.intensivregister.de/api/public/reporting/laendertabelle
1604026805,29322,21735,7587,1705,835,https://www.intensivregister.de/api/public/reporting/laendertabelle
1604030405,29322,21721,7601,1706,834,https://www.intensivregister.de/api/public/reporting/laendertabelle
1604034005,29320,21746,7574,1711,832,https://www.intensivregister.de/api/public/reporting/laendertabelle
1604037605,29304,21718,7586,1740,869,https://www.intensivregister.de/api/public/reporting/laendertabelle
1604041205,29262,21690,7572,1773,887,https://www.intensivregister.de/api/public/reporting/laendertabelle
1604044805,29253,21685,7568,1809,906,https://www.intensivregister.de/api/public/reporting/laendertabelle
1604048405,29250,21694,7556,1818,907,https://www.intensivregister.de/api/public/reporting/laendertabelle
1604052005,29231,21696,7535,1844,920,https://www.intensivregister.de/api/public/reporting/laendertabelle
1604055605,29251,21708,7543,1840,921,https://www.intensivregister.de/api/public/reporting/laendertabelle
1604059205,29250,21706,7544,1840,922,https://www.intensivregister.de/api/public/reporting/laendertabelle
1604062805,29245,21712,7533,1843,922,https://www.intensivregister.de/api/public/reporting/laendertabelle
1604066405,29239,21712,7527,1846,922,https://www.intensivregister.de/api/public/reporting/laendertabelle
1604070005,29239,21705,7534,1848,923,https://www.intensivregister.de/api/public/reporting/laendertabelle
1604073605,29239,21708,7531,1852,927,https://www.intensivregister.de/api/public/reporting/laendertabelle
1604077205,29239,21706,7533,1852,926,https://www.intensivregister.de/api/public/reporting/laendertabelle
1604080805,29239,21708,7531,1856,927,https://www.intensivregister.de/api/public/reporting/laendertabelle
1604084405,29239,21707,7532,1857,927,https://www.intensivregister.de/api/public/reporting/laendertabelle
1604088005,29238,21706,7532,1858,927,https://www.intensivregister.de/api/public/reporting/laendertabelle
1604091605,29238,21708,7530,1858,927,https://www.intensivregister.de/api/public/reporting/laendertabelle
1604095205,29237,21707,7530,1858,927,https://www.intensivregister.de/api/public/reporting/laendertabelle
1604098805,29241,21699,7542,1859,928,https://www.intensivregister.de/api/public/reporting/laendertabelle
1604102405,29241,21705,7536,1861,930,https://www.intensivregister.de/api/public/reporting/laendertabelle
1604106005,29241,21709,7532,1861,930,https://www.intensivregister.de/api/public/reporting/laendertabelle
1604109605,29241,21718,7523,1862,930,https://www.intensivregister.de/api/public/reporting/laendertabelle
1604113205,29241,21710,7531,1863,930,https://www.intensivregister.de/api/public/reporting/laendertabelle
1604116805,29237,21704,7533,1862,931,https://www.intensivregister.de/api/public/reporting/laendertabelle
1604120405,29226,21708,7518,1865,933,https://www.intensivregister.de/api/public/reporting/laendertabelle
1604124005,29185,21641,7544,1868,941,https://www.intensivregister.de/api/public/reporting/laendertabelle
1604127605,29143,21549,7594,1893,956,https://www.intensivregister.de/api/public/reporting/laendertabelle
1604131205,29102,21426,7676,1905,966,https://www.intensivregister.de/api/public/reporting/laendertabelle
1604134805,29088,21394,7694,1928,990,https://www.intensivregister.de/api/public/reporting/laendertabelle
1604138405,29006,21322,7684,1945,1003,https://www.intensivregister.de/api/public/reporting/laendertabelle
1604142005,29001,21315,7686,1949,1005,https://www.intensivregister.de/api/public/reporting/laendertabelle
1604145605,29000,21317,7683,1952,1005,https://www.intensivregister.de/api/public/reporting/laendertabelle
1604149205,28998,21298,7700,1955,1008,https://www.intensivregister.de/api/public/reporting/laendertabelle
1604152805,28998,21287,7711,1955,1008,https://www.intensivregister.de/api/public/reporting/laendertabelle
1604156405,28996,21278,7718,1954,1007,https://www.intensivregister.de/api/public/reporting/laendertabelle
1604160005,28996,21276,7720,1955,1007,https://www.intensivregister.de/api/public/reporting/laendertabelle
1604163605,28994,21275,7719,1957,1007,https://www.intensivregister.de/api/public/reporting/laendertabelle
1604167205,28994,21276,7718,1959,1008,https://www.intensivregister.de/api/public/reporting/laendertabelle
1604170805,28994,21275,7719,1959,1008,https://www.intensivregister.de/api/public/reporting/laendertabelle
1604178005,28994,21275,7719,1962,1009,https://www.intensivregister.de/api/public/reporting/laendertabelle
1604181605,28995,21274,7721,1962,1009,https://www.intensivregister.de/api/public/reporting/laendertabelle
1604185205,28993,21259,7734,1964,1011,https://www.intensivregister.de/api/public/reporting/laendertabelle
1604188805,28993,21255,7738,1964,1011,https://www.intensivregister.de/api/public/reporting/laendertabelle
1604192405,28993,21253,7740,1963,1012,https://www.intensivregister.de/api/public/reporting/laendertabelle
1604196005,28993,21251,7742,1964,1013,https://www.intensivregister.de/api/public/reporting/laendertabelle
1604199605,28993,21253,7740,1965,1013,https://www.intensivregister.de/api/public/reporting/laendertabelle
1604203205,28993,21250,7743,1965,1013,https://www.intensivregister.de/api/public/reporting/laendertabelle
1604206805,28993,21233,7760,1967,1014,https://www.intensivregister.de/api/public/reporting/laendertabelle
1604210405,28989,21189,7800,1976,1015,https://www.intensivregister.de/api/public/reporting/laendertabelle
1604214005,28987,21139,7848,2011,1034,https://www.intensivregister.de/api/public/reporting/laendertabelle
1604217605,28949,21039,7910,2027,1056,https://www.intensivregister.de/api/public/reporting/laendertabelle
1604221205,28962,21034,7928,2039,1069,https://www.intensivregister.de/api/public/reporting/laendertabelle
1604224805,28957,20982,7975,2061,1086,https://www.intensivregister.de/api/public/reporting/laendertabelle
1604228405,28956,20969,7987,2066,1087,https://www.intensivregister.de/api/public/reporting/laendertabelle
1604232005,28957,20973,7984,2069,1088,https://www.intensivregister.de/api/public/reporting/laendertabelle
1604235605,28957,20969,7988,2070,1088,https://www.intensivregister.de/api/public/reporting/laendertabelle
1604239205,28958,20968,7990,2069,1088,https://www.intensivregister.de/api/public/reporting/laendertabelle
1604242805,28958,20967,7991,2069,1087,https://www.intensivregister.de/api/public/reporting/laendertabelle
1604246405,28958,20966,7992,2070,1088,https://www.intensivregister.de/api/public/reporting/laendertabelle
1604250005,28956,20966,7990,2070,1089,https://www.intensivregister.de/api/public/reporting/laendertabelle
1604253605,28956,20967,7989,2069,1089,https://www.intensivregister.de/api/public/reporting/laendertabelle
1604257205,28958,20965,7993,2070,1091,https://www.intensivregister.de/api/public/reporting/laendertabelle
1604260805,28961,20967,7994,2071,1092,https://www.intensivregister.de/api/public/reporting/laendertabelle
1604271605,28961,20962,7999,2074,1093,https://www.intensivregister.de/api/public/reporting/laendertabelle
1604275205,28950,20942,8008,2074,1093,https://www.intensivregister.de/api/public/reporting/laendertabelle
1604278805,28949,20941,8008,2074,1092,https://www.intensivregister.de/api/public/reporting/laendertabelle
1604282405,28947,20944,8003,2074,1091,https://www.intensivregister.de/api/public/reporting/laendertabelle
1604286005,28947,20951,7996,2073,1090,https://www.intensivregister.de/api/public/reporting/laendertabelle
1604289605,28952,20947,8005,2074,1090,https://www.intensivregister.de/api/public/reporting/laendertabelle
1604293205,28960,20943,8017,2089,1092,https://www.intensivregister.de/api/public/reporting/laendertabelle
1604296805,29040,20990,8050,2130,1108,https://www.intensivregister.de/api/public/reporting/laendertabelle
1604300405,28983,20918,8065,2174,1130,https://www.intensivregister.de/api/public/reporting/laendertabelle
1604304005,28929,20913,8016,2200,1148,https://www.intensivregister.de/api/public/reporting/laendertabelle
1604307605,28866,20933,7933,2234,1148,https://www.intensivregister.de/api/public/reporting/laendertabelle
1604311205,28857,20947,7910,2243,1167,https://www.intensivregister.de/api/public/reporting/laendertabelle
1604314805,28837,20980,7857,2253,1170,https://www.intensivregister.de/api/public/reporting/laendertabelle
1604318405,28839,20982,7857,2255,1170,https://www.intensivregister.de/api/public/reporting/laendertabelle
1604322005,28824,20987,7837,2253,1170,https://www.intensivregister.de/api/public/reporting/laendertabelle
1604325605,28816,20987,7829,2255,1171,https://www.intensivregister.de/api/public/reporting/laendertabelle
1604329205,28816,20987,7829,2254,1172,https://www.intensivregister.de/api/public/reporting/laendertabelle
1604332805,28816,20986,7830,2256,1174,https://www.intensivregister.de/api/public/reporting/laendertabelle
1604336405,28810,20989,7821,2258,1175,https://www.intensivregister.de/api/public/reporting/laendertabelle
1604340005,28810,20996,7814,2261,1175,https://www.intensivregister.de/api/public/reporting/laendertabelle
1604343605,28810,20996,7814,2262,1176,https://www.intensivregister.de/api/public/reporting/laendertabelle
1604350805,28810,20998,7812,2263,1176,https://www.intensivregister.de/api/public/reporting/laendertabelle
1604358005,28814,20999,7815,2265,1177,https://www.intensivregister.de/api/public/reporting/laendertabelle
1604361605,28813,20999,7814,2265,1177,https://www.intensivregister.de/api/public/reporting/laendertabelle
1604365205,28813,20998,7815,2265,1177,https://www.intensivregister.de/api/public/reporting/laendertabelle
1604368805,28813,21005,7808,2265,1177,https://www.intensivregister.de/api/public/reporting/laendertabelle
1604372405,28813,21012,7801,2265,1175,https://www.intensivregister.de/api/public/reporting/laendertabelle
1604376005,28814,21016,7798,2265,1175,https://www.intensivregister.de/api/public/reporting/laendertabelle
1604379605,28829,21097,7732,2273,1177,https://www.intensivregister.de/api/public/reporting/laendertabelle
1604383205,28860,21277,7583,2302,1192,https://www.intensivregister.de/api/public/reporting/laendertabelle
1604386805,28778,21414,7364,2344,1233,https://www.intensivregister.de/api/public/reporting/laendertabelle
1604390405,28787,21458,7329,2367,1254,https://www.intensivregister.de/api/public/reporting/laendertabelle
1604394005,28751,21492,7259,2375,1242,https://www.intensivregister.de/api/public/reporting/laendertabelle
1604397605,28756,21515,7241,2392,1256,https://www.intensivregister.de/api/public/reporting/laendertabelle
1604401205,28754,21506,7248,2391,1256,https://www.intensivregister.de/api/public/reporting/laendertabelle
1604404805,28799,21550,7249,2391,1257,https://www.intensivregister.de/api/public/reporting/laendertabelle
1604408405,28771,21557,7214,2397,1262,https://www.intensivregister.de/api/public/reporting/laendertabelle
1604412005,28771,21555,7216,2394,1261,https://www.intensivregister.de/api/public/reporting/laendertabelle
1604415605,28771,21556,7215,2393,1263,https://www.intensivregister.de/api/public/reporting/laendertabelle
1604419205,28771,21570,7201,2394,1263,https://www.intensivregister.de/api/public/reporting/laendertabelle
1604422805,28770,21573,7197,2396,1264,https://www.intensivregister.de/api/public/reporting/laendertabelle
1604433605,28770,21573,7197,2397,1264,https://www.intensivregister.de/api/public/reporting/laendertabelle
1604437205,28770,21572,7198,2397,1264,https://www.intensivregister.de/api/public/reporting/laendertabelle
1604444405,28769,21567,7202,2398,1266,https://www.intensivregister.de/api/public/reporting/laendertabelle
1604448005,28769,21567,7202,2399,1266,https://www.intensivregister.de/api/public/reporting/laendertabelle
1604451605,28769,21564,7205,2399,1266,https://www.intensivregister.de/api/public/reporting/laendertabelle
1604455205,28767,21564,7203,2398,1266,https://www.intensivregister.de/api/public/reporting/laendertabelle
1604458805,28768,21567,7201,2398,1266,https://www.intensivregister.de/api/public/reporting/laendertabelle
1604462405,28768,21555,7213,2397,1268,https://www.intensivregister.de/api/public/reporting/laendertabelle
1604466005,28760,21598,7162,2408,1280,https://www.intensivregister.de/api/public/reporting/laendertabelle
1604469605,28795,21600,7195,2428,1278,https://www.intensivregister.de/api/public/reporting/laendertabelle
1604473205,28855,21689,7166,2442,1305,https://www.intensivregister.de/api/public/reporting/laendertabelle
1604476805,28955,21846,7109,2498,1320,https://www.intensivregister.de/api/public/reporting/laendertabelle
1604480405,28948,21831,7117,2529,1339,https://www.intensivregister.de/api/public/reporting/laendertabelle
1604484005,28937,21843,7094,2556,1349,https://www.intensivregister.de/api/public/reporting/laendertabelle
1604487605,28933,21843,7090,2558,1352,https://www.intensivregister.de/api/public/reporting/laendertabelle
1604491205,28916,21835,7081,2560,1353,https://www.intensivregister.de/api/public/reporting/laendertabelle
1604494805,28873,21834,7039,2563,1355,https://www.intensivregister.de/api/public/reporting/laendertabelle
1604498405,28870,21830,7040,2564,1358,https://www.intensivregister.de/api/public/reporting/laendertabelle
1604502005,28870,21828,7042,2564,1358,https://www.intensivregister.de/api/public/reporting/laendertabelle
1604505605,28869,21835,7034,2568,1360,https://www.intensivregister.de/api/public/reporting/laendertabelle
1604509205,28868,21835,7033,2570,1360,https://www.intensivregister.de/api/public/reporting/laendertabelle
1604520005,28868,21836,7032,2571,1360,https://www.intensivregister.de/api/public/reporting/laendertabelle
1604523605,28868,21838,7030,2572,1361,https://www.intensivregister.de/api/public/reporting/laendertabelle
1604527205,28868,21834,7034,2575,1363,https://www.intensivregister.de/api/public/reporting/laendertabelle
1604530805,28873,21838,7035,2575,1363,https://www.intensivregister.de/api/public/reporting/laendertabelle
1604534405,28873,21833,7040,2574,1363,https://www.intensivregister.de/api/public/reporting/laendertabelle
1604538005,28872,21836,7036,2574,1363,https://www.intensivregister.de/api/public/reporting/laendertabelle
1604541605,28872,21837,7035,2574,1363,https://www.intensivregister.de/api/public/reporting/laendertabelle
1604545205,28872,21828,7044,2579,1362,https://www.intensivregister.de/api/public/reporting/laendertabelle
1604548805,28874,21840,7034,2580,1361,https://www.intensivregister.de/api/public/reporting/laendertabelle
1604552405,28861,21827,7034,2582,1361,https://www.intensivregister.de/api/public/reporting/laendertabelle
1604556005,28832,21809,7023,2587,1373,https://www.intensivregister.de/api/public/reporting/laendertabelle
1604559605,28822,21836,6986,2629,1395,https://www.intensivregister.de/api/public/reporting/laendertabelle
1604563205,28761,21823,6938,2639,1418,https://www.intensivregister.de/api/public/reporting/laendertabelle
1604566805,28755,21848,6907,2651,1418,https://www.intensivregister.de/api/public/reporting/laendertabelle
1604570405,28755,21840,6915,2658,1423,https://www.intensivregister.de/api/public/reporting/laendertabelle
1604574005,28717,21811,6906,2659,1423,https://www.intensivregister.de/api/public/reporting/laendertabelle
1604577605,28716,21815,6901,2661,1425,https://www.intensivregister.de/api/public/reporting/laendertabelle
1604581205,28714,21815,6899,2662,1425,https://www.intensivregister.de/api/public/reporting/laendertabelle
1604584805,28751,21822,6929,2668,1430,https://www.intensivregister.de/api/public/reporting/laendertabelle
1604588405,28751,21812,6939,2666,1426,https://www.intensivregister.de/api/public/reporting/laendertabelle
1604592005,28751,21812,6939,2667,1426,https://www.intensivregister.de/api/public/reporting/laendertabelle
1604595605,28751,21805,6946,2667,1426,https://www.intensivregister.de/api/public/reporting/laendertabelle
1604599205,28751,21805,6946,2666,1426,https://www.intensivregister.de/api/public/reporting/laendertabelle
1604602805,28751,21807,6944,2669,1428,https://www.intensivregister.de/api/public/reporting/laendertabelle
1604610005,28754,21806,6948,2669,1429,https://www.intensivregister.de/api/public/reporting/laendertabelle
1604617205,28750,21802,6948,2671,1428,https://www.intensivregister.de/api/public/reporting/laendertabelle
1604620805,28738,21795,6943,2672,1428,https://www.intensivregister.de/api/public/reporting/laendertabelle
1604624405,28738,21796,6942,2671,1428,https://www.intensivregister.de/api/public/reporting/laendertabelle
1604631605,28738,21798,6940,2673,1429,https://www.intensivregister.de/api/public/reporting/laendertabelle
1604635205,28733,21792,6941,2675,1430,https://www.intensivregister.de/api/public/reporting/laendertabelle
1604638805,28731,21770,6961,2667,1430,https://www.intensivregister.de/api/public/reporting/laendertabelle
1604642405,28733,21709,7024,2680,1434,https://www.intensivregister.de/api/public/reporting/laendertabelle
1604646005,28659,21722,6937,2715,1447,https://www.intensivregister.de/api/public/reporting/laendertabelle
1604649605,28761,21673,7088,2731,1440,https://www.intensivregister.de/api/public/reporting/laendertabelle
1604653205,28745,21666,7079,2747,1451,https://www.intensivregister.de/api/public/reporting/laendertabelle
1604656805,28699,21651,7048,2760,1446,https://www.intensivregister.de/api/public/reporting/laendertabelle
1604660405,28704,21641,7063,2758,1448,https://www.intensivregister.de/api/public/reporting/laendertabelle
1604664005,28693,21633,7060,2761,1450,https://www.intensivregister.de/api/public/reporting/laendertabelle
1604667605,28693,21628,7065,2760,1449,https://www.intensivregister.de/api/public/reporting/laendertabelle
1604671205,28694,21622,7072,2761,1449,https://www.intensivregister.de/api/public/reporting/laendertabelle
1604674805,28687,21609,7078,2762,1450,https://www.intensivregister.de/api/public/reporting/laendertabelle
1604678405,28682,21598,7084,2763,1451,https://www.intensivregister.de/api/public/reporting/laendertabelle
1604682005,28682,21601,7081,2764,1454,https://www.intensivregister.de/api/public/reporting/laendertabelle
1604685605,28682,21597,7085,2765,1455,https://www.intensivregister.de/api/public/reporting/laendertabelle
1604689205,28682,21599,7083,2766,1455,https://www.intensivregister.de/api/public/reporting/laendertabelle
1604696405,28682,21604,7078,2766,1455,https://www.intensivregister.de/api/public/reporting/laendertabelle
1604700005,28682,21605,7077,2767,1455,https://www.intensivregister.de/api/public/reporting/laendertabelle
1604703605,28680,21600,7080,2770,1454,https://www.intensivregister.de/api/public/reporting/laendertabelle
1604707205,28678,21597,7081,2768,1456,https://www.intensivregister.de/api/public/reporting/laendertabelle
1604714405,28678,21596,7082,2768,1456,https://www.intensivregister.de/api/public/reporting/laendertabelle
1604718005,28679,21602,7077,2767,1456,https://www.intensivregister.de/api/public/reporting/laendertabelle
1604721605,28681,21601,7080,2767,1459,https://www.intensivregister.de/api/public/reporting/laendertabelle
1604725205,28677,21584,7093,2767,1458,https://www.intensivregister.de/api/public/reporting/laendertabelle
1604728805,28676,21603,7073,2781,1466,https://www.intensivregister.de/api/public/reporting/laendertabelle
1604732405,28611,21510,7101,2800,1478,https://www.intensivregister.de/api/public/reporting/laendertabelle
1604736005,28581,21443,7138,2819,1514,https://www.intensivregister.de/api/public/reporting/laendertabelle
1604739605,28457,21422,7035,2829,1528,https://www.intensivregister.de/api/public/reporting/laendertabelle
1604743205,28483,21365,7118,2847,1535,https://www.intensivregister.de/api/public/reporting/laendertabelle
1604746805,28474,21354,7120,2852,1536,https://www.intensivregister.de/api/public/reporting/laendertabelle
1604750405,28471,21335,7136,2852,1541,https://www.intensivregister.de/api/public/reporting/laendertabelle
1604754005,28469,21338,7131,2851,1540,https://www.intensivregister.de/api/public/reporting/laendertabelle
1604757605,28467,21333,7134,2848,1538,https://www.intensivregister.de/api/public/reporting/laendertabelle
1604761205,28467,21331,7136,2849,1538,https://www.intensivregister.de/api/public/reporting/laendertabelle
1604764805,28463,21323,7140,2850,1540,https://www.intensivregister.de/api/public/reporting/laendertabelle
1604768405,28459,21328,7131,2850,1544,https://www.intensivregister.de/api/public/reporting/laendertabelle
1604772005,28459,21326,7133,2850,1543,https://www.intensivregister.de/api/public/reporting/laendertabelle
1604775605,28459,21327,7132,2849,1542,https://www.intensivregister.de/api/public/reporting/laendertabelle
1604779205,28459,21328,7131,2849,1542,https://www.intensivregister.de/api/public/reporting/laendertabelle
1604782805,28459,21326,7133,2849,1542,https://www.intensivregister.de/api/public/reporting/laendertabelle
1604786405,28459,21327,7132,2849,1542,https://www.intensivregister.de/api/public/reporting/laendertabelle
1604790005,28463,21326,7137,2848,1543,https://www.intensivregister.de/api/public/reporting/laendertabelle
1604793605,28463,21316,7147,2847,1543,https://www.intensivregister.de/api/public/reporting/laendertabelle
1604797205,28463,21321,7142,2847,1543,https://www.intensivregister.de/api/public/reporting/laendertabelle
1604804405,28463,21319,7144,2847,1544,https://www.intensivregister.de/api/public/reporting/laendertabelle
1604808005,28468,21320,7148,2849,1544,https://www.intensivregister.de/api/public/reporting/laendertabelle
1604811605,28469,21311,7158,2854,1546,https://www.intensivregister.de/api/public/reporting/laendertabelle
1604815205,28484,21228,7256,2861,1548,https://www.intensivregister.de/api/public/reporting/laendertabelle
1604818805,28471,21106,7365,2891,1559,https://www.intensivregister.de/api/public/reporting/laendertabelle
1604822405,28453,20975,7478,2910,1584,https://www.intensivregister.de/api/public/reporting/laendertabelle
1604826005,28405,20891,7514,2918,1598,https://www.intensivregister.de/api/public/reporting/laendertabelle
1604829605,28396,20866,7530,2909,1605,https://www.intensivregister.de/api/public/reporting/laendertabelle
1604833205,28396,20863,7533,2913,1609,https://www.intensivregister.de/api/public/reporting/laendertabelle
1604836805,28396,20861,7535,2922,1611,https://www.intensivregister.de/api/public/reporting/laendertabelle
1604840405,28396,20862,7534,2923,1612,https://www.intensivregister.de/api/public/reporting/laendertabelle
1604844005,28395,20862,7533,2924,1613,https://www.intensivregister.de/api/public/reporting/laendertabelle
1604847605,28395,20860,7535,2926,1613,https://www.intensivregister.de/api/public/reporting/laendertabelle
1604851205,28395,20858,7537,2925,1613,https://www.intensivregister.de/api/public/reporting/laendertabelle
1604854805,28395,20862,7533,2929,1617,https://www.intensivregister.de/api/public/reporting/laendertabelle
1604858405,28395,20866,7529,2930,1617,https://www.intensivregister.de/api/public/reporting/laendertabelle
1604862005,28395,20867,7528,2931,1617,https://www.intensivregister.de/api/public/reporting/laendertabelle
1604865605,28395,20869,7526,2933,1618,https://www.intensivregister.de/api/public/reporting/laendertabelle
1604869205,28395,20873,7522,2933,1617,https://www.intensivregister.de/api/public/reporting/laendertabelle
1604876405,28393,20863,7530,2934,1617,https://www.intensivregister.de/api/public/reporting/laendertabelle
1604880005,28395,20867,7528,2934,1617,https://www.intensivregister.de/api/public/reporting/laendertabelle
1604883605,28396,20866,7530,2932,1616,https://www.intensivregister.de/api/public/reporting/laendertabelle
1604887205,28396,20865,7531,2931,1616,https://www.intensivregister.de/api/public/reporting/laendertabelle
1604890805,28398,20871,7527,2931,1616,https://www.intensivregister.de/api/public/reporting/laendertabelle
1604894405,28403,20866,7537,2932,1616,https://www.intensivregister.de/api/public/reporting/laendertabelle
1604898005,28408,20883,7525,2929,1621,https://www.intensivregister.de/api/public/reporting/laendertabelle
1604901605,29317,20941,8376,2963,1667,https://www.intensivregister.de/api/public/reporting/laendertabelle
1604905205,29387,20898,8489,2978,1662,https://www.intensivregister.de/api/public/reporting/laendertabelle
1604908805,29475,21050,8425,3004,1683,https://www.intensivregister.de/api/public/reporting/laendertabelle
1604912405,29494,21076,8418,3005,1681,https://www.intensivregister.de/api/public/reporting/laendertabelle
1604916005,29488,21078,8410,3011,1689,https://www.intensivregister.de/api/public/reporting/laendertabelle
1604919605,29486,21081,8405,3015,1694,https://www.intensivregister.de/api/public/reporting/laendertabelle
1604923205,29486,21076,8410,3014,1695,https://www.intensivregister.de/api/public/reporting/laendertabelle
1604926805,29473,21080,8393,3016,1695,https://www.intensivregister.de/api/public/reporting/laendertabelle
1604930405,29474,21086,8388,3017,1696,https://www.intensivregister.de/api/public/reporting/laendertabelle
1604934005,29471,21092,8379,3021,1698,https://www.intensivregister.de/api/public/reporting/laendertabelle
1604937605,29471,21090,8381,3021,1698,https://www.intensivregister.de/api/public/reporting/laendertabelle
1604941205,29469,21087,8382,3018,1697,https://www.intensivregister.de/api/public/reporting/laendertabelle
1604952005,29469,21088,8381,3020,1698,https://www.intensivregister.de/api/public/reporting/laendertabelle
1604962805,29469,21092,8377,3021,1699,https://www.intensivregister.de/api/public/reporting/laendertabelle
1604966405,29469,21098,8371,3021,1699,https://www.intensivregister.de/api/public/reporting/laendertabelle
1604970005,29469,21097,8372,3019,1698,https://www.intensivregister.de/api/public/reporting/laendertabelle
1604973605,29469,21098,8371,3020,1698,https://www.intensivregister.de/api/public/reporting/laendertabelle
1604977205,29469,21101,8368,3021,1699,https://www.intensivregister.de/api/public/reporting/laendertabelle
1604980805,29472,21109,8363,3026,1699,https://www.intensivregister.de/api/public/reporting/laendertabelle
1604984405,29490,21128,8362,3035,1701,https://www.intensivregister.de/api/public/reporting/laendertabelle
1604988005,28550,21258,7292,3037,1699,https://www.intensivregister.de/api/public/reporting/laendertabelle
1604991605,28467,21414,7053,3061,1713,https://www.intensivregister.de/api/public/reporting/laendertabelle
1604995205,28466,21494,6972,3075,1724,https://www.intensivregister.de/api/public/reporting/laendertabelle
1604998805,28485,21536,6949,3057,1732,https://www.intensivregister.de/api/public/reporting/laendertabelle
1605002405,28490,21567,6923,3054,1735,https://www.intensivregister.de/api/public/reporting/laendertabelle
1605006005,28493,21586,6907,3062,1735,https://www.intensivregister.de/api/public/reporting/laendertabelle
1605009605,28488,21594,6894,3060,1735,https://www.intensivregister.de/api/public/reporting/laendertabelle
1605013205,28485,21603,6882,3061,1732,https://www.intensivregister.de/api/public/reporting/laendertabelle
1605016805,28485,21602,6883,3063,1733,https://www.intensivregister.de/api/public/reporting/laendertabelle
1605020405,28488,21593,6895,3063,1732,https://www.intensivregister.de/api/public/reporting/laendertabelle
1605024005,28483,21600,6883,3063,1732,https://www.intensivregister.de/api/public/reporting/laendertabelle
1605027605,28482,21601,6881,3064,1732,https://www.intensivregister.de/api/public/reporting/laendertabelle
1605034805,28495,21611,6884,3064,1732,https://www.intensivregister.de/api/public/reporting/laendertabelle
1605049205,28495,21609,6886,3064,1732,https://www.intensivregister.de/api/public/reporting/laendertabelle
1605052805,28494,21609,6885,3063,1732,https://www.intensivregister.de/api/public/reporting/laendertabelle
1605056405,28490,21610,6880,3063,1732,https://www.intensivregister.de/api/public/reporting/laendertabelle
1605060005,28490,21615,6875,3061,1732,https://www.intensivregister.de/api/public/reporting/laendertabelle
1605063605,28490,21624,6866,3061,1735,https://www.intensivregister.de/api/public/reporting/laendertabelle
1605067205,28487,21629,6858,3064,1737,https://www.intensivregister.de/api/public/reporting/laendertabelle
1605070805,28486,21653,6833,3068,1739,https://www.intensivregister.de/api/public/reporting/laendertabelle
1605074405,28487,21690,6797,3072,1750,https://www.intensivregister.de/api/public/reporting/laendertabelle
1605078005,28488,21752,6736,3102,1766,https://www.intensivregister.de/api/public/reporting/laendertabelle
1605081605,28472,21756,6716,3119,1777,https://www.intensivregister.de/api/public/reporting/laendertabelle
1605085205,28507,21791,6716,3132,1794,https://www.intensivregister.de/api/public/reporting/laendertabelle
1605088805,28543,21823,6720,3139,1794,https://www.intensivregister.de/api/public/reporting/laendertabelle
1605092405,28541,21816,6725,3144,1795,https://www.intensivregister.de/api/public/reporting/laendertabelle
1605096005,28539,21816,6723,3146,1795,https://www.intensivregister.de/api/public/reporting/laendertabelle
1605099605,28539,21817,6722,3150,1796,https://www.intensivregister.de/api/public/reporting/laendertabelle
1605103205,28532,21815,6717,3149,1796,https://www.intensivregister.de/api/public/reporting/laendertabelle
1605106805,28533,21819,6714,3149,1797,https://www.intensivregister.de/api/public/reporting/laendertabelle
1605110405,28533,21823,6710,3148,1796,https://www.intensivregister.de/api/public/reporting/laendertabelle
1605114005,28535,21821,6714,3150,1797,https://www.intensivregister.de/api/public/reporting/laendertabelle
1605117605,28535,21823,6712,3151,1798,https://www.intensivregister.de/api/public/reporting/laendertabelle
1605124805,28535,21823,6712,3150,1798,https://www.intensivregister.de/api/public/reporting/laendertabelle
1605128405,28535,21824,6711,3150,1798,https://www.intensivregister.de/api/public/reporting/laendertabelle
1605135605,28551,21816,6735,3150,1798,https://www.intensivregister.de/api/public/reporting/laendertabelle
1605139205,28550,21815,6735,3152,1795,https://www.intensivregister.de/api/public/reporting/laendertabelle
1605142805,28550,21818,6732,3152,1796,https://www.intensivregister.de/api/public/reporting/laendertabelle
1605146405,28550,21819,6731,3151,1796,https://www.intensivregister.de/api/public/reporting/laendertabelle
1605150005,28550,21819,6731,3150,1796,https://www.intensivregister.de/api/public/reporting/laendertabelle
1605153605,28548,21822,6726,3151,1796,https://www.intensivregister.de/api/public/reporting/laendertabelle
1605157205,28576,21836,6740,3149,1799,https://www.intensivregister.de/api/public/reporting/laendertabelle
1605160805,28574,21836,6738,3163,1807,https://www.intensivregister.de/api/public/reporting/laendertabelle
1605164405,28566,21864,6702,3171,1807,https://www.intensivregister.de/api/public/reporting/laendertabelle
1605165300,28523,21874,6649,3168,1807,https://www.intensivregister.de/api/public/reporting/laendertabelle
1605186005,28545,21922,6623,3194,1821,https://www.intensivregister.de/api/public/reporting/laendertabelle
1605189605,28550,21920,6630,3196,1819,https://www.intensivregister.de/api/public/reporting/laendertabelle
1605193205,28549,21911,6638,3200,1821,https://www.intensivregister.de/api/public/reporting/laendertabelle
1605196805,28550,21914,6636,3202,1821,https://www.intensivregister.de/api/public/reporting/laendertabelle
1605200405,28553,21917,6636,3208,1825,https://www.intensivregister.de/api/public/reporting/laendertabelle
1605204005,28552,21917,6635,3208,1825,https://www.intensivregister.de/api/public/reporting/laendertabelle
1605207605,28552,21918,6634,3208,1826,https://www.intensivregister.de/api/public/reporting/laendertabelle
1605211205,28549,21915,6634,3208,1826,https://www.intensivregister.de/api/public/reporting/laendertabelle
1605214805,28549,21915,6634,3207,1825,https://www.intensivregister.de/api/public/reporting/laendertabelle
1605218405,28549,21919,6630,3210,1827,https://www.intensivregister.de/api/public/reporting/laendertabelle
1605222005,28549,21917,6632,3211,1827,https://www.intensivregister.de/api/public/reporting/laendertabelle
1605225605,28546,21920,6626,3214,1828,https://www.intensivregister.de/api/public/reporting/laendertabelle
1605229205,28546,21922,6624,3214,1828,https://www.intensivregister.de/api/public/reporting/laendertabelle
1605232805,28544,21917,6627,3214,1828,https://www.intensivregister.de/api/public/reporting/laendertabelle
1605236405,28544,21922,6622,3215,1829,https://www.intensivregister.de/api/public/reporting/laendertabelle
1605240005,28544,21915,6629,3216,1830,https://www.intensivregister.de/api/public/reporting/laendertabelle
1605243605,28536,21903,6633,3231,1833,https://www.intensivregister.de/api/public/reporting/laendertabelle
1605247205,28488,21903,6585,3251,1845,https://www.intensivregister.de/api/public/reporting/laendertabelle
1605250805,28459,21976,6483,3288,1843,https://www.intensivregister.de/api/public/reporting/laendertabelle
1605254405,28400,21933,6467,3300,1863,https://www.intensivregister.de/api/public/reporting/laendertabelle
1605258005,28399,21967,6432,3316,1869,https://www.intensivregister.de/api/public/reporting/laendertabelle
1605261605,28389,21984,6405,3310,1867,https://www.intensivregister.de/api/public/reporting/laendertabelle
1605265205,28385,21972,6413,3309,1866,https://www.intensivregister.de/api/public/reporting/laendertabelle
1605268805,28399,21983,6416,3326,1872,https://www.intensivregister.de/api/public/reporting/laendertabelle
1605272405,28379,21966,6413,3312,1867,https://www.intensivregister.de/api/public/reporting/laendertabelle
1605275974,28335,21922,6413,3300,1859,https://www.intensivregister.de/api/public/reporting/laendertabelle
1605275974,28334,21916,6418,3304,1859,https://www.intensivregister.de/api/public/reporting/laendertabelle
1605282899,28329,21906,6423,3303,1858,https://www.intensivregister.de/api/public/reporting/laendertabelle
1605283853,28329,21900,6429,3303,1857,https://www.intensivregister.de/api/public/reporting/laendertabelle
1605283853,28333,21903,6430,3303,1858,https://www.intensivregister.de/api/public/reporting/laendertabelle
1605293095,28333,21900,6433,3303,1858,https://www.intensivregister.de/api/public/reporting/laendertabelle
1605293095,28335,21900,6435,3303,1860,https://www.intensivregister.de/api/public/reporting/laendertabelle
1605293095,28335,21900,6435,3304,1860,https://www.intensivregister.de/api/public/reporting/laendertabelle
1605293095,28335,21902,6433,3305,1860,https://www.intensivregister.de/api/public/reporting/laendertabelle
1605293095,28212,21797,6415,3288,1855,https://www.intensivregister.de/api/public/reporting/laendertabelle
1605293095,28212,21794,6418,3290,1856,https://www.intensivregister.de/api/public/reporting/laendertabelle
1605293095,28212,21792,6420,3292,1858,https://www.intensivregister.de/api/public/reporting/laendertabelle
1605293095,28210,21794,6416,3292,1857,https://www.intensivregister.de/api/public/reporting/laendertabelle
1605293095,28213,21797,6416,3292,1858,https://www.intensivregister.de/api/public/reporting/laendertabelle
1605293095,28207,21794,6413,3291,1858,https://www.intensivregister.de/api/public/reporting/laendertabelle
1605293095,28207,21787,6420,3289,1859,https://www.intensivregister.de/api/public/reporting/laendertabelle
1605293095,28177,21765,6412,3305,1863,https://www.intensivregister.de/api/public/reporting/laendertabelle
1605293095,28158,21689,6469,3319,1870,https://www.intensivregister.de/api/public/reporting/laendertabelle
1605338983,28216,21714,6502,3340,1880,https://www.intensivregister.de/api/public/reporting/laendertabelle
1605338983,28180,21612,6568,3325,1864,https://www.intensivregister.de/api/public/reporting/laendertabelle
1605347474,28181,21629,6552,3324,1877,https://www.intensivregister.de/api/public/reporting/laendertabelle
1605349152,28183,21623,6560,3322,1876,https://www.intensivregister.de/api/public/reporting/laendertabelle
1605352748,28185,21620,6565,3324,1874,https://www.intensivregister.de/api/public/reporting/laendertabelle
1605356343,28181,21615,6566,3324,1874,https://www.intensivregister.de/api/public/reporting/laendertabelle
1605359949,28181,21611,6570,3323,1873,https://www.intensivregister.de/api/public/reporting/laendertabelle
1605363544,28181,21598,6583,3326,1873,https://www.intensivregister.de/api/public/reporting/laendertabelle
1605367150,28181,21600,6581,3325,1872,https://www.intensivregister.de/api/public/reporting/laendertabelle
1605370746,28189,21603,6586,3325,1872,https://www.intensivregister.de/api/public/reporting/laendertabelle
1605374351,28187,21600,6587,3324,1870,https://www.intensivregister.de/api/public/reporting/laendertabelle
1605377947,28186,21595,6591,3323,1870,https://www.intensivregister.de/api/public/reporting/laendertabelle
1605381553,28185,21596,6589,3323,1870,https://www.intensivregister.de/api/public/reporting/laendertabelle
1605385148,28185,21594,6591,3323,1870,https://www.intensivregister.de/api/public/reporting/laendertabelle
1605388744,28184,21596,6588,3323,1870,https://www.intensivregister.de/api/public/reporting/laendertabelle
1605392350,28198,21593,6605,3322,1870,https://www.intensivregister.de/api/public/reporting/laendertabelle
1605395945,28196,21597,6599,3322,1870,https://www.intensivregister.de/api/public/reporting/laendertabelle
1605399550,28196,21595,6601,3322,1870,https://www.intensivregister.de/api/public/reporting/laendertabelle
1605403146,28197,21591,6606,3323,1871,https://www.intensivregister.de/api/public/reporting/laendertabelle
1605406752,28197,21587,6610,3324,1871,https://www.intensivregister.de/api/public/reporting/laendertabelle
1605410347,28197,21585,6612,3325,1872,https://www.intensivregister.de/api/public/reporting/laendertabelle
1605413953,28192,21566,6626,3325,1872,https://www.intensivregister.de/api/public/reporting/laendertabelle
1605417548,28172,21493,6679,3335,1868,https://www.intensivregister.de/api/public/reporting/laendertabelle
1605421144,28165,21415,6750,3346,1876,https://www.intensivregister.de/api/public/reporting/laendertabelle
1605424749,28136,21326,6810,3358,1913,https://www.intensivregister.de/api/public/reporting/laendertabelle
1605428345,28114,21269,6845,3378,1924,https://www.intensivregister.de/api/public/reporting/laendertabelle
1605431950,28127,21227,6900,3384,1923,https://www.intensivregister.de/api/public/reporting/laendertabelle
1605435546,28129,21222,6907,3384,1925,https://www.intensivregister.de/api/public/reporting/laendertabelle
1605439151,28126,21227,6899,3384,1924,https://www.intensivregister.de/api/public/reporting/laendertabelle
1605442747,28126,21228,6898,3383,1926,https://www.intensivregister.de/api/public/reporting/laendertabelle
1605449948,28126,21224,6902,3384,1927,https://www.intensivregister.de/api/public/reporting/laendertabelle
1605453543,28126,21225,6901,3385,1927,https://www.intensivregister.de/api/public/reporting/laendertabelle
1605457149,28126,21233,6893,3386,1927,https://www.intensivregister.de/api/public/reporting/laendertabelle
1605460744,28126,21232,6894,3386,1927,https://www.intensivregister.de/api/public/reporting/laendertabelle
1605464350,28126,21235,6891,3386,1927,https://www.intensivregister.de/api/public/reporting/laendertabelle
1605471551,28126,21235,6891,3383,1926,https://www.intensivregister.de/api/public/reporting/laendertabelle
1605475147,28126,21238,6888,3383,1926,https://www.intensivregister.de/api/public/reporting/laendertabelle
1605478753,28125,21228,6897,3381,1925,https://www.intensivregister.de/api/public/reporting/laendertabelle
1605482349,28127,21233,6894,3381,1926,https://www.intensivregister.de/api/public/reporting/laendertabelle
1605485945,28127,21228,6899,3382,1927,https://www.intensivregister.de/api/public/reporting/laendertabelle
1605489550,28126,21228,6898,3382,1927,https://www.intensivregister.de/api/public/reporting/laendertabelle
1605493145,28129,21229,6900,3381,1926,https://www.intensivregister.de/api/public/reporting/laendertabelle
1605496751,28134,21231,6903,3383,1923,https://www.intensivregister.de/api/public/reporting/laendertabelle
1605500347,28146,21234,6912,3387,1922,https://www.intensivregister.de/api/public/reporting/laendertabelle
1605503953,28189,21278,6911,3417,1928,https://www.intensivregister.de/api/public/reporting/laendertabelle
1605507548,28242,21267,6975,3428,1948,https://www.intensivregister.de/api/public/reporting/laendertabelle
1605511144,28278,21343,6935,3430,1956,https://www.intensivregister.de/api/public/reporting/laendertabelle
1605514751,28307,21360,6947,3435,1967,https://www.intensivregister.de/api/public/reporting/laendertabelle
1605518346,28302,21349,6953,3436,1971,https://www.intensivregister.de/api/public/reporting/laendertabelle
1605521953,28305,21348,6957,3437,1970,https://www.intensivregister.de/api/public/reporting/laendertabelle
1605525548,28309,21344,6965,3437,1969,https://www.intensivregister.de/api/public/reporting/laendertabelle
1605529144,28309,21347,6962,3440,1970,https://www.intensivregister.de/api/public/reporting/laendertabelle
1605532750,28313,21349,6964,3439,1974,https://www.intensivregister.de/api/public/reporting/laendertabelle
1605536346,28315,21351,6964,3437,1975,https://www.intensivregister.de/api/public/reporting/laendertabelle
1605539952,28325,21357,6968,3437,1974,https://www.intensivregister.de/api/public/reporting/laendertabelle
1605543548,28326,21358,6968,3440,1974,https://www.intensivregister.de/api/public/reporting/laendertabelle
1605547144,28325,21363,6962,3443,1975,https://www.intensivregister.de/api/public/reporting/laendertabelle
1605550749,28325,21361,6964,3443,1976,https://www.intensivregister.de/api/public/reporting/laendertabelle
1605554345,28325,21363,6962,3443,1976,https://www.intensivregister.de/api/public/reporting/laendertabelle
1605557951,28323,21361,6962,3443,1976,https://www.intensivregister.de/api/public/reporting/laendertabelle
1605565153,28320,21361,6959,3443,1977,https://www.intensivregister.de/api/public/reporting/laendertabelle
1605568748,28315,21361,6954,3442,1977,https://www.intensivregister.de/api/public/reporting/laendertabelle
1605572343,28315,21366,6949,3442,1976,https://www.intensivregister.de/api/public/reporting/laendertabelle
1605575949,28315,21363,6952,3441,1975,https://www.intensivregister.de/api/public/reporting/laendertabelle
1605579545,28311,21354,6957,3440,1975,https://www.intensivregister.de/api/public/reporting/laendertabelle
1605583151,28318,21364,6954,3440,1974,https://www.intensivregister.de/api/public/reporting/laendertabelle
1605586747,28319,21376,6943,3454,1980,https://www.intensivregister.de/api/public/reporting/laendertabelle
1605590352,28335,21515,6820,3456,1980,https://www.intensivregister.de/api/public/reporting/laendertabelle
1605593948,28353,21667,6686,3473,1986,https://www.intensivregister.de/api/public/reporting/laendertabelle
1605597544,28373,21754,6619,3484,1982,https://www.intensivregister.de/api/public/reporting/laendertabelle
1605601150,28364,21806,6558,3504,1996,https://www.intensivregister.de/api/public/reporting/laendertabelle
1605604746,28337,21813,6524,3516,2008,https://www.intensivregister.de/api/public/reporting/laendertabelle
1605608352,28334,21824,6510,3517,2011,https://www.intensivregister.de/api/public/reporting/laendertabelle
1605611947,28328,21819,6509,3517,2008,https://www.intensivregister.de/api/public/reporting/laendertabelle
1605615544,28323,21825,6498,3518,2009,https://www.intensivregister.de/api/public/reporting/laendertabelle
1605619149,28323,21824,6499,3516,2009,https://www.intensivregister.de/api/public/reporting/laendertabelle
1605622745,28333,21830,6503,3515,2010,https://www.intensivregister.de/api/public/reporting/laendertabelle
1605626351,28333,21831,6502,3518,2017,https://www.intensivregister.de/api/public/reporting/laendertabelle
1605629947,28338,21834,6504,3519,2017,https://www.intensivregister.de/api/public/reporting/laendertabelle
1605633553,28337,21835,6502,3519,2018,https://www.intensivregister.de/api/public/reporting/laendertabelle
1605640744,28340,21835,6505,3521,2019,https://www.intensivregister.de/api/public/reporting/laendertabelle
1605644350,28340,21836,6504,3521,2019,https://www.intensivregister.de/api/public/reporting/laendertabelle
1605651551,28338,21836,6502,3524,2022,https://www.intensivregister.de/api/public/reporting/laendertabelle
1605655147,28338,21840,6498,3523,2021,https://www.intensivregister.de/api/public/reporting/laendertabelle
1605658753,28337,21840,6497,3523,2021,https://www.intensivregister.de/api/public/reporting/laendertabelle
1605662348,28339,21853,6486,3524,2021,https://www.intensivregister.de/api/public/reporting/laendertabelle
1605665944,28339,21854,6485,3524,2021,https://www.intensivregister.de/api/public/reporting/laendertabelle
1605669549,28343,21852,6491,3522,2021,https://www.intensivregister.de/api/public/reporting/laendertabelle
1605673145,28339,21898,6441,3526,2026,https://www.intensivregister.de/api/public/reporting/laendertabelle
1605676750,28326,21940,6386,3540,2037,https://www.intensivregister.de/api/public/reporting/laendertabelle
1605680346,28318,22009,6309,3540,2033,https://www.intensivregister.de/api/public/reporting/laendertabelle
1605683952,28309,22063,6246,3544,2031,https://www.intensivregister.de/api/public/reporting/laendertabelle
1605687547,28318,22072,6246,3556,2028,https://www.intensivregister.de/api/public/reporting/laendertabelle
1605691158,28265,22040,6225,3561,2021,https://www.intensivregister.de/api/public/reporting/laendertabelle
1605694749,28263,22042,6221,3562,2024,https://www.intensivregister.de/api/public/reporting/laendertabelle
1605698345,28262,22042,6220,3563,2024,https://www.intensivregister.de/api/public/reporting/laendertabelle
1605701951,28278,22058,6220,3564,2023,https://www.intensivregister.de/api/public/reporting/laendertabelle
1605705546,28278,22056,6222,3564,2021,https://www.intensivregister.de/api/public/reporting/laendertabelle
1605709152,28275,22057,6218,3571,2024,https://www.intensivregister.de/api/public/reporting/laendertabelle
1605712748,28273,22056,6217,3571,2026,https://www.intensivregister.de/api/public/reporting/laendertabelle
1605716353,28276,22057,6219,3572,2027,https://www.intensivregister.de/api/public/reporting/laendertabelle
1605719949,28276,22057,6219,3571,2027,https://www.intensivregister.de/api/public/reporting/laendertabelle
1605723545,28276,22055,6221,3570,2026,https://www.intensivregister.de/api/public/reporting/laendertabelle
1605734352,28276,22056,6220,3572,2026,https://www.intensivregister.de/api/public/reporting/laendertabelle
1605737948,28278,22049,6229,3571,2024,https://www.intensivregister.de/api/public/reporting/laendertabelle
1605741553,28282,22047,6235,3570,2023,https://www.intensivregister.de/api/public/reporting/laendertabelle
1605745148,28282,22042,6240,3569,2023,https://www.intensivregister.de/api/public/reporting/laendertabelle
1605752350,28282,22038,6244,3566,2022,https://www.intensivregister.de/api/public/reporting/laendertabelle
1605755945,28287,22050,6237,3566,2022,https://www.intensivregister.de/api/public/reporting/laendertabelle
1605759551,28283,22010,6273,3569,2030,https://www.intensivregister.de/api/public/reporting/laendertabelle
1605763147,28249,21939,6310,3601,2045,https://www.intensivregister.de/api/public/reporting/laendertabelle
1605766752,28236,21923,6313,3591,2074,https://www.intensivregister.de/api/public/reporting/laendertabelle
1605770348,28222,21946,6276,3584,2071,https://www.intensivregister.de/api/public/reporting/laendertabelle
1605773944,28199,21912,6287,3581,2076,https://www.intensivregister.de/api/public/reporting/laendertabelle
1605777549,28207,21933,6274,3588,2084,https://www.intensivregister.de/api/public/reporting/laendertabelle
1605781145,28208,21943,6265,3593,2087,https://www.intensivregister.de/api/public/reporting/laendertabelle
1605784751,28206,21933,6273,3595,2086,https://www.intensivregister.de/api/public/reporting/laendertabelle
1605788346,28204,21927,6277,3592,2084,https://www.intensivregister.de/api/public/reporting/laendertabelle
1605791952,28199,21934,6265,3597,2087,https://www.intensivregister.de/api/public/reporting/laendertabelle
1605795548,28202,21943,6259,3599,2086,https://www.intensivregister.de/api/public/reporting/laendertabelle
1605799153,28200,21943,6257,3601,2087,https://www.intensivregister.de/api/public/reporting/laendertabelle
1605806345,28200,21946,6254,3601,2087,https://www.intensivregister.de/api/public/reporting/laendertabelle
1605824352,28200,21951,6249,3602,2087,https://www.intensivregister.de/api/public/reporting/laendertabelle
1605827947,28200,21953,6247,3602,2087,https://www.intensivregister.de/api/public/reporting/laendertabelle
1605835149,28199,21957,6242,3603,2088,https://www.intensivregister.de/api/public/reporting/laendertabelle
1605838744,28197,21955,6242,3607,2088,https://www.intensivregister.de/api/public/reporting/laendertabelle
1605842350,28197,21953,6244,3608,2091,https://www.intensivregister.de/api/public/reporting/laendertabelle
1605845946,28203,21964,6239,3606,2088,https://www.intensivregister.de/api/public/reporting/laendertabelle
1605849551,28213,22031,6182,3622,2099,https://www.intensivregister.de/api/public/reporting/laendertabelle
1605853147,28192,22063,6129,3600,2087,https://www.intensivregister.de/api/public/reporting/laendertabelle
1605856753,28200,22078,6122,3604,2099,https://www.intensivregister.de/api/public/reporting/laendertabelle
1605860349,28182,22079,6103,3616,2100,https://www.intensivregister.de/api/public/reporting/laendertabelle
1605863944,28173,22066,6107,3615,2102,https://www.intensivregister.de/api/public/reporting/laendertabelle
1605867550,28154,22060,6094,3616,2103,https://www.intensivregister.de/api/public/reporting/laendertabelle
1605871146,28104,22075,6029,3623,2105,https://www.intensivregister.de/api/public/reporting/laendertabelle
1605874751,28100,22077,6023,3623,2106,https://www.intensivregister.de/api/public/reporting/laendertabelle
1605878346,28097,22077,6020,3623,2105,https://www.intensivregister.de/api/public/reporting/laendertabelle
1605881952,28112,22084,6028,3616,2102,https://www.intensivregister.de/api/public/reporting/laendertabelle
1605885547,28111,22086,6025,3618,2104,https://www.intensivregister.de/api/public/reporting/laendertabelle
1605889153,28110,22087,6023,3618,2104,https://www.intensivregister.de/api/public/reporting/laendertabelle
1605892748,28110,22085,6025,3618,2106,https://www.intensivregister.de/api/public/reporting/laendertabelle
1605896343,28112,22086,6026,3618,2106,https://www.intensivregister.de/api/public/reporting/laendertabelle
1605899949,28114,22085,6029,3618,2107,https://www.intensivregister.de/api/public/reporting/laendertabelle
1605903544,28104,22075,6029,3618,2106,https://www.intensivregister.de/api/public/reporting/laendertabelle
1605907152,28104,22076,6028,3618,2106,https://www.intensivregister.de/api/public/reporting/laendertabelle
1605910744,28104,22053,6051,3617,2106,https://www.intensivregister.de/api/public/reporting/laendertabelle
1605914353,28104,22051,6053,3618,2107,https://www.intensivregister.de/api/public/reporting/laendertabelle
1605917948,28104,22044,6060,3617,2107,https://www.intensivregister.de/api/public/reporting/laendertabelle
1605921551,28104,22042,6062,3617,2107,https://www.intensivregister.de/api/public/reporting/laendertabelle
1605925148,28104,22048,6056,3617,2109,https://www.intensivregister.de/api/public/reporting/laendertabelle
1605928744,28104,22047,6057,3615,2110,https://www.intensivregister.de/api/public/reporting/laendertabelle
1605932350,28095,22047,6048,3620,2108,https://www.intensivregister.de/api/public/reporting/laendertabelle
1605935947,28058,21956,6102,3616,2097,https://www.intensivregister.de/api/public/reporting/laendertabelle
1605939553,28026,21872,6154,3604,2097,https://www.intensivregister.de/api/public/reporting/laendertabelle
1605943149,27996,21796,6200,3632,2111,https://www.intensivregister.de/api/public/reporting/laendertabelle
1605946746,27985,21757,6228,3627,2114,https://www.intensivregister.de/api/public/reporting/laendertabelle
1605950354,27958,21742,6216,3630,2097,https://www.intensivregister.de/api/public/reporting/laendertabelle
1605953949,27952,21741,6211,3628,2099,https://www.intensivregister.de/api/public/reporting/laendertabelle
1605957544,27953,21730,6223,3627,2100,https://www.intensivregister.de/api/public/reporting/laendertabelle
1605961150,27952,21729,6223,3627,2101,https://www.intensivregister.de/api/public/reporting/laendertabelle
1605964746,27943,21719,6224,3626,2101,https://www.intensivregister.de/api/public/reporting/laendertabelle
1605968352,27943,21724,6219,3628,2106,https://www.intensivregister.de/api/public/reporting/laendertabelle
1605971948,27945,21722,6223,3630,2108,https://www.intensivregister.de/api/public/reporting/laendertabelle
1605975544,27946,21723,6223,3626,2106,https://www.intensivregister.de/api/public/reporting/laendertabelle
1605982746,27946,21717,6229,3628,2108,https://www.intensivregister.de/api/public/reporting/laendertabelle
1605986352,27946,21718,6228,3628,2108,https://www.intensivregister.de/api/public/reporting/laendertabelle
1605989948,27946,21719,6227,3628,2108,https://www.intensivregister.de/api/public/reporting/laendertabelle
1605993544,27947,21715,6232,3628,2108,https://www.intensivregister.de/api/public/reporting/laendertabelle
1605997150,27947,21704,6243,3633,2109,https://www.intensivregister.de/api/public/reporting/laendertabelle
1606000747,27949,21709,6240,3632,2108,https://www.intensivregister.de/api/public/reporting/laendertabelle
1606004353,27949,21713,6236,3632,2109,https://www.intensivregister.de/api/public/reporting/laendertabelle
1606007949,27949,21711,6238,3632,2109,https://www.intensivregister.de/api/public/reporting/laendertabelle
1606011544,27948,21711,6237,3634,2109,https://www.intensivregister.de/api/public/reporting/laendertabelle
1606015148,27948,21713,6235,3634,2109,https://www.intensivregister.de/api/public/reporting/laendertabelle
1606018751,27955,21702,6253,3632,2112,https://www.intensivregister.de/api/public/reporting/laendertabelle
1606022345,27948,21578,6370,3628,2107,https://www.intensivregister.de/api/public/reporting/laendertabelle
1606025949,27952,21517,6435,3666,2111,https://www.intensivregister.de/api/public/reporting/laendertabelle
1606029553,27964,21374,6590,3693,2112,https://www.intensivregister.de/api/public/reporting/laendertabelle
1606033147,27956,21328,6628,3703,2115,https://www.intensivregister.de/api/public/reporting/laendertabelle
1606036751,27943,21299,6644,3707,2132,https://www.intensivregister.de/api/public/reporting/laendertabelle
1606040345,27942,21284,6658,3708,2130,https://www.intensivregister.de/api/public/reporting/laendertabelle
1606043948,27941,21282,6659,3704,2130,https://www.intensivregister.de/api/public/reporting/laendertabelle
1606047552,27937,21273,6664,3704,2128,https://www.intensivregister.de/api/public/reporting/laendertabelle
1606051146,27937,21269,6668,3705,2129,https://www.intensivregister.de/api/public/reporting/laendertabelle
1606054750,27937,21264,6673,3705,2129,https://www.intensivregister.de/api/public/reporting/laendertabelle
1606058344,27935,21262,6673,3704,2130,https://www.intensivregister.de/api/public/reporting/laendertabelle
1606061947,27935,21263,6672,3706,2130,https://www.intensivregister.de/api/public/reporting/laendertabelle
1606065551,27935,21265,6670,3706,2128,https://www.intensivregister.de/api/public/reporting/laendertabelle
1606069144,27936,21263,6673,3707,2129,https://www.intensivregister.de/api/public/reporting/laendertabelle
1606072748,27936,21266,6670,3708,2130,https://www.intensivregister.de/api/public/reporting/laendertabelle
1606079945,27930,21261,6669,3709,2131,https://www.intensivregister.de/api/public/reporting/laendertabelle
1606083549,27930,21269,6661,3712,2131,https://www.intensivregister.de/api/public/reporting/laendertabelle
1606087153,27930,21267,6663,3715,2132,https://www.intensivregister.de/api/public/reporting/laendertabelle
1606094351,27932,21269,6663,3717,2133,https://www.intensivregister.de/api/public/reporting/laendertabelle
1606097945,27932,21262,6670,3716,2133,https://www.intensivregister.de/api/public/reporting/laendertabelle
1606101548,27932,21261,6671,3715,2131,https://www.intensivregister.de/api/public/reporting/laendertabelle
1606105152,27945,21267,6678,3714,2128,https://www.intensivregister.de/api/public/reporting/laendertabelle
1606108747,27986,21328,6658,3717,2133,https://www.intensivregister.de/api/public/reporting/laendertabelle
1606112353,27956,21341,6615,3723,2131,https://www.intensivregister.de/api/public/reporting/laendertabelle
1606115947,27979,21354,6625,3737,2136,https://www.intensivregister.de/api/public/reporting/laendertabelle
1606119551,27945,21345,6600,3741,2148,https://www.intensivregister.de/api/public/reporting/laendertabelle
1606123145,27940,21337,6603,3742,2161,https://www.intensivregister.de/api/public/reporting/laendertabelle
1606126748,27902,21337,6565,3741,2161,https://www.intensivregister.de/api/public/reporting/laendertabelle
1606130352,27895,21333,6562,3741,2161,https://www.intensivregister.de/api/public/reporting/laendertabelle
1606133946,27869,21335,6534,3739,2157,https://www.intensivregister.de/api/public/reporting/laendertabelle
1606137550,27847,21317,6530,3738,2156,https://www.intensivregister.de/api/public/reporting/laendertabelle
1606141144,27869,21334,6535,3737,2157,https://www.intensivregister.de/api/public/reporting/laendertabelle
1606144747,27860,21330,6530,3738,2156,https://www.intensivregister.de/api/public/reporting/laendertabelle
1606148351,27860,21331,6529,3738,2159,https://www.intensivregister.de/api/public/reporting/laendertabelle
1606151945,27860,21331,6529,3741,2159,https://www.intensivregister.de/api/public/reporting/laendertabelle
1606155548,27862,21335,6527,3742,2159,https://www.intensivregister.de/api/public/reporting/laendertabelle
1606159152,27861,21338,6523,3743,2160,https://www.intensivregister.de/api/public/reporting/laendertabelle
1606166349,27861,21338,6523,3742,2160,https://www.intensivregister.de/api/public/reporting/laendertabelle
1606169953,27861,21336,6525,3742,2160,https://www.intensivregister.de/api/public/reporting/laendertabelle
1606173546,27861,21340,6521,3742,2160,https://www.intensivregister.de/api/public/reporting/laendertabelle
1606177150,27861,21343,6518,3743,2161,https://www.intensivregister.de/api/public/reporting/laendertabelle
1606180744,27862,21349,6513,3743,2160,https://www.intensivregister.de/api/public/reporting/laendertabelle
1606184347,27862,21351,6511,3744,2160,https://www.intensivregister.de/api/public/reporting/laendertabelle
1606187951,27861,21354,6507,3744,2163,https://www.intensivregister.de/api/public/reporting/laendertabelle
1606191544,27867,21388,6479,3757,2163,https://www.intensivregister.de/api/public/reporting/laendertabelle
1606195148,27868,21510,6358,3738,2173,https://www.intensivregister.de/api/public/reporting/laendertabelle
1606198752,27887,21681,6206,3757,2170,https://www.intensivregister.de/api/public/reporting/laendertabelle
1606202346,27877,21792,6085,3762,2167,https://www.intensivregister.de/api/public/reporting/laendertabelle
1606205953,27880,21892,5988,3769,2170,https://www.intensivregister.de/api/public/reporting/laendertabelle
1606209544,27882,21929,5953,3768,2175,https://www.intensivregister.de/api/public/reporting/laendertabelle
1606213148,27882,21925,5957,3771,2175,https://www.intensivregister.de/api/public/reporting/laendertabelle
1606216753,27867,21925,5942,3776,2177,https://www.intensivregister.de/api/public/reporting/laendertabelle
1606220350,27866,21925,5941,3781,2182,https://www.intensivregister.de/api/public/reporting/laendertabelle
1606223944,27865,21921,5944,3779,2182,https://www.intensivregister.de/api/public/reporting/laendertabelle
1606231151,27868,21921,5947,3779,2179,https://www.intensivregister.de/api/public/reporting/laendertabelle
1606234751,27868,21923,5945,3778,2179,https://www.intensivregister.de/api/public/reporting/laendertabelle
1606238345,27868,21930,5938,3779,2179,https://www.intensivregister.de/api/public/reporting/laendertabelle
1606252746,27870,21932,5938,3779,2179,https://www.intensivregister.de/api/public/reporting/laendertabelle
1606256350,27871,21926,5945,3775,2178,https://www.intensivregister.de/api/public/reporting/laendertabelle
1606259953,27873,21924,5949,3775,2178,https://www.intensivregister.de/api/public/reporting/laendertabelle
1606263547,27868,21922,5946,3775,2179,https://www.intensivregister.de/api/public/reporting/laendertabelle
1606267151,27872,21921,5951,3777,2180,https://www.intensivregister.de/api/public/reporting/laendertabelle
1606270752,27872,21923,5949,3777,2180,https://www.intensivregister.de/api/public/reporting/laendertabelle
1606274350,27881,21921,5960,3773,2178,https://www.intensivregister.de/api/public/reporting/laendertabelle
1606277947,27847,21946,5901,3773,2176,https://www.intensivregister.de/api/public/reporting/laendertabelle
1606281553,27837,22002,5835,3769,2185,https://www.intensivregister.de/api/public/reporting/laendertabelle
1606285153,27841,21990,5851,3770,2187,https://www.intensivregister.de/api/public/reporting/laendertabelle
1606288749,27835,22040,5795,3782,2205,https://www.intensivregister.de/api/public/reporting/laendertabelle
1606292345,27842,22060,5782,3784,2210,https://www.intensivregister.de/api/public/reporting/laendertabelle
1606295950,27833,22045,5788,3781,2214,https://www.intensivregister.de/api/public/reporting/laendertabelle
1606299547,27809,22045,5764,3784,2220,https://www.intensivregister.de/api/public/reporting/laendertabelle
1606303153,27804,22039,5765,3783,2220,https://www.intensivregister.de/api/public/reporting/laendertabelle
1606306748,27766,22012,5754,3785,2223,https://www.intensivregister.de/api/public/reporting/laendertabelle
1606310344,27752,22009,5743,3790,2226,https://www.intensivregister.de/api/public/reporting/laendertabelle
1606313950,27752,22016,5736,3792,2228,https://www.intensivregister.de/api/public/reporting/laendertabelle
1606317546,27757,22023,5734,3793,2228,https://www.intensivregister.de/api/public/reporting/laendertabelle
1606324749,27755,22026,5729,3793,2232,https://www.intensivregister.de/api/public/reporting/laendertabelle
1606328345,27755,22027,5728,3793,2232,https://www.intensivregister.de/api/public/reporting/laendertabelle
1606331953,27755,22028,5727,3794,2232,https://www.intensivregister.de/api/public/reporting/laendertabelle
1606335548,27755,22030,5725,3795,2233,https://www.intensivregister.de/api/public/reporting/laendertabelle
1606342747,27755,22038,5717,3795,2233,https://www.intensivregister.de/api/public/reporting/laendertabelle
1606346343,27755,22040,5715,3794,2234,https://www.intensivregister.de/api/public/reporting/laendertabelle
1606349949,27755,22054,5701,3795,2235,https://www.intensivregister.de/api/public/reporting/laendertabelle
1606353545,27752,22051,5701,3795,2235,https://www.intensivregister.de/api/public/reporting/laendertabelle
1606357148,27751,22050,5701,3795,2235,https://www.intensivregister.de/api/public/reporting/laendertabelle
1606360752,27753,22058,5695,3794,2236,https://www.intensivregister.de/api/public/reporting/laendertabelle
1606364346,27763,22070,5693,3801,2240,https://www.intensivregister.de/api/public/reporting/laendertabelle
1606367952,27756,22071,5685,3800,2255,https://www.intensivregister.de/api/public/reporting/laendertabelle
1606371544,27725,22087,5638,3816,2271,https://www.intensivregister.de/api/public/reporting/laendertabelle
1606375148,27737,22115,5622,3829,2276,https://www.intensivregister.de/api/public/reporting/laendertabelle
1606378752,27718,22139,5579,3823,2286,https://www.intensivregister.de/api/public/reporting/laendertabelle
1606382354,27703,22128,5575,3827,2292,https://www.intensivregister.de/api/public/reporting/laendertabelle
1606385951,27702,22132,5570,3823,2290,https://www.intensivregister.de/api/public/reporting/laendertabelle
1606389545,27696,22138,5558,3823,2293,https://www.intensivregister.de/api/public/reporting/laendertabelle
1606393149,27697,22139,5558,3824,2291,https://www.intensivregister.de/api/public/reporting/laendertabelle
1606396753,27697,22137,5560,3824,2291,https://www.intensivregister.de/api/public/reporting/laendertabelle
1606400347,27697,22143,5554,3822,2291,https://www.intensivregister.de/api/public/reporting/laendertabelle
1606403951,27696,22161,5535,3831,2295,https://www.intensivregister.de/api/public/reporting/laendertabelle
1606407547,27694,22164,5530,3838,2296,https://www.intensivregister.de/api/public/reporting/laendertabelle
1606411146,27694,22167,5527,3837,2297,https://www.intensivregister.de/api/public/reporting/laendertabelle
1606414745,27694,22163,5531,3836,2297,https://www.intensivregister.de/api/public/reporting/laendertabelle
1606418352,27694,22166,5528,3836,2297,https://www.intensivregister.de/api/public/reporting/laendertabelle
1606425545,27694,22165,5529,3836,2297,https://www.intensivregister.de/api/public/reporting/laendertabelle
1606429151,27587,22070,5517,3817,2278,https://www.intensivregister.de/api/public/reporting/laendertabelle
1606432747,27587,22075,5512,3816,2277,https://www.intensivregister.de/api/public/reporting/laendertabelle
1606436344,27587,22072,5515,3817,2277,https://www.intensivregister.de/api/public/reporting/laendertabelle
1606439950,27587,22075,5512,3812,2275,https://www.intensivregister.de/api/public/reporting/laendertabelle
1606443546,27587,22074,5513,3812,2275,https://www.intensivregister.de/api/public/reporting/laendertabelle
1606447153,27587,22077,5510,3812,2273,https://www.intensivregister.de/api/public/reporting/laendertabelle
1606450749,27569,22138,5431,3823,2274,https://www.intensivregister.de/api/public/reporting/laendertabelle
1606454346,27584,22212,5372,3829,2282,https://www.intensivregister.de/api/public/reporting/laendertabelle
1606457953,27560,22252,5308,3817,2282,https://www.intensivregister.de/api/public/reporting/laendertabelle
1606461550,27651,22335,5316,3848,2304,https://www.intensivregister.de/api/public/reporting/laendertabelle
1606465147,27630,22337,5293,3849,2300,https://www.intensivregister.de/api/public/reporting/laendertabelle
1606468751,27619,22298,5321,3856,2303,https://www.intensivregister.de/api/public/reporting/laendertabelle
1606472352,27613,22300,5313,3857,2304,https://www.intensivregister.de/api/public/reporting/laendertabelle
1606475948,27611,22308,5303,3859,2305,https://www.intensivregister.de/api/public/reporting/laendertabelle
1606479546,27610,22298,5312,3862,2304,https://www.intensivregister.de/api/public/reporting/laendertabelle
1606483153,27601,22286,5315,3868,2309,https://www.intensivregister.de/api/public/reporting/laendertabelle
1606486750,27602,22277,5325,3867,2310,https://www.intensivregister.de/api/public/reporting/laendertabelle
1606490347,27593,22274,5319,3869,2312,https://www.intensivregister.de/api/public/reporting/laendertabelle
1606501147,27589,22272,5317,3873,2312,https://www.intensivregister.de/api/public/reporting/laendertabelle
1606504743,27589,22275,5314,3877,2313,https://www.intensivregister.de/api/public/reporting/laendertabelle
1606511946,27589,22276,5313,3877,2313,https://www.intensivregister.de/api/public/reporting/laendertabelle
1606515553,27589,22273,5316,3880,2313,https://www.intensivregister.de/api/public/reporting/laendertabelle
1606519149,27591,22274,5317,3881,2314,https://www.intensivregister.de/api/public/reporting/laendertabelle
1606522745,27591,22275,5316,3881,2314,https://www.intensivregister.de/api/public/reporting/laendertabelle
1606526352,27591,22269,5322,3881,2314,https://www.intensivregister.de/api/public/reporting/laendertabelle
1606529947,27591,22267,5324,3880,2313,https://www.intensivregister.de/api/public/reporting/laendertabelle
1606533544,27591,22262,5329,3879,2313,https://www.intensivregister.de/api/public/reporting/laendertabelle
1606537152,27590,22271,5319,3877,2312,https://www.intensivregister.de/api/public/reporting/laendertabelle
1606540750,27581,22238,5343,3876,2310,https://www.intensivregister.de/api/public/reporting/laendertabelle
1606544348,27528,22104,5424,3876,2315,https://www.intensivregister.de/api/public/reporting/laendertabelle
1606547945,27493,22043,5450,3869,2309,https://www.intensivregister.de/api/public/reporting/laendertabelle
1606551544,27479,22004,5475,3889,2300,https://www.intensivregister.de/api/public/reporting/laendertabelle
1606555147,27451,21930,5521,3889,2305,https://www.intensivregister.de/api/public/reporting/laendertabelle
1606558751,27452,21905,5547,3899,2309,https://www.intensivregister.de/api/public/reporting/laendertabelle
1606562349,27479,21922,5557,3898,2307,https://www.intensivregister.de/api/public/reporting/laendertabelle
1606565946,27477,21910,5567,3897,2308,https://www.intensivregister.de/api/public/reporting/laendertabelle
1606569553,27477,21912,5565,3897,2308,https://www.intensivregister.de/api/public/reporting/laendertabelle
1606573149,27479,21916,5563,3897,2309,https://www.intensivregister.de/api/public/reporting/laendertabelle
1606576745,27479,21917,5562,3897,2308,https://www.intensivregister.de/api/public/reporting/laendertabelle
1606580352,27479,21914,5565,3895,2308,https://www.intensivregister.de/api/public/reporting/laendertabelle
1606583948,27472,21917,5555,3896,2308,https://www.intensivregister.de/api/public/reporting/laendertabelle
1606587544,27472,21915,5557,3896,2308,https://www.intensivregister.de/api/public/reporting/laendertabelle
1606591151,27472,21919,5553,3896,2308,https://www.intensivregister.de/api/public/reporting/laendertabelle
1606594747,27472,21922,5550,3897,2311,https://www.intensivregister.de/api/public/reporting/laendertabelle
1606598344,27472,21920,5552,3897,2311,https://www.intensivregister.de/api/public/reporting/laendertabelle
1606601950,27472,21900,5572,3894,2311,https://www.intensivregister.de/api/public/reporting/laendertabelle
1606605546,27473,21894,5579,3894,2309,https://www.intensivregister.de/api/public/reporting/laendertabelle
1606609144,27470,21890,5580,3895,2309,https://www.intensivregister.de/api/public/reporting/laendertabelle
1606612744,27470,21888,5582,3895,2309,https://www.intensivregister.de/api/public/reporting/laendertabelle
1606616351,27468,21889,5579,3896,2309,https://www.intensivregister.de/api/public/reporting/laendertabelle
1606619948,27470,21885,5585,3897,2309,https://www.intensivregister.de/api/public/reporting/laendertabelle
1606623545,27476,21864,5612,3890,2307,https://www.intensivregister.de/api/public/reporting/laendertabelle
1606627153,27471,21814,5657,3894,2308,https://www.intensivregister.de/api/public/reporting/laendertabelle
1606630749,27455,21725,5730,3902,2297,https://www.intensivregister.de/api/public/reporting/laendertabelle
1606634346,27416,21642,5774,3927,2302,https://www.intensivregister.de/api/public/reporting/laendertabelle
1606637953,27425,21567,5858,3916,2306,https://www.intensivregister.de/api/public/reporting/laendertabelle
1606641549,27408,21541,5867,3901,2300,https://www.intensivregister.de/api/public/reporting/laendertabelle
1606645146,27407,21545,5862,3892,2292,https://www.intensivregister.de/api/public/reporting/laendertabelle
1606648744,27399,21544,5855,3894,2297,https://www.intensivregister.de/api/public/reporting/laendertabelle
1606652351,27399,21544,5855,3895,2296,https://www.intensivregister.de/api/public/reporting/laendertabelle
1606655948,27407,21544,5863,3895,2296,https://www.intensivregister.de/api/public/reporting/laendertabelle
1606659545,27407,21536,5871,3897,2296,https://www.intensivregister.de/api/public/reporting/laendertabelle
1606663153,27407,21535,5872,3898,2297,https://www.intensivregister.de/api/public/reporting/laendertabelle
1606666749,27407,21533,5874,3898,2297,https://www.intensivregister.de/api/public/reporting/laendertabelle
1606673944,27410,21534,5876,3897,2297,https://www.intensivregister.de/api/public/reporting/laendertabelle
1606681148,27412,21529,5883,3897,2297,https://www.intensivregister.de/api/public/reporting/laendertabelle
1606684746,27412,21532,5880,3897,2297,https://www.intensivregister.de/api/public/reporting/laendertabelle
1606688353,27412,21530,5882,3899,2299,https://www.intensivregister.de/api/public/reporting/laendertabelle
1606691950,27412,21526,5886,3899,2300,https://www.intensivregister.de/api/public/reporting/laendertabelle
1606695547,27417,21526,5891,3899,2300,https://www.intensivregister.de/api/public/reporting/laendertabelle
1606699145,27417,21527,5890,3901,2301,https://www.intensivregister.de/api/public/reporting/laendertabelle
1606702751,27419,21524,5895,3900,2301,https://www.intensivregister.de/api/public/reporting/laendertabelle
1606706348,27430,21534,5896,3906,2301,https://www.intensivregister.de/api/public/reporting/laendertabelle
1606709946,27439,21529,5910,3912,2307,https://www.intensivregister.de/api/public/reporting/laendertabelle
1606713549,27462,21572,5890,3919,2317,https://www.intensivregister.de/api/public/reporting/laendertabelle
1606717153,27517,21551,5966,3922,2325,https://www.intensivregister.de/api/public/reporting/laendertabelle
1606720748,27546,21590,5956,3912,2304,https://www.intensivregister.de/api/public/reporting/laendertabelle
1606724352,27533,21587,5946,3909,2305,https://www.intensivregister.de/api/public/reporting/laendertabelle
1606727947,27537,21631,5906,3924,2319,https://www.intensivregister.de/api/public/reporting/laendertabelle
1606731552,27533,21629,5904,3926,2320,https://www.intensivregister.de/api/public/reporting/laendertabelle
1606735149,27536,21634,5902,3927,2322,https://www.intensivregister.de/api/public/reporting/laendertabelle
1606738751,27529,21626,5903,3926,2322,https://www.intensivregister.de/api/public/reporting/laendertabelle
1606742345,27528,21628,5900,3928,2323,https://www.intensivregister.de/api/public/reporting/laendertabelle
1606745950,27526,21629,5897,3927,2323,https://www.intensivregister.de/api/public/reporting/laendertabelle
1606749545,27522,21634,5888,3929,2323,https://www.intensivregister.de/api/public/reporting/laendertabelle
1606756744,27522,21636,5886,3929,2323,https://www.intensivregister.de/api/public/reporting/laendertabelle
1606763944,27522,21638,5884,3928,2322,https://www.intensivregister.de/api/public/reporting/laendertabelle
1606767550,27522,21639,5883,3928,2322,https://www.intensivregister.de/api/public/reporting/laendertabelle
1606771153,27522,21637,5885,3927,2321,https://www.intensivregister.de/api/public/reporting/laendertabelle
1606774747,27520,21637,5883,3927,2322,https://www.intensivregister.de/api/public/reporting/laendertabelle
1606778352,27518,21640,5878,3927,2322,https://www.intensivregister.de/api/public/reporting/laendertabelle
1606781946,27518,21644,5874,3927,2324,https://www.intensivregister.de/api/public/reporting/laendertabelle
1606785550,27515,21645,5870,3929,2324,https://www.intensivregister.de/api/public/reporting/laendertabelle
1606789144,27516,21654,5862,3931,2324,https://www.intensivregister.de/api/public/reporting/laendertabelle
1606792750,27517,21670,5847,3931,2325,https://www.intensivregister.de/api/public/reporting/laendertabelle
1606796343,27512,21692,5820,3927,2321,https://www.intensivregister.de/api/public/reporting/laendertabelle
1606799948,27505,21779,5726,3912,2320,https://www.intensivregister.de/api/public/reporting/laendertabelle
1606803553,27514,21922,5592,3919,2323,https://www.intensivregister.de/api/public/reporting/laendertabelle
1606807149,27586,22086,5500,3926,2340,https://www.intensivregister.de/api/public/reporting/laendertabelle
1606810746,27595,22118,5477,3915,2354,https://www.intensivregister.de/api/public/reporting/laendertabelle
1606814352,27611,22143,5468,3918,2354,https://www.intensivregister.de/api/public/reporting/laendertabelle
1606817949,27610,22148,5462,3925,2357,https://www.intensivregister.de/api/public/reporting/laendertabelle
1606821545,27596,22129,5467,3923,2355,https://www.intensivregister.de/api/public/reporting/laendertabelle
1606825152,27596,22134,5462,3925,2356,https://www.intensivregister.de/api/public/reporting/laendertabelle
1606828749,27594,22136,5458,3924,2355,https://www.intensivregister.de/api/public/reporting/laendertabelle
1606832345,27594,22144,5450,3924,2352,https://www.intensivregister.de/api/public/reporting/laendertabelle
1606835952,27596,22140,5456,3924,2351,https://www.intensivregister.de/api/public/reporting/laendertabelle
1606839549,27596,22139,5457,3924,2351,https://www.intensivregister.de/api/public/reporting/laendertabelle
1606843146,27596,22140,5456,3924,2351,https://www.intensivregister.de/api/public/reporting/laendertabelle
1606850347,27596,22139,5457,3924,2351,https://www.intensivregister.de/api/public/reporting/laendertabelle
1606853952,27592,22135,5457,3923,2351,https://www.intensivregister.de/api/public/reporting/laendertabelle
1606857548,27592,22136,5456,3923,2351,https://www.intensivregister.de/api/public/reporting/laendertabelle
1606861145,27593,22133,5460,3922,2350,https://www.intensivregister.de/api/public/reporting/laendertabelle
1606864751,27590,22131,5459,3925,2351,https://www.intensivregister.de/api/public/reporting/laendertabelle
1606868347,27590,22134,5456,3926,2351,https://www.intensivregister.de/api/public/reporting/laendertabelle
1606871953,27590,22127,5463,3924,2350,https://www.intensivregister.de/api/public/reporting/laendertabelle
1606875549,27589,22125,5464,3923,2350,https://www.intensivregister.de/api/public/reporting/laendertabelle
1606879145,27592,22121,5471,3923,2353,https://www.intensivregister.de/api/public/reporting/laendertabelle
1606882752,27593,22157,5436,3913,2357,https://www.intensivregister.de/api/public/reporting/laendertabelle
1606886348,27582,22173,5409,3925,2346,https://www.intensivregister.de/api/public/reporting/laendertabelle
1606889952,27578,22165,5413,3934,2352,https://www.intensivregister.de/api/public/reporting/laendertabelle
1606893545,27572,22204,5368,3932,2364,https://www.intensivregister.de/api/public/reporting/laendertabelle
1606897147,27559,22242,5317,3945,2344,https://www.intensivregister.de/api/public/reporting/laendertabelle
1606900749,27546,22270,5276,3957,2353,https://www.intensivregister.de/api/public/reporting/laendertabelle
1606904352,27545,22267,5278,3956,2357,https://www.intensivregister.de/api/public/reporting/laendertabelle
1606907945,27544,22265,5279,3957,2357,https://www.intensivregister.de/api/public/reporting/laendertabelle
1606911546,27544,22268,5276,3957,2357,https://www.intensivregister.de/api/public/reporting/laendertabelle
1606915149,27543,22266,5277,3955,2355,https://www.intensivregister.de/api/public/reporting/laendertabelle
1606918761,27536,22269,5267,3955,2355,https://www.intensivregister.de/api/public/reporting/laendertabelle
1606922353,27536,22267,5269,3953,2354,https://www.intensivregister.de/api/public/reporting/laendertabelle
1606929546,27536,22268,5268,3954,2355,https://www.intensivregister.de/api/public/reporting/laendertabelle
1606947552,27539,22275,5264,3950,2354,https://www.intensivregister.de/api/public/reporting/laendertabelle
1606951144,27539,22276,5263,3950,2354,https://www.intensivregister.de/api/public/reporting/laendertabelle
1606954745,27539,22266,5273,3949,2354,https://www.intensivregister.de/api/public/reporting/laendertabelle
1606961951,27539,22264,5275,3950,2354,https://www.intensivregister.de/api/public/reporting/laendertabelle
1606965550,27540,22270,5270,3952,2356,https://www.intensivregister.de/api/public/reporting/laendertabelle
1606969149,27551,22264,5287,3941,2351,https://www.intensivregister.de/api/public/reporting/laendertabelle
1606972750,27545,22246,5299,3940,2356,https://www.intensivregister.de/api/public/reporting/laendertabelle
1606976345,27523,22248,5275,3939,2361,https://www.intensivregister.de/api/public/reporting/laendertabelle
1606979953,27514,22249,5265,3947,2367,https://www.intensivregister.de/api/public/reporting/laendertabelle
1606983545,27509,22280,5229,3965,2369,https://www.intensivregister.de/api/public/reporting/laendertabelle
1606987145,27512,22286,5226,3980,2383,https://www.intensivregister.de/api/public/reporting/laendertabelle
1606990744,27512,22287,5225,3983,2383,https://www.intensivregister.de/api/public/reporting/laendertabelle
1606994347,27523,22288,5235,3985,2386,https://www.intensivregister.de/api/public/reporting/laendertabelle
1606997950,27523,22286,5237,3986,2388,https://www.intensivregister.de/api/public/reporting/laendertabelle
1607001544,27525,22282,5243,3986,2389,https://www.intensivregister.de/api/public/reporting/laendertabelle
1607005148,27518,22278,5240,3984,2391,https://www.intensivregister.de/api/public/reporting/laendertabelle
1607008752,27519,22272,5247,3982,2389,https://www.intensivregister.de/api/public/reporting/laendertabelle
1607012346,27522,22278,5244,3982,2391,https://www.intensivregister.de/api/public/reporting/laendertabelle
1607015950,27522,22281,5241,3982,2390,https://www.intensivregister.de/api/public/reporting/laendertabelle
1607019543,27536,22297,5239,3984,2391,https://www.intensivregister.de/api/public/reporting/laendertabelle
1607023147,27536,22299,5237,3982,2389,https://www.intensivregister.de/api/public/reporting/laendertabelle
1607026752,27536,22300,5236,3981,2388,https://www.intensivregister.de/api/public/reporting/laendertabelle
1607033946,27536,22299,5237,3982,2388,https://www.intensivregister.de/api/public/reporting/laendertabelle
1607037545,27536,22292,5244,3983,2388,https://www.intensivregister.de/api/public/reporting/laendertabelle
1607041145,27535,22296,5239,3986,2387,https://www.intensivregister.de/api/public/reporting/laendertabelle
1607044753,27535,22296,5239,3985,2386,https://www.intensivregister.de/api/public/reporting/laendertabelle
1607048349,27536,22295,5241,3986,2385,https://www.intensivregister.de/api/public/reporting/laendertabelle
1607051948,27534,22293,5241,3985,2383,https://www.intensivregister.de/api/public/reporting/laendertabelle
1607055553,27515,22291,5224,3985,2379,https://www.intensivregister.de/api/public/reporting/laendertabelle
1607059152,27510,22314,5196,3984,2375,https://www.intensivregister.de/api/public/reporting/laendertabelle
1607062751,27486,22328,5158,3972,2388,https://www.intensivregister.de/api/public/reporting/laendertabelle
1607066345,27452,22389,5063,3993,2389,https://www.intensivregister.de/api/public/reporting/laendertabelle
1607069949,27437,22401,5036,4007,2394,https://www.intensivregister.de/api/public/reporting/laendertabelle
1607073547,27434,22399,5035,4010,2388,https://www.intensivregister.de/api/public/reporting/laendertabelle
1607077146,27416,22392,5024,4011,2392,https://www.intensivregister.de/api/public/reporting/laendertabelle
1607080752,27415,22384,5031,4012,2392,https://www.intensivregister.de/api/public/reporting/laendertabelle
1607084350,27413,22392,5021,4017,2395,https://www.intensivregister.de/api/public/reporting/laendertabelle
1607087947,27396,22392,5004,4015,2394,https://www.intensivregister.de/api/public/reporting/laendertabelle
1607091545,27394,22392,5002,4016,2392,https://www.intensivregister.de/api/public/reporting/laendertabelle
1607095152,27392,22395,4997,4019,2394,https://www.intensivregister.de/api/public/reporting/laendertabelle
1607098746,27392,22397,4995,4017,2393,https://www.intensivregister.de/api/public/reporting/laendertabelle
1607102350,27390,22396,4994,4019,2393,https://www.intensivregister.de/api/public/reporting/laendertabelle
1607105945,27390,22398,4992,4020,2394,https://www.intensivregister.de/api/public/reporting/laendertabelle
1607109551,27390,22398,4992,4021,2394,https://www.intensivregister.de/api/public/reporting/laendertabelle
1607113146,27392,22400,4992,4021,2394,https://www.intensivregister.de/api/public/reporting/laendertabelle
1607116752,27392,22394,4998,4022,2395,https://www.intensivregister.de/api/public/reporting/laendertabelle
1607120348,27392,22397,4995,4022,2394,https://www.intensivregister.de/api/public/reporting/laendertabelle
1607123947,27392,22387,5005,4021,2395,https://www.intensivregister.de/api/public/reporting/laendertabelle
1607131152,27392,22385,5007,4022,2395,https://www.intensivregister.de/api/public/reporting/laendertabelle
1607134750,27394,22385,5009,4020,2395,https://www.intensivregister.de/api/public/reporting/laendertabelle
1607138348,27393,22389,5004,4020,2394,https://www.intensivregister.de/api/public/reporting/laendertabelle
1607141945,27397,22382,5015,4016,2388,https://www.intensivregister.de/api/public/reporting/laendertabelle
1607145553,27369,22348,5021,4024,2396,https://www.intensivregister.de/api/public/reporting/laendertabelle
1607149151,27307,22263,5044,4009,2387,https://www.intensivregister.de/api/public/reporting/laendertabelle
1607152749,27261,22173,5088,4034,2404,https://www.intensivregister.de/api/public/reporting/laendertabelle
1607156350,27242,22136,5106,4037,2413,https://www.intensivregister.de/api/public/reporting/laendertabelle
1607159966,27202,22078,5124,4049,2413,https://www.intensivregister.de/api/public/reporting/laendertabelle
1607163548,27201,22073,5128,4050,2417,https://www.intensivregister.de/api/public/reporting/laendertabelle
1607167152,27198,22061,5137,4053,2416,https://www.intensivregister.de/api/public/reporting/laendertabelle
1607170746,27197,22057,5140,4056,2417,https://www.intensivregister.de/api/public/reporting/laendertabelle
1607177945,27197,22056,5141,4056,2417,https://www.intensivregister.de/api/public/reporting/laendertabelle
1607181550,27195,22044,5151,4055,2416,https://www.intensivregister.de/api/public/reporting/laendertabelle
1607185144,27195,22045,5150,4055,2416,https://www.intensivregister.de/api/public/reporting/laendertabelle
1607188748,27185,22043,5142,4055,2416,https://www.intensivregister.de/api/public/reporting/laendertabelle
1607192353,27185,22043,5142,4056,2417,https://www.intensivregister.de/api/public/reporting/laendertabelle
1607195943,27185,22042,5143,4057,2417,https://www.intensivregister.de/api/public/reporting/laendertabelle
1607199546,27186,22044,5142,4058,2417,https://www.intensivregister.de/api/public/reporting/laendertabelle
1607203149,27186,22042,5144,4058,2418,https://www.intensivregister.de/api/public/reporting/laendertabelle
1607206748,27186,22044,5142,4056,2417,https://www.intensivregister.de/api/public/reporting/laendertabelle
1607210346,27186,22035,5151,4058,2417,https://www.intensivregister.de/api/public/reporting/laendertabelle
1607213947,27183,22027,5156,4058,2417,https://www.intensivregister.de/api/public/reporting/laendertabelle
1607217550,27183,22031,5152,4057,2415,https://www.intensivregister.de/api/public/reporting/laendertabelle
1607221151,27182,22021,5161,4056,2416,https://www.intensivregister.de/api/public/reporting/laendertabelle
1607224753,27182,22024,5158,4054,2416,https://www.intensivregister.de/api/public/reporting/laendertabelle
1607228344,27176,22023,5153,4056,2421,https://www.intensivregister.de/api/public/reporting/laendertabelle
1607231946,27178,21981,5197,4060,2425,https://www.intensivregister.de/api/public/reporting/laendertabelle
1607235544,27188,21868,5320,4064,2422,https://www.intensivregister.de/api/public/reporting/laendertabelle
1607239153,27179,21730,5449,4085,2424,https://www.intensivregister.de/api/public/reporting/laendertabelle
1607242752,27179,21667,5512,4096,2435,https://www.intensivregister.de/api/public/reporting/laendertabelle
1607246350,27182,21638,5544,4104,2455,https://www.intensivregister.de/api/public/reporting/laendertabelle
1607249948,27180,21644,5536,4113,2461,https://www.intensivregister.de/api/public/reporting/laendertabelle
1607253546,27178,21639,5539,4117,2462,https://www.intensivregister.de/api/public/reporting/laendertabelle
1607257147,27178,21635,5543,4115,2463,https://www.intensivregister.de/api/public/reporting/laendertabelle
1607260744,27178,21634,5544,4115,2463,https://www.intensivregister.de/api/public/reporting/laendertabelle
1607264344,27178,21635,5543,4116,2463,https://www.intensivregister.de/api/public/reporting/laendertabelle
1607267950,27178,21634,5544,4113,2463,https://www.intensivregister.de/api/public/reporting/laendertabelle
1607271544,27178,21636,5542,4111,2462,https://www.intensivregister.de/api/public/reporting/laendertabelle
1607275149,27178,21635,5543,4115,2464,https://www.intensivregister.de/api/public/reporting/laendertabelle
1607278744,27178,21638,5540,4117,2464,https://www.intensivregister.de/api/public/reporting/laendertabelle
1607293149,27175,21640,5535,4115,2464,https://www.intensivregister.de/api/public/reporting/laendertabelle
1607296749,27175,21643,5532,4115,2464,https://www.intensivregister.de/api/public/reporting/laendertabelle
1607300349,27176,21645,5531,4115,2464,https://www.intensivregister.de/api/public/reporting/laendertabelle
1607303948,27176,21647,5529,4115,2464,https://www.intensivregister.de/api/public/reporting/laendertabelle
1607307550,27176,21644,5532,4117,2466,https://www.intensivregister.de/api/public/reporting/laendertabelle
1607311151,27175,21642,5533,4117,2466,https://www.intensivregister.de/api/public/reporting/laendertabelle
1607314752,27180,21634,5546,4124,2476,https://www.intensivregister.de/api/public/reporting/laendertabelle
1607318349,27218,21679,5539,4125,2472,https://www.intensivregister.de/api/public/reporting/laendertabelle
1607321947,27267,21756,5511,4124,2493,https://www.intensivregister.de/api/public/reporting/laendertabelle
1607325551,27290,21821,5469,4156,2495,https://www.intensivregister.de/api/public/reporting/laendertabelle
1607329146,27288,21836,5452,4162,2507,https://www.intensivregister.de/api/public/reporting/laendertabelle
1607332749,27291,21841,5450,4178,2515,https://www.intensivregister.de/api/public/reporting/laendertabelle
1607336344,27293,21853,5440,4184,2517,https://www.intensivregister.de/api/public/reporting/laendertabelle
1607339948,27287,21858,5429,4180,2517,https://www.intensivregister.de/api/public/reporting/laendertabelle
1607343552,27288,21852,5436,4182,2519,https://www.intensivregister.de/api/public/reporting/laendertabelle
1607347146,27284,21862,5422,4182,2520,https://www.intensivregister.de/api/public/reporting/laendertabelle
1607350744,27284,21861,5423,4185,2520,https://www.intensivregister.de/api/public/reporting/laendertabelle
1607354352,27283,21863,5420,4184,2520,https://www.intensivregister.de/api/public/reporting/laendertabelle
1607357948,27283,21864,5419,4184,2519,https://www.intensivregister.de/api/public/reporting/laendertabelle
1607361545,27283,21872,5411,4186,2520,https://www.intensivregister.de/api/public/reporting/laendertabelle
1607365152,27283,21871,5412,4188,2521,https://www.intensivregister.de/api/public/reporting/laendertabelle
1607372345,27283,21873,5410,4188,2521,https://www.intensivregister.de/api/public/reporting/laendertabelle
1607379549,27200,21806,5394,4178,2511,https://www.intensivregister.de/api/public/reporting/laendertabelle
1607383146,27200,21812,5388,4178,2511,https://www.intensivregister.de/api/public/reporting/laendertabelle
1607386753,27200,21808,5392,4175,2509,https://www.intensivregister.de/api/public/reporting/laendertabelle
1607390343,27199,21812,5387,4176,2509,https://www.intensivregister.de/api/public/reporting/laendertabelle
1607393947,27199,21825,5374,4178,2508,https://www.intensivregister.de/api/public/reporting/laendertabelle
1607397544,27201,21840,5361,4178,2506,https://www.intensivregister.de/api/public/reporting/laendertabelle
1607401151,27210,21907,5303,4179,2512,https://www.intensivregister.de/api/public/reporting/laendertabelle
1607404749,27246,22024,5222,4184,2506,https://www.intensivregister.de/api/public/reporting/laendertabelle
1607408346,27269,22182,5087,4227,2512,https://www.intensivregister.de/api/public/reporting/laendertabelle
1607411944,27288,22251,5037,4251,2525,https://www.intensivregister.de/api/public/reporting/laendertabelle
1607415550,27299,22316,4983,4258,2532,https://www.intensivregister.de/api/public/reporting/laendertabelle
1607419145,27271,22310,4961,4257,2537,https://www.intensivregister.de/api/public/reporting/laendertabelle
1607422750,27272,22325,4947,4256,2537,https://www.intensivregister.de/api/public/reporting/laendertabelle
1607426346,27276,22327,4949,4256,2538,https://www.intensivregister.de/api/public/reporting/laendertabelle
1607429953,27284,22334,4950,4257,2541,https://www.intensivregister.de/api/public/reporting/laendertabelle
1607433549,27280,22332,4948,4255,2539,https://www.intensivregister.de/api/public/reporting/laendertabelle
1607437145,27280,22333,4947,4253,2535,https://www.intensivregister.de/api/public/reporting/laendertabelle
1607440752,27280,22326,4954,4250,2534,https://www.intensivregister.de/api/public/reporting/laendertabelle
1607444347,27278,22323,4955,4250,2532,https://www.intensivregister.de/api/public/reporting/laendertabelle
1607447951,27278,22323,4955,4252,2534,https://www.intensivregister.de/api/public/reporting/laendertabelle
1607451546,27278,22326,4952,4253,2533,https://www.intensivregister.de/api/public/reporting/laendertabelle
1607465946,27278,22329,4949,4253,2533,https://www.intensivregister.de/api/public/reporting/laendertabelle
1607469547,27279,22331,4948,4254,2530,https://www.intensivregister.de/api/public/reporting/laendertabelle
1607473150,27279,22327,4952,4254,2530,https://www.intensivregister.de/api/public/reporting/laendertabelle
1607476752,27279,22323,4956,4253,2531,https://www.intensivregister.de/api/public/reporting/laendertabelle
1607480343,27282,22324,4958,4253,2531,https://www.intensivregister.de/api/public/reporting/laendertabelle
1607483948,27282,22324,4958,4250,2531,https://www.intensivregister.de/api/public/reporting/laendertabelle
1607487553,27281,22297,4984,4248,2531,https://www.intensivregister.de/api/public/reporting/laendertabelle
1607491147,27287,22362,4925,4274,2528,https://www.intensivregister.de/api/public/reporting/laendertabelle
1607494752,27309,22459,4850,4270,2527,https://www.intensivregister.de/api/public/reporting/laendertabelle
1607498346,27313,22485,4828,4276,2530,https://www.intensivregister.de/api/public/reporting/laendertabelle
1607501949,27333,22473,4860,4291,2530,https://www.intensivregister.de/api/public/reporting/laendertabelle
1607505552,27348,22487,4861,4278,2521,https://www.intensivregister.de/api/public/reporting/laendertabelle
1607509145,27349,22483,4866,4278,2521,https://www.intensivregister.de/api/public/reporting/laendertabelle
1607512750,27330,22474,4856,4279,2521,https://www.intensivregister.de/api/public/reporting/laendertabelle
1607516344,27330,22472,4858,4279,2522,https://www.intensivregister.de/api/public/reporting/laendertabelle
1607519950,27328,22485,4843,4282,2521,https://www.intensivregister.de/api/public/reporting/laendertabelle
1607523544,27326,22488,4838,4281,2521,https://www.intensivregister.de/api/public/reporting/laendertabelle
1607527143,27329,22491,4838,4280,2521,https://www.intensivregister.de/api/public/reporting/laendertabelle
1607530750,27329,22494,4835,4284,2522,https://www.intensivregister.de/api/public/reporting/laendertabelle
1607534346,27331,22496,4835,4286,2523,https://www.intensivregister.de/api/public/reporting/laendertabelle
1607537952,27331,22499,4832,4286,2523,https://www.intensivregister.de/api/public/reporting/laendertabelle
1607541548,27331,22499,4832,4285,2522,https://www.intensivregister.de/api/public/reporting/laendertabelle
1607552345,27330,22488,4842,4284,2522,https://www.intensivregister.de/api/public/reporting/laendertabelle
1607555949,27330,22485,4845,4289,2525,https://www.intensivregister.de/api/public/reporting/laendertabelle
1607559544,27332,22481,4851,4290,2525,https://www.intensivregister.de/api/public/reporting/laendertabelle
1607563149,27332,22483,4849,4290,2525,https://www.intensivregister.de/api/public/reporting/laendertabelle
1607566753,27332,22481,4851,4289,2525,https://www.intensivregister.de/api/public/reporting/laendertabelle
1607570347,27329,22478,4851,4291,2526,https://www.intensivregister.de/api/public/reporting/laendertabelle
1607573947,27325,22477,4848,4296,2529,https://www.intensivregister.de/api/public/reporting/laendertabelle
1607577543,27328,22516,4812,4332,2534,https://www.intensivregister.de/api/public/reporting/laendertabelle
1607581151,27312,22501,4811,4317,2516,https://www.intensivregister.de/api/public/reporting/laendertabelle
1607584752,27300,22498,4802,4324,2517,https://www.intensivregister.de/api/public/reporting/laendertabelle
1607588349,27292,22519,4773,4333,2503,https://www.intensivregister.de/api/public/reporting/laendertabelle
1607591946,27294,22547,4747,4341,2505,https://www.intensivregister.de/api/public/reporting/laendertabelle
1607595553,27296,22544,4752,4339,2505,https://www.intensivregister.de/api/public/reporting/laendertabelle
1607599150,27298,22557,4741,4345,2509,https://www.intensivregister.de/api/public/reporting/laendertabelle
1607602747,27298,22561,4737,4344,2510,https://www.intensivregister.de/api/public/reporting/laendertabelle
1607606344,27298,22562,4736,4342,2510,https://www.intensivregister.de/api/public/reporting/laendertabelle
1607609952,27299,22567,4732,4342,2510,https://www.intensivregister.de/api/public/reporting/laendertabelle
1607613549,27299,22566,4733,4335,2508,https://www.intensivregister.de/api/public/reporting/laendertabelle
1607617146,27299,22565,4734,4334,2507,https://www.intensivregister.de/api/public/reporting/laendertabelle
1607620753,27300,22563,4737,4337,2507,https://www.intensivregister.de/api/public/reporting/laendertabelle
1607624350,27300,22566,4734,4338,2509,https://www.intensivregister.de/api/public/reporting/laendertabelle
1607627947,27303,22569,4734,4341,2511,https://www.intensivregister.de/api/public/reporting/laendertabelle
1607635150,27303,22570,4733,4341,2511,https://www.intensivregister.de/api/public/reporting/laendertabelle
1607638750,27305,22571,4734,4342,2511,https://www.intensivregister.de/api/public/reporting/laendertabelle
1607642347,27305,22569,4736,4341,2511,https://www.intensivregister.de/api/public/reporting/laendertabelle
1607645944,27307,22571,4736,4341,2511,https://www.intensivregister.de/api/public/reporting/laendertabelle
1607649551,27308,22572,4736,4343,2512,https://www.intensivregister.de/api/public/reporting/laendertabelle
1607653148,27308,22575,4733,4342,2511,https://www.intensivregister.de/api/public/reporting/laendertabelle
1607656748,27305,22571,4734,4343,2514,https://www.intensivregister.de/api/public/reporting/laendertabelle
1607660348,27293,22561,4732,4343,2516,https://www.intensivregister.de/api/public/reporting/laendertabelle
1607663949,27288,22575,4713,4368,2527,https://www.intensivregister.de/api/public/reporting/laendertabelle
1607667550,27241,22535,4706,4374,2537,https://www.intensivregister.de/api/public/reporting/laendertabelle
1607671150,27215,22493,4722,4395,2526,https://www.intensivregister.de/api/public/reporting/laendertabelle
1607674750,27188,22494,4694,4404,2520,https://www.intensivregister.de/api/public/reporting/laendertabelle
1607678351,27142,22492,4650,4432,2540,https://www.intensivregister.de/api/public/reporting/laendertabelle
1607681951,27146,22485,4661,4435,2539,https://www.intensivregister.de/api/public/reporting/laendertabelle
1607685551,27158,22505,4653,4438,2537,https://www.intensivregister.de/api/public/reporting/laendertabelle
1607689151,27160,22504,4656,4440,2539,https://www.intensivregister.de/api/public/reporting/laendertabelle
1607692750,27160,22507,4653,4440,2546,https://www.intensivregister.de/api/public/reporting/laendertabelle
1607696355,27160,22512,4648,4446,2547,https://www.intensivregister.de/api/public/reporting/laendertabelle
1607699950,27160,22508,4652,4447,2547,https://www.intensivregister.de/api/public/reporting/laendertabelle
1607703554,27160,22502,4658,4446,2549,https://www.intensivregister.de/api/public/reporting/laendertabelle
1607707153,27160,22504,4656,4446,2549,https://www.intensivregister.de/api/public/reporting/laendertabelle
1607710748,27160,22505,4655,4446,2549,https://www.intensivregister.de/api/public/reporting/laendertabelle
1607714348,27158,22502,4656,4448,2552,https://www.intensivregister.de/api/public/reporting/laendertabelle
1607721547,27158,22506,4652,4448,2552,https://www.intensivregister.de/api/public/reporting/laendertabelle
1607725146,27154,22503,4651,4447,2552,https://www.intensivregister.de/api/public/reporting/laendertabelle
1607728746,27154,22498,4656,4447,2552,https://www.intensivregister.de/api/public/reporting/laendertabelle
1607732346,27152,22500,4652,4447,2552,https://www.intensivregister.de/api/public/reporting/laendertabelle
1607735945,27153,22499,4654,4446,2549,https://www.intensivregister.de/api/public/reporting/laendertabelle
1607739544,27153,22497,4656,4448,2550,https://www.intensivregister.de/api/public/reporting/laendertabelle
1607743143,27152,22505,4647,4448,2550,https://www.intensivregister.de/api/public/reporting/laendertabelle
1607746753,27161,22495,4666,4450,2547,https://www.intensivregister.de/api/public/reporting/laendertabelle
1607750352,27151,22497,4654,4467,2554,https://www.intensivregister.de/api/public/reporting/laendertabelle
1607753951,27100,22390,4710,4470,2552,https://www.intensivregister.de/api/public/reporting/laendertabelle
1607757550,27086,22317,4769,4498,2562,https://www.intensivregister.de/api/public/reporting/laendertabelle
1607761150,27066,22224,4842,4501,2547,https://www.intensivregister.de/api/public/reporting/laendertabelle
1607764749,27045,22160,4885,4490,2541,https://www.intensivregister.de/api/public/reporting/laendertabelle
1607768348,27033,22146,4887,4490,2547,https://www.intensivregister.de/api/public/reporting/laendertabelle
1607771947,27031,22136,4895,4486,2548,https://www.intensivregister.de/api/public/reporting/laendertabelle
1607775547,27031,22135,4896,4487,2548,https://www.intensivregister.de/api/public/reporting/laendertabelle
1607779146,27037,22144,4893,4489,2548,https://www.intensivregister.de/api/public/reporting/laendertabelle
1607782745,27032,22135,4897,4488,2548,https://www.intensivregister.de/api/public/reporting/laendertabelle
1607786344,27030,22129,4901,4489,2550,https://www.intensivregister.de/api/public/reporting/laendertabelle
1607789944,27030,22125,4905,4490,2550,https://www.intensivregister.de/api/public/reporting/laendertabelle
1607793553,27030,22126,4904,4492,2548,https://www.intensivregister.de/api/public/reporting/laendertabelle
1607797152,27030,22125,4905,4492,2548,https://www.intensivregister.de/api/public/reporting/laendertabelle
1607800751,27030,22124,4906,4492,2548,https://www.intensivregister.de/api/public/reporting/laendertabelle
1607804351,27030,22123,4907,4492,2548,https://www.intensivregister.de/api/public/reporting/laendertabelle
1607807950,27030,22122,4908,4493,2548,https://www.intensivregister.de/api/public/reporting/laendertabelle
1607811550,27029,22123,4906,4494,2547,https://www.intensivregister.de/api/public/reporting/laendertabelle
1607815149,27029,22130,4899,4495,2549,https://www.intensivregister.de/api/public/reporting/laendertabelle
1607818748,27029,22129,4900,4494,2546,https://www.intensivregister.de/api/public/reporting/laendertabelle
1607822347,27029,22124,4905,4493,2547,https://www.intensivregister.de/api/public/reporting/laendertabelle
1607825947,27029,22130,4899,4493,2547,https://www.intensivregister.de/api/public/reporting/laendertabelle
1607829546,27031,22137,4894,4495,2550,https://www.intensivregister.de/api/public/reporting/laendertabelle
1607833145,27035,22117,4918,4489,2548,https://www.intensivregister.de/api/public/reporting/laendertabelle
1607836744,27032,22043,4989,4502,2566,https://www.intensivregister.de/api/public/reporting/laendertabelle
1607840344,27004,21942,5062,4526,2572,https://www.intensivregister.de/api/public/reporting/laendertabelle
1607843943,27006,21858,5148,4539,2592,https://www.intensivregister.de/api/public/reporting/laendertabelle
1607847552,27003,21779,5224,4534,2600,https://www.intensivregister.de/api/public/reporting/laendertabelle
1607851152,26984,21789,5195,4555,2600,https://www.intensivregister.de/api/public/reporting/laendertabelle
1607854752,26977,21773,5204,4553,2605,https://www.intensivregister.de/api/public/reporting/laendertabelle
1607858351,26981,21769,5212,4554,2606,https://www.intensivregister.de/api/public/reporting/laendertabelle
1607861950,26979,21763,5216,4554,2606,https://www.intensivregister.de/api/public/reporting/laendertabelle
1607865550,26980,21760,5220,4556,2607,https://www.intensivregister.de/api/public/reporting/laendertabelle
1607869149,26980,21763,5217,4559,2608,https://www.intensivregister.de/api/public/reporting/laendertabelle
1607872748,26980,21759,5221,4559,2608,https://www.intensivregister.de/api/public/reporting/laendertabelle
1607876347,26980,21758,5222,4558,2607,https://www.intensivregister.de/api/public/reporting/laendertabelle
1607879946,26980,21760,5220,4559,2606,https://www.intensivregister.de/api/public/reporting/laendertabelle
1607883545,26980,21758,5222,4559,2605,https://www.intensivregister.de/api/public/reporting/laendertabelle
1607887145,26984,21761,5223,4561,2605,https://www.intensivregister.de/api/public/reporting/laendertabelle
1607890744,26984,21758,5226,4561,2605,https://www.intensivregister.de/api/public/reporting/laendertabelle
1607894343,26984,21757,5227,4561,2605,https://www.intensivregister.de/api/public/reporting/laendertabelle
1607897952,26983,21757,5226,4562,2605,https://www.intensivregister.de/api/public/reporting/laendertabelle
1607901552,26985,21756,5229,4563,2607,https://www.intensivregister.de/api/public/reporting/laendertabelle
1607908751,26985,21759,5226,4563,2607,https://www.intensivregister.de/api/public/reporting/laendertabelle
1607912349,26983,21764,5219,4563,2608,https://www.intensivregister.de/api/public/reporting/laendertabelle
1607915950,26986,21759,5227,4568,2608,https://www.intensivregister.de/api/public/reporting/laendertabelle
1607919548,27014,21816,5198,4588,2624,https://www.intensivregister.de/api/public/reporting/laendertabelle
1607923147,27068,21834,5234,4633,2627,https://www.intensivregister.de/api/public/reporting/laendertabelle
1607928919,27106,21927,5179,4637,2651,https://www.intensivregister.de/api/public/reporting/laendertabelle
1607930346,27124,22032,5092,4647,2632,https://www.intensivregister.de/api/public/reporting/laendertabelle
1607933945,27122,22004,5118,4658,2647,https://www.intensivregister.de/api/public/reporting/laendertabelle
1607937545,27106,22018,5088,4674,2670,https://www.intensivregister.de/api/public/reporting/laendertabelle
1607941144,27115,22030,5085,4682,2670,https://www.intensivregister.de/api/public/reporting/laendertabelle
1607944744,27116,22028,5088,4682,2672,https://www.intensivregister.de/api/public/reporting/laendertabelle
1607948344,27114,22029,5085,4686,2675,https://www.intensivregister.de/api/public/reporting/laendertabelle
1607951953,27124,22034,5090,4686,2677,https://www.intensivregister.de/api/public/reporting/laendertabelle
1607955552,27125,22041,5084,4689,2679,https://www.intensivregister.de/api/public/reporting/laendertabelle
1607959151,27125,22048,5077,4687,2679,https://www.intensivregister.de/api/public/reporting/laendertabelle
1607962751,27125,22046,5079,4688,2677,https://www.intensivregister.de/api/public/reporting/laendertabelle
1607966352,27125,22047,5078,4688,2681,https://www.intensivregister.de/api/public/reporting/laendertabelle
1607969949,27125,22047,5078,4689,2681,https://www.intensivregister.de/api/public/reporting/laendertabelle
1607973548,27125,22048,5077,4690,2681,https://www.intensivregister.de/api/public/reporting/laendertabelle
1607980747,27125,22051,5074,4690,2680,https://www.intensivregister.de/api/public/reporting/laendertabelle
1607984346,27125,22054,5071,4691,2680,https://www.intensivregister.de/api/public/reporting/laendertabelle
1607987946,27126,22056,5070,4691,2680,https://www.intensivregister.de/api/public/reporting/laendertabelle
1607995145,27126,22061,5065,4693,2680,https://www.intensivregister.de/api/public/reporting/laendertabelle
1607998745,27125,22064,5061,4693,2678,https://www.intensivregister.de/api/public/reporting/laendertabelle
1608002344,27124,22066,5058,4692,2678,https://www.intensivregister.de/api/public/reporting/laendertabelle
1608005952,27130,22112,5018,4714,2678,https://www.intensivregister.de/api/public/reporting/laendertabelle
1608009549,27124,22207,4917,4709,2685,https://www.intensivregister.de/api/public/reporting/laendertabelle
1608013147,27137,22350,4787,4739,2681,https://www.intensivregister.de/api/public/reporting/laendertabelle
1608016744,27133,22405,4728,4730,2688,https://www.intensivregister.de/api/public/reporting/laendertabelle
1608020352,27152,22456,4696,4735,2685,https://www.intensivregister.de/api/public/reporting/laendertabelle
1608023950,27157,22476,4681,4739,2678,https://www.intensivregister.de/api/public/reporting/laendertabelle
1608027548,27156,22478,4678,4735,2681,https://www.intensivregister.de/api/public/reporting/laendertabelle
1608031145,27152,22476,4676,4734,2680,https://www.intensivregister.de/api/public/reporting/laendertabelle
1608034753,27154,22478,4676,4738,2682,https://www.intensivregister.de/api/public/reporting/laendertabelle
1608038351,27154,22470,4684,4736,2681,https://www.intensivregister.de/api/public/reporting/laendertabelle
1608041948,27156,22469,4687,4737,2682,https://www.intensivregister.de/api/public/reporting/laendertabelle
1608045545,27156,22469,4687,4741,2684,https://www.intensivregister.de/api/public/reporting/laendertabelle
1608049153,27156,22468,4688,4743,2685,https://www.intensivregister.de/api/public/reporting/laendertabelle
1608052751,27156,22467,4689,4743,2685,https://www.intensivregister.de/api/public/reporting/laendertabelle
1608056347,27156,22470,4686,4743,2685,https://www.intensivregister.de/api/public/reporting/laendertabelle
1608059945,27157,22472,4685,4743,2685,https://www.intensivregister.de/api/public/reporting/laendertabelle
1608063553,27157,22473,4684,4744,2685,https://www.intensivregister.de/api/public/reporting/laendertabelle
1608070748,27157,22469,4688,4744,2685,https://www.intensivregister.de/api/public/reporting/laendertabelle
1608074346,27157,22463,4694,4743,2685,https://www.intensivregister.de/api/public/reporting/laendertabelle
1608077944,27154,22463,4691,4745,2687,https://www.intensivregister.de/api/public/reporting/laendertabelle
1608081553,27154,22462,4692,4745,2687,https://www.intensivregister.de/api/public/reporting/laendertabelle
1608088745,27142,22464,4678,4746,2690,https://www.intensivregister.de/api/public/reporting/laendertabelle
1608092344,27148,22454,4694,4759,2693,https://www.intensivregister.de/api/public/reporting/laendertabelle
1608095943,27139,22426,4713,4760,2709,https://www.intensivregister.de/api/public/reporting/laendertabelle
1608099552,27120,22463,4657,4814,2730,https://www.intensivregister.de/api/public/reporting/laendertabelle
1608103151,27127,22500,4627,4795,2737,https://www.intensivregister.de/api/public/reporting/laendertabelle
1608106750,27139,22529,4610,4819,2758,https://www.intensivregister.de/api/public/reporting/laendertabelle
1608110348,27072,22531,4541,4825,2756,https://www.intensivregister.de/api/public/reporting/laendertabelle
1608113947,27083,22534,4549,4835,2758,https://www.intensivregister.de/api/public/reporting/laendertabelle
1608117545,27083,22529,4554,4836,2764,https://www.intensivregister.de/api/public/reporting/laendertabelle
1608121153,27083,22526,4557,4834,2764,https://www.intensivregister.de/api/public/reporting/laendertabelle
1608124754,27083,22523,4560,4834,2765,https://www.intensivregister.de/api/public/reporting/laendertabelle
1608128347,27085,22525,4560,4837,2766,https://www.intensivregister.de/api/public/reporting/laendertabelle
1608131950,27081,22529,4552,4839,2765,https://www.intensivregister.de/api/public/reporting/laendertabelle
1608135552,27081,22526,4555,4844,2767,https://www.intensivregister.de/api/public/reporting/laendertabelle
1608139145,27081,22528,4553,4848,2771,https://www.intensivregister.de/api/public/reporting/laendertabelle
1608142748,27081,22529,4552,4849,2771,https://www.intensivregister.de/api/public/reporting/laendertabelle
1608149944,27081,22529,4552,4852,2774,https://www.intensivregister.de/api/public/reporting/laendertabelle
1608157145,27081,22518,4563,4851,2772,https://www.intensivregister.de/api/public/reporting/laendertabelle
1608160746,27077,22519,4558,4851,2772,https://www.intensivregister.de/api/public/reporting/laendertabelle
1608164347,27077,22516,4561,4851,2772,https://www.intensivregister.de/api/public/reporting/laendertabelle
1608167948,27079,22517,4562,4851,2773,https://www.intensivregister.de/api/public/reporting/laendertabelle
1608171549,27080,22521,4559,4852,2773,https://www.intensivregister.de/api/public/reporting/laendertabelle
1608175153,27087,22529,4558,4847,2772,https://www.intensivregister.de/api/public/reporting/laendertabelle
1608178743,27092,22496,4596,4839,2775,https://www.intensivregister.de/api/public/reporting/laendertabelle
1608182344,27081,22447,4634,4834,2761,https://www.intensivregister.de/api/public/reporting/laendertabelle
1608185948,27107,22466,4641,4839,2774,https://www.intensivregister.de/api/public/reporting/laendertabelle
1608189550,27097,22496,4601,4868,2789,https://www.intensivregister.de/api/public/reporting/laendertabelle
1608193152,27109,22496,4613,4867,2782,https://www.intensivregister.de/api/public/reporting/laendertabelle
1608196749,27100,22451,4649,4857,2775,https://www.intensivregister.de/api/public/reporting/laendertabelle
1608200345,27099,22448,4651,4857,2772,https://www.intensivregister.de/api/public/reporting/laendertabelle
1608203950,27087,22464,4623,4860,2774,https://www.intensivregister.de/api/public/reporting/laendertabelle
1608207552,27085,22465,4620,4856,2771,https://www.intensivregister.de/api/public/reporting/laendertabelle
1608211145,27079,22452,4627,4855,2770,https://www.intensivregister.de/api/public/reporting/laendertabelle
1608214749,27081,22469,4612,4856,2772,https://www.intensivregister.de/api/public/reporting/laendertabelle
1608218351,27080,22467,4613,4855,2774,https://www.intensivregister.de/api/public/reporting/laendertabelle
1608221944,27078,22466,4612,4859,2771,https://www.intensivregister.de/api/public/reporting/laendertabelle
1608225547,27077,22466,4611,4858,2769,https://www.intensivregister.de/api/public/reporting/laendertabelle
1608229149,27077,22471,4606,4860,2769,https://www.intensivregister.de/api/public/reporting/laendertabelle
1608232751,27077,22472,4605,4860,2769,https://www.intensivregister.de/api/public/reporting/laendertabelle
1608236344,27077,22471,4606,4860,2769,https://www.intensivregister.de/api/public/reporting/laendertabelle
1608239946,27077,22472,4605,4860,2769,https://www.intensivregister.de/api/public/reporting/laendertabelle
1608243549,27077,22468,4609,4860,2768,https://www.intensivregister.de/api/public/reporting/laendertabelle
1608247152,27077,22466,4611,4860,2768,https://www.intensivregister.de/api/public/reporting/laendertabelle
1608250744,27077,22464,4613,4861,2769,https://www.intensivregister.de/api/public/reporting/laendertabelle
1608254347,27073,22462,4611,4861,2769,https://www.intensivregister.de/api/public/reporting/laendertabelle
1608257952,27074,22462,4612,4864,2770,https://www.intensivregister.de/api/public/reporting/laendertabelle
1608261545,27072,22461,4611,4863,2766,https://www.intensivregister.de/api/public/reporting/laendertabelle
1608265148,27072,22474,4598,4870,2753,https://www.intensivregister.de/api/public/reporting/laendertabelle
1608268751,27085,22419,4666,4866,2718,https://www.intensivregister.de/api/public/reporting/laendertabelle
1608272348,27084,22431,4653,4883,2690,https://www.intensivregister.de/api/public/reporting/laendertabelle
1608275944,27099,22454,4645,4913,2672,https://www.intensivregister.de/api/public/reporting/laendertabelle
1608279551,27082,22448,4634,4916,2621,https://www.intensivregister.de/api/public/reporting/laendertabelle
1608283148,26847,22255,4592,4872,2581,https://www.intensivregister.de/api/public/reporting/laendertabelle
1608286744,27038,22420,4618,4903,2600,https://www.intensivregister.de/api/public/reporting/laendertabelle
1608290350,26998,22419,4579,4905,2601,https://www.intensivregister.de/api/public/reporting/laendertabelle
1608293947,26992,22417,4575,4904,2599,https://www.intensivregister.de/api/public/reporting/laendertabelle
1608297543,26994,22432,4562,4905,2600,https://www.intensivregister.de/api/public/reporting/laendertabelle
1608301150,26976,22425,4551,4905,2605,https://www.intensivregister.de/api/public/reporting/laendertabelle
1608304746,26975,22426,4549,4907,2605,https://www.intensivregister.de/api/public/reporting/laendertabelle
1608308353,26975,22431,4544,4905,2601,https://www.intensivregister.de/api/public/reporting/laendertabelle
1608311949,26975,22432,4543,4908,2602,https://www.intensivregister.de/api/public/reporting/laendertabelle
1608315545,26975,22436,4539,4906,2601,https://www.intensivregister.de/api/public/reporting/laendertabelle
1608319152,26975,22443,4532,4909,2601,https://www.intensivregister.de/api/public/reporting/laendertabelle
1608322748,26970,22440,4530,4909,2601,https://www.intensivregister.de/api/public/reporting/laendertabelle
1608326345,26970,22436,4534,4910,2602,https://www.intensivregister.de/api/public/reporting/laendertabelle
1608329951,26781,22268,4513,4881,2581,https://www.intensivregister.de/api/public/reporting/laendertabelle
1608333547,26777,22263,4514,4881,2581,https://www.intensivregister.de/api/public/reporting/laendertabelle
1608337143,26776,22262,4514,4881,2581,https://www.intensivregister.de/api/public/reporting/laendertabelle
1608340750,26776,22261,4515,4880,2582,https://www.intensivregister.de/api/public/reporting/laendertabelle
1608344346,26773,22251,4522,4878,2583,https://www.intensivregister.de/api/public/reporting/laendertabelle
1608347953,26772,22250,4522,4876,2583,https://www.intensivregister.de/api/public/reporting/laendertabelle
1608351549,26762,22257,4505,4880,2581,https://www.intensivregister.de/api/public/reporting/laendertabelle
1608355145,26731,22204,4527,4901,2603,https://www.intensivregister.de/api/public/reporting/laendertabelle
1608358752,26691,22135,4556,4887,2597,https://www.intensivregister.de/api/public/reporting/laendertabelle
1608362349,26689,22081,4608,4906,2583,https://www.intensivregister.de/api/public/reporting/laendertabelle
1608365945,26861,22108,4753,4939,2598,https://www.intensivregister.de/api/public/reporting/laendertabelle
1608369551,26818,22070,4748,4941,2605,https://www.intensivregister.de/api/public/reporting/laendertabelle
1608373147,26820,22054,4766,4938,2608,https://www.intensivregister.de/api/public/reporting/laendertabelle
1608376744,26814,22050,4764,4937,2608,https://www.intensivregister.de/api/public/reporting/laendertabelle
1608380350,26815,22050,4765,4939,2608,https://www.intensivregister.de/api/public/reporting/laendertabelle
1608383947,26815,22056,4759,4944,2609,https://www.intensivregister.de/api/public/reporting/laendertabelle
1608387543,26815,22058,4757,4944,2610,https://www.intensivregister.de/api/public/reporting/laendertabelle
1608394746,26813,22044,4769,4942,2607,https://www.intensivregister.de/api/public/reporting/laendertabelle
1608398352,26811,22046,4765,4941,2607,https://www.intensivregister.de/api/public/reporting/laendertabelle
1608401948,26809,22049,4760,4941,2608,https://www.intensivregister.de/api/public/reporting/laendertabelle
1608405545,26809,22050,4759,4940,2608,https://www.intensivregister.de/api/public/reporting/laendertabelle
1608409151,26809,22051,4758,4941,2608,https://www.intensivregister.de/api/public/reporting/laendertabelle
1608416353,26809,22046,4763,4940,2609,https://www.intensivregister.de/api/public/reporting/laendertabelle
1608419949,26809,22044,4765,4940,2609,https://www.intensivregister.de/api/public/reporting/laendertabelle
1608427151,26810,22044,4766,4940,2608,https://www.intensivregister.de/api/public/reporting/laendertabelle
1608430747,26809,22047,4762,4943,2607,https://www.intensivregister.de/api/public/reporting/laendertabelle
1608434343,26798,22034,4764,4944,2608,https://www.intensivregister.de/api/public/reporting/laendertabelle
1608437949,26800,22011,4789,4956,2609,https://www.intensivregister.de/api/public/reporting/laendertabelle
1608441545,26797,21966,4831,4971,2608,https://www.intensivregister.de/api/public/reporting/laendertabelle
1608445151,26786,21856,4930,4993,2620,https://www.intensivregister.de/api/public/reporting/laendertabelle
1608448747,26775,21794,4981,4992,2637,https://www.intensivregister.de/api/public/reporting/laendertabelle
1608452353,26724,21688,5036,5028,2645,https://www.intensivregister.de/api/public/reporting/laendertabelle
1608455949,26699,21655,5044,5022,2640,https://www.intensivregister.de/api/public/reporting/laendertabelle
1608459545,26700,21657,5043,5025,2642,https://www.intensivregister.de/api/public/reporting/laendertabelle
1608463151,26699,21652,5047,5030,2644,https://www.intensivregister.de/api/public/reporting/laendertabelle
1608466747,26698,21650,5048,5030,2648,https://www.intensivregister.de/api/public/reporting/laendertabelle
1608470353,26720,21670,5050,5035,2650,https://www.intensivregister.de/api/public/reporting/laendertabelle
1608473949,26720,21672,5048,5035,2650,https://www.intensivregister.de/api/public/reporting/laendertabelle
1608477545,26720,21668,5052,5035,2650,https://www.intensivregister.de/api/public/reporting/laendertabelle
1608481151,26720,21667,5053,5035,2650,https://www.intensivregister.de/api/public/reporting/laendertabelle
1608484747,26720,21668,5052,5040,2653,https://www.intensivregister.de/api/public/reporting/laendertabelle
1608488343,26720,21668,5052,5041,2653,https://www.intensivregister.de/api/public/reporting/laendertabelle
1608495545,26720,21684,5036,5045,2655,https://www.intensivregister.de/api/public/reporting/laendertabelle
1608499152,26720,21685,5035,5043,2655,https://www.intensivregister.de/api/public/reporting/laendertabelle
1608502747,26719,21684,5035,5044,2655,https://www.intensivregister.de/api/public/reporting/laendertabelle
1608506344,26718,21684,5034,5044,2655,https://www.intensivregister.de/api/public/reporting/laendertabelle
1608513545,26717,21682,5035,5044,2655,https://www.intensivregister.de/api/public/reporting/laendertabelle
1608517152,26717,21683,5034,5044,2657,https://www.intensivregister.de/api/public/reporting/laendertabelle
1608520748,26720,21689,5031,5050,2664,https://www.intensivregister.de/api/public/reporting/laendertabelle
1608524344,26722,21693,5029,5047,2657,https://www.intensivregister.de/api/public/reporting/laendertabelle
1608527951,26740,21697,5043,5081,2681,https://www.intensivregister.de/api/public/reporting/laendertabelle
1608531547,26759,21774,4985,5117,2680,https://www.intensivregister.de/api/public/reporting/laendertabelle
1608535143,26796,21857,4939,5143,2699,https://www.intensivregister.de/api/public/reporting/laendertabelle
1608538749,26817,21921,4896,5155,2711,https://www.intensivregister.de/api/public/reporting/laendertabelle
1608542346,26828,21960,4868,5167,2690,https://www.intensivregister.de/api/public/reporting/laendertabelle
1608545952,26824,21969,4855,5170,2692,https://www.intensivregister.de/api/public/reporting/laendertabelle
1608549549,26827,21973,4854,5170,2692,https://www.intensivregister.de/api/public/reporting/laendertabelle
1608553145,26827,21977,4850,5162,2690,https://www.intensivregister.de/api/public/reporting/laendertabelle
1608556752,26827,21975,4852,5162,2691,https://www.intensivregister.de/api/public/reporting/laendertabelle
1608560348,26826,21979,4847,5166,2691,https://www.intensivregister.de/api/public/reporting/laendertabelle
1608563944,26819,21978,4841,5163,2689,https://www.intensivregister.de/api/public/reporting/laendertabelle
1608567550,26819,21980,4839,5162,2690,https://www.intensivregister.de/api/public/reporting/laendertabelle
1608571147,26818,21984,4834,5163,2693,https://www.intensivregister.de/api/public/reporting/laendertabelle
1608574753,26817,21985,4832,5162,2693,https://www.intensivregister.de/api/public/reporting/laendertabelle
1608578349,26812,21986,4826,5162,2693,https://www.intensivregister.de/api/public/reporting/laendertabelle
1608581946,26812,21989,4823,5162,2693,https://www.intensivregister.de/api/public/reporting/laendertabelle
1608589148,26776,21967,4809,5161,2692,https://www.intensivregister.de/api/public/reporting/laendertabelle
1608592745,26776,21968,4808,5163,2694,https://www.intensivregister.de/api/public/reporting/laendertabelle
1608596351,26774,21959,4815,5164,2694,https://www.intensivregister.de/api/public/reporting/laendertabelle
1608599947,26774,21960,4814,5164,2694,https://www.intensivregister.de/api/public/reporting/laendertabelle
1608603544,26773,21960,4813,5165,2695,https://www.intensivregister.de/api/public/reporting/laendertabelle
1608607149,26788,21956,4832,5171,2697,https://www.intensivregister.de/api/public/reporting/laendertabelle
1608610745,26811,21967,4844,5177,2707,https://www.intensivregister.de/api/public/reporting/laendertabelle
1608614352,26805,22016,4789,5196,2706,https://www.intensivregister.de/api/public/reporting/laendertabelle
1608617950,26811,22016,4795,5193,2704,https://www.intensivregister.de/api/public/reporting/laendertabelle
1608621546,26822,22054,4768,5198,2698,https://www.intensivregister.de/api/public/reporting/laendertabelle
1608625153,26801,22056,4745,5207,2716,https://www.intensivregister.de/api/public/reporting/laendertabelle
1608628748,26799,22045,4754,5216,2724,https://www.intensivregister.de/api/public/reporting/laendertabelle
1608632344,26806,22035,4771,5215,2726,https://www.intensivregister.de/api/public/reporting/laendertabelle
1608635951,26805,22030,4775,5218,2727,https://www.intensivregister.de/api/public/reporting/laendertabelle
1608639547,26805,22050,4755,5221,2725,https://www.intensivregister.de/api/public/reporting/laendertabelle
1608643153,26806,22055,4751,5224,2726,https://www.intensivregister.de/api/public/reporting/laendertabelle
1608646749,26807,22055,4752,5225,2726,https://www.intensivregister.de/api/public/reporting/laendertabelle
1608650346,26815,22064,4751,5222,2728,https://www.intensivregister.de/api/public/reporting/laendertabelle
1608653951,26815,22063,4752,5220,2728,https://www.intensivregister.de/api/public/reporting/laendertabelle
1608657548,26815,22064,4751,5220,2728,https://www.intensivregister.de/api/public/reporting/laendertabelle
1608661144,26815,22069,4746,5220,2728,https://www.intensivregister.de/api/public/reporting/laendertabelle
1608664751,26815,22068,4747,5220,2728,https://www.intensivregister.de/api/public/reporting/laendertabelle
1608671943,26815,22070,4745,5222,2731,https://www.intensivregister.de/api/public/reporting/laendertabelle
1608675550,26815,22074,4741,5223,2731,https://www.intensivregister.de/api/public/reporting/laendertabelle
1608679146,26815,22076,4739,5224,2731,https://www.intensivregister.de/api/public/reporting/laendertabelle
1608682752,26811,22082,4729,5224,2730,https://www.intensivregister.de/api/public/reporting/laendertabelle
1608686349,26811,22083,4728,5224,2731,https://www.intensivregister.de/api/public/reporting/laendertabelle
1608689945,26812,22082,4730,5224,2731,https://www.intensivregister.de/api/public/reporting/laendertabelle
1608693552,26814,22070,4744,5218,2732,https://www.intensivregister.de/api/public/reporting/laendertabelle
1608697148,26814,22060,4754,5229,2736,https://www.intensivregister.de/api/public/reporting/laendertabelle
1608700744,26802,22014,4788,5216,2740,https://www.intensivregister.de/api/public/reporting/laendertabelle
1608704350,26794,22007,4787,5233,2775,https://www.intensivregister.de/api/public/reporting/laendertabelle
1608707946,26789,21982,4807,5231,2790,https://www.intensivregister.de/api/public/reporting/laendertabelle
1608711553,26736,21941,4795,5225,2793,https://www.intensivregister.de/api/public/reporting/laendertabelle
1608715149,26736,21903,4833,5240,2808,https://www.intensivregister.de/api/public/reporting/laendertabelle
1608718745,26739,21910,4829,5246,2812,https://www.intensivregister.de/api/public/reporting/laendertabelle
1608722351,26717,21908,4809,5246,2809,https://www.intensivregister.de/api/public/reporting/laendertabelle
1608725947,26721,21909,4812,5241,2807,https://www.intensivregister.de/api/public/reporting/laendertabelle
1608729543,26720,21901,4819,5239,2807,https://www.intensivregister.de/api/public/reporting/laendertabelle
1608733150,26721,21899,4822,5239,2808,https://www.intensivregister.de/api/public/reporting/laendertabelle
1608736746,26721,21892,4829,5233,2806,https://www.intensivregister.de/api/public/reporting/laendertabelle
1608740352,26721,21891,4830,5233,2806,https://www.intensivregister.de/api/public/reporting/laendertabelle
1608743949,26702,21891,4811,5231,2806,https://www.intensivregister.de/api/public/reporting/laendertabelle
1608747545,26702,21891,4811,5230,2805,https://www.intensivregister.de/api/public/reporting/laendertabelle
1608751152,26702,21890,4812,5229,2804,https://www.intensivregister.de/api/public/reporting/laendertabelle
1608754749,26702,21892,4810,5229,2805,https://www.intensivregister.de/api/public/reporting/laendertabelle
1608758344,26702,21893,4809,5230,2805,https://www.intensivregister.de/api/public/reporting/laendertabelle
1608761950,26700,21886,4814,5233,2803,https://www.intensivregister.de/api/public/reporting/laendertabelle
1608765547,26699,21888,4811,5237,2804,https://www.intensivregister.de/api/public/reporting/laendertabelle
1608769153,26700,21890,4810,5237,2804,https://www.intensivregister.de/api/public/reporting/laendertabelle
1608772749,26702,21894,4808,5240,2804,https://www.intensivregister.de/api/public/reporting/laendertabelle
1608776346,26701,21886,4815,5241,2802,https://www.intensivregister.de/api/public/reporting/laendertabelle
1608779952,26703,21881,4822,5240,2799,https://www.intensivregister.de/api/public/reporting/laendertabelle
1608783548,26693,21894,4799,5241,2794,https://www.intensivregister.de/api/public/reporting/laendertabelle
1608787145,26660,21853,4807,5242,2802,https://www.intensivregister.de/api/public/reporting/laendertabelle
1608790751,26627,21782,4845,5281,2819,https://www.intensivregister.de/api/public/reporting/laendertabelle
1608794347,26570,21664,4906,5296,2813,https://www.intensivregister.de/api/public/reporting/laendertabelle
1608797943,26552,21563,4989,5317,2820,https://www.intensivregister.de/api/public/reporting/laendertabelle
1608801550,26552,21535,5017,5353,2831,https://www.intensivregister.de/api/public/reporting/laendertabelle
1608805146,26551,21547,5004,5354,2831,https://www.intensivregister.de/api/public/reporting/laendertabelle
1608808752,26549,21535,5014,5353,2831,https://www.intensivregister.de/api/public/reporting/laendertabelle
1608812349,26546,21528,5018,5350,2829,https://www.intensivregister.de/api/public/reporting/laendertabelle
1608815945,26544,21529,5015,5350,2829,https://www.intensivregister.de/api/public/reporting/laendertabelle
1608819552,26544,21531,5013,5354,2828,https://www.intensivregister.de/api/public/reporting/laendertabelle
1608823148,26543,21538,5005,5354,2829,https://www.intensivregister.de/api/public/reporting/laendertabelle
1608826744,26543,21534,5009,5356,2829,https://www.intensivregister.de/api/public/reporting/laendertabelle
1608830351,26543,21533,5010,5355,2829,https://www.intensivregister.de/api/public/reporting/laendertabelle
1608833947,26543,21536,5007,5356,2829,https://www.intensivregister.de/api/public/reporting/laendertabelle
1608837553,26543,21535,5008,5355,2829,https://www.intensivregister.de/api/public/reporting/laendertabelle
1608841149,26543,21536,5007,5357,2827,https://www.intensivregister.de/api/public/reporting/laendertabelle
1608844746,26543,21534,5009,5357,2827,https://www.intensivregister.de/api/public/reporting/laendertabelle
1608848352,26531,21534,4997,5356,2827,https://www.intensivregister.de/api/public/reporting/laendertabelle
1608851949,26531,21535,4996,5354,2829,https://www.intensivregister.de/api/public/reporting/laendertabelle
1608855545,26531,21533,4998,5354,2830,https://www.intensivregister.de/api/public/reporting/laendertabelle
1608862747,26531,21530,5001,5354,2830,https://www.intensivregister.de/api/public/reporting/laendertabelle
1608866344,26526,21526,5000,5354,2830,https://www.intensivregister.de/api/public/reporting/laendertabelle
1608869950,26532,21512,5020,5356,2831,https://www.intensivregister.de/api/public/reporting/laendertabelle
1608873547,26511,21457,5054,5359,2829,https://www.intensivregister.de/api/public/reporting/laendertabelle
1608877144,26516,21382,5134,5388,2842,https://www.intensivregister.de/api/public/reporting/laendertabelle
1608880750,26489,21304,5185,5378,2850,https://www.intensivregister.de/api/public/reporting/laendertabelle
1608884346,26507,21285,5222,5387,2849,https://www.intensivregister.de/api/public/reporting/laendertabelle
1608887953,26521,21201,5320,5390,2847,https://www.intensivregister.de/api/public/reporting/laendertabelle
1608891549,26519,21194,5325,5391,2849,https://www.intensivregister.de/api/public/reporting/laendertabelle
1608895146,26519,21195,5324,5389,2849,https://www.intensivregister.de/api/public/reporting/laendertabelle
1608898752,26526,21202,5324,5392,2849,https://www.intensivregister.de/api/public/reporting/laendertabelle
1608902348,26526,21203,5323,5393,2850,https://www.intensivregister.de/api/public/reporting/laendertabelle
1608905944,26526,21204,5322,5397,2849,https://www.intensivregister.de/api/public/reporting/laendertabelle
1608909551,26528,21206,5322,5391,2852,https://www.intensivregister.de/api/public/reporting/laendertabelle
1608913147,26527,21202,5325,5380,2853,https://www.intensivregister.de/api/public/reporting/laendertabelle
1608916744,26527,21203,5324,5379,2853,https://www.intensivregister.de/api/public/reporting/laendertabelle
1608920350,26527,21208,5319,5382,2854,https://www.intensivregister.de/api/public/reporting/laendertabelle
1608923946,26528,21208,5320,5383,2856,https://www.intensivregister.de/api/public/reporting/laendertabelle
1608927552,26528,21207,5321,5385,2856,https://www.intensivregister.de/api/public/reporting/laendertabelle
1608931149,26528,21206,5322,5386,2856,https://www.intensivregister.de/api/public/reporting/laendertabelle
1608934745,26526,21207,5319,5388,2861,https://www.intensivregister.de/api/public/reporting/laendertabelle
1608938351,26524,21200,5324,5390,2862,https://www.intensivregister.de/api/public/reporting/laendertabelle
1608941948,26524,21197,5327,5390,2862,https://www.intensivregister.de/api/public/reporting/laendertabelle
1608945543,26525,21198,5327,5390,2862,https://www.intensivregister.de/api/public/reporting/laendertabelle
1608949149,26524,21202,5322,5393,2864,https://www.intensivregister.de/api/public/reporting/laendertabelle
1608952746,26520,21210,5310,5396,2864,https://www.intensivregister.de/api/public/reporting/laendertabelle
1608956352,26517,21201,5316,5399,2865,https://www.intensivregister.de/api/public/reporting/laendertabelle
1608959948,26516,21170,5346,5404,2872,https://www.intensivregister.de/api/public/reporting/laendertabelle
1608963544,26527,21195,5332,5441,2876,https://www.intensivregister.de/api/public/reporting/laendertabelle
1608967151,26541,21230,5311,5470,2894,https://www.intensivregister.de/api/public/reporting/laendertabelle
1608970748,26562,21268,5294,5508,2910,https://www.intensivregister.de/api/public/reporting/laendertabelle
1608974345,26534,21268,5266,5534,2910,https://www.intensivregister.de/api/public/reporting/laendertabelle
1608977951,26535,21265,5270,5536,2918,https://www.intensivregister.de/api/public/reporting/laendertabelle
1608981548,26540,21260,5280,5532,2916,https://www.intensivregister.de/api/public/reporting/laendertabelle
1608985144,26542,21265,5277,5532,2917,https://www.intensivregister.de/api/public/reporting/laendertabelle
1608988751,26542,21258,5284,5529,2917,https://www.intensivregister.de/api/public/reporting/laendertabelle
1608992347,26542,21261,5281,5530,2917,https://www.intensivregister.de/api/public/reporting/laendertabelle
1608995943,26542,21258,5284,5530,2916,https://www.intensivregister.de/api/public/reporting/laendertabelle
1608999550,26543,21259,5284,5531,2916,https://www.intensivregister.de/api/public/reporting/laendertabelle
1609003146,26545,21265,5280,5534,2918,https://www.intensivregister.de/api/public/reporting/laendertabelle
1609010349,26545,21266,5279,5534,2918,https://www.intensivregister.de/api/public/reporting/laendertabelle
1609017552,26545,21267,5278,5535,2918,https://www.intensivregister.de/api/public/reporting/laendertabelle
1609021148,26545,21265,5280,5533,2917,https://www.intensivregister.de/api/public/reporting/laendertabelle
1609024745,26545,21267,5278,5534,2917,https://www.intensivregister.de/api/public/reporting/laendertabelle
1609028351,26541,21269,5272,5533,2917,https://www.intensivregister.de/api/public/reporting/laendertabelle
1609031948,26540,21266,5274,5530,2916,https://www.intensivregister.de/api/public/reporting/laendertabelle
1609035544,26540,21264,5276,5530,2916,https://www.intensivregister.de/api/public/reporting/laendertabelle
1609039151,26543,21266,5277,5529,2913,https://www.intensivregister.de/api/public/reporting/laendertabelle
1609042748,26548,21265,5283,5530,2915,https://www.intensivregister.de/api/public/reporting/laendertabelle
1609046344,26568,21302,5266,5523,2920,https://www.intensivregister.de/api/public/reporting/laendertabelle
1609049952,26556,21338,5218,5526,2933,https://www.intensivregister.de/api/public/reporting/laendertabelle
1609053548,26549,21362,5187,5536,2950,https://www.intensivregister.de/api/public/reporting/laendertabelle
1609057145,26533,21349,5184,5546,2952,https://www.intensivregister.de/api/public/reporting/laendertabelle
1609060751,26513,21360,5153,5559,2959,https://www.intensivregister.de/api/public/reporting/laendertabelle
1609064348,26513,21371,5142,5566,2961,https://www.intensivregister.de/api/public/reporting/laendertabelle
1609067945,26512,21374,5138,5566,2959,https://www.intensivregister.de/api/public/reporting/laendertabelle
1609071551,26512,21376,5136,5569,2960,https://www.intensivregister.de/api/public/reporting/laendertabelle
1609075148,26512,21375,5137,5570,2958,https://www.intensivregister.de/api/public/reporting/laendertabelle
1609078744,26512,21375,5137,5571,2958,https://www.intensivregister.de/api/public/reporting/laendertabelle
1609082351,26536,21404,5132,5572,2958,https://www.intensivregister.de/api/public/reporting/laendertabelle
1609085949,26522,21390,5132,5572,2958,https://www.intensivregister.de/api/public/reporting/laendertabelle
1609089546,26522,21392,5130,5572,2956,https://www.intensivregister.de/api/public/reporting/laendertabelle
1609093148,26523,21392,5131,5573,2957,https://www.intensivregister.de/api/public/reporting/laendertabelle
1609096747,26523,21393,5130,5573,2958,https://www.intensivregister.de/api/public/reporting/laendertabelle
1609103945,26521,21391,5130,5573,2958,https://www.intensivregister.de/api/public/reporting/laendertabelle
1609107552,26521,21396,5125,5574,2956,https://www.intensivregister.de/api/public/reporting/laendertabelle
1609111150,26519,21397,5122,5577,2959,https://www.intensivregister.de/api/public/reporting/laendertabelle
1609118346,26519,21399,5120,5577,2959,https://www.intensivregister.de/api/public/reporting/laendertabelle
1609121944,26520,21411,5109,5579,2960,https://www.intensivregister.de/api/public/reporting/laendertabelle
1609125552,26517,21406,5111,5579,2963,https://www.intensivregister.de/api/public/reporting/laendertabelle
1609129150,26527,21412,5115,5587,2965,https://www.intensivregister.de/api/public/reporting/laendertabelle
1609132749,26536,21443,5093,5591,2965,https://www.intensivregister.de/api/public/reporting/laendertabelle
1609136352,26578,21476,5102,5632,2978,https://www.intensivregister.de/api/public/reporting/laendertabelle
1609139950,26625,21552,5073,5634,3013,https://www.intensivregister.de/api/public/reporting/laendertabelle
1609143548,26657,21628,5029,5622,3024,https://www.intensivregister.de/api/public/reporting/laendertabelle
1609147146,26667,21631,5036,5593,3017,https://www.intensivregister.de/api/public/reporting/laendertabelle
1609150744,26669,21638,5031,5598,3017,https://www.intensivregister.de/api/public/reporting/laendertabelle
1609154352,26675,21636,5039,5598,3019,https://www.intensivregister.de/api/public/reporting/laendertabelle
1609157951,26669,21622,5047,5593,3016,https://www.intensivregister.de/api/public/reporting/laendertabelle
1609161549,26665,21628,5037,5596,3016,https://www.intensivregister.de/api/public/reporting/laendertabelle
1609165147,26666,21619,5047,5592,3017,https://www.intensivregister.de/api/public/reporting/laendertabelle
1609168746,26666,21621,5045,5596,3018,https://www.intensivregister.de/api/public/reporting/laendertabelle
1609172344,26668,21627,5041,5600,3020,https://www.intensivregister.de/api/public/reporting/laendertabelle
1609175952,26668,21631,5037,5600,3019,https://www.intensivregister.de/api/public/reporting/laendertabelle
1609179550,26668,21638,5030,5602,3023,https://www.intensivregister.de/api/public/reporting/laendertabelle
1609183149,26668,21635,5033,5598,3022,https://www.intensivregister.de/api/public/reporting/laendertabelle
1609186746,26668,21636,5032,5599,3023,https://www.intensivregister.de/api/public/reporting/laendertabelle
1609190344,26668,21635,5033,5599,3023,https://www.intensivregister.de/api/public/reporting/laendertabelle
1609193953,26669,21630,5039,5598,3020,https://www.intensivregister.de/api/public/reporting/laendertabelle
1609197551,26673,21632,5041,5599,3018,https://www.intensivregister.de/api/public/reporting/laendertabelle
1609204750,26674,21632,5042,5598,3017,https://www.intensivregister.de/api/public/reporting/laendertabelle
1609208348,26679,21637,5042,5598,3014,https://www.intensivregister.de/api/public/reporting/laendertabelle
1609211947,26675,21640,5035,5599,3014,https://www.intensivregister.de/api/public/reporting/laendertabelle
1609215547,26676,21684,4992,5603,3013,https://www.intensivregister.de/api/public/reporting/laendertabelle
1609219153,26676,21754,4922,5609,3011,https://www.intensivregister.de/api/public/reporting/laendertabelle
1609222748,26713,21833,4880,5622,3048,https://www.intensivregister.de/api/public/reporting/laendertabelle
1609226346,26733,21898,4835,5619,3052,https://www.intensivregister.de/api/public/reporting/laendertabelle
1609229945,26744,21931,4813,5633,3059,https://www.intensivregister.de/api/public/reporting/laendertabelle
1609233544,26738,22018,4720,5651,3071,https://www.intensivregister.de/api/public/reporting/laendertabelle
1609237152,26751,22033,4718,5653,3073,https://www.intensivregister.de/api/public/reporting/laendertabelle
1609240751,26748,22036,4712,5653,3072,https://www.intensivregister.de/api/public/reporting/laendertabelle
1609244349,26748,22040,4708,5652,3072,https://www.intensivregister.de/api/public/reporting/laendertabelle
1609247946,26748,22039,4709,5653,3073,https://www.intensivregister.de/api/public/reporting/laendertabelle
1609255152,26738,22034,4704,5658,3075,https://www.intensivregister.de/api/public/reporting/laendertabelle
1609258751,26736,22030,4706,5657,3075,https://www.intensivregister.de/api/public/reporting/laendertabelle
1609262349,26736,22031,4705,5656,3075,https://www.intensivregister.de/api/public/reporting/laendertabelle
1609265948,26736,22033,4703,5659,3076,https://www.intensivregister.de/api/public/reporting/laendertabelle
1609269547,26736,22033,4703,5661,3077,https://www.intensivregister.de/api/public/reporting/laendertabelle
1609273145,26734,22027,4707,5658,3074,https://www.intensivregister.de/api/public/reporting/laendertabelle
1609280343,26735,22025,4710,5657,3073,https://www.intensivregister.de/api/public/reporting/laendertabelle
1609283953,26734,22024,4710,5657,3072,https://www.intensivregister.de/api/public/reporting/laendertabelle
1609287551,26734,22026,4708,5657,3072,https://www.intensivregister.de/api/public/reporting/laendertabelle
1609291149,26734,22025,4709,5656,3071,https://www.intensivregister.de/api/public/reporting/laendertabelle
1609294747,26740,22039,4701,5655,3072,https://www.intensivregister.de/api/public/reporting/laendertabelle
1609298346,26738,22025,4713,5650,3069,https://www.intensivregister.de/api/public/reporting/laendertabelle
1609301944,26751,22013,4738,5637,3074,https://www.intensivregister.de/api/public/reporting/laendertabelle
1609305553,26744,22048,4696,5651,3077,https://www.intensivregister.de/api/public/reporting/laendertabelle
1609309151,26718,22008,4710,5643,3050,https://www.intensivregister.de/api/public/reporting/laendertabelle
1609312754,26704,22003,4701,5668,3070,https://www.intensivregister.de/api/public/reporting/laendertabelle
1609316348,26705,21991,4714,5645,3058,https://www.intensivregister.de/api/public/reporting/laendertabelle
1609319946,26691,21974,4717,5645,3061,https://www.intensivregister.de/api/public/reporting/laendertabelle
1609323545,26694,21983,4711,5651,3062,https://www.intensivregister.de/api/public/reporting/laendertabelle
1609327144,26694,21987,4707,5651,3064,https://www.intensivregister.de/api/public/reporting/laendertabelle
1609330744,26691,21989,4702,5654,3067,https://www.intensivregister.de/api/public/reporting/laendertabelle
1609334353,26685,21983,4702,5651,3064,https://www.intensivregister.de/api/public/reporting/laendertabelle
1609337944,26685,21986,4699,5651,3065,https://www.intensivregister.de/api/public/reporting/laendertabelle
1609341552,26689,21996,4693,5653,3068,https://www.intensivregister.de/api/public/reporting/laendertabelle
1609345151,26690,22002,4688,5652,3068,https://www.intensivregister.de/api/public/reporting/laendertabelle
1609348750,26690,22005,4685,5651,3068,https://www.intensivregister.de/api/public/reporting/laendertabelle
1609352349,26690,22001,4689,5651,3067,https://www.intensivregister.de/api/public/reporting/laendertabelle
1609355948,26690,22003,4687,5650,3067,https://www.intensivregister.de/api/public/reporting/laendertabelle
1609363145,26689,21999,4690,5647,3067,https://www.intensivregister.de/api/public/reporting/laendertabelle
1609366753,26688,21992,4696,5648,3070,https://www.intensivregister.de/api/public/reporting/laendertabelle
1609370351,26688,21992,4696,5646,3069,https://www.intensivregister.de/api/public/reporting/laendertabelle
1609373950,26687,21990,4697,5646,3069,https://www.intensivregister.de/api/public/reporting/laendertabelle
1609377549,26687,21991,4696,5647,3069,https://www.intensivregister.de/api/public/reporting/laendertabelle
1609381147,26688,21985,4703,5646,3069,https://www.intensivregister.de/api/public/reporting/laendertabelle
1609384747,26690,21993,4697,5653,3071,https://www.intensivregister.de/api/public/reporting/laendertabelle
1609388345,26686,22003,4683,5657,3073,https://www.intensivregister.de/api/public/reporting/laendertabelle
1609391944,26678,22006,4672,5655,3058,https://www.intensivregister.de/api/public/reporting/laendertabelle
1609395545,26673,21972,4701,5653,3080,https://www.intensivregister.de/api/public/reporting/laendertabelle
1609399152,26622,21882,4740,5618,3086,https://www.intensivregister.de/api/public/reporting/laendertabelle
1609402752,26604,21852,4752,5624,3104,https://www.intensivregister.de/api/public/reporting/laendertabelle
1609406351,26576,21830,4746,5629,3111,https://www.intensivregister.de/api/public/reporting/laendertabelle
1609409949,26568,21811,4757,5635,3112,https://www.intensivregister.de/api/public/reporting/laendertabelle
1609413547,26563,21807,4756,5635,3113,https://www.intensivregister.de/api/public/reporting/laendertabelle
1609417145,26563,21798,4765,5637,3116,https://www.intensivregister.de/api/public/reporting/laendertabelle
1609420743,26563,21790,4773,5636,3117,https://www.intensivregister.de/api/public/reporting/laendertabelle
1609424351,26563,21783,4780,5634,3116,https://www.intensivregister.de/api/public/reporting/laendertabelle
1609427949,26563,21781,4782,5637,3118,https://www.intensivregister.de/api/public/reporting/laendertabelle
1609431547,26563,21780,4783,5642,3121,https://www.intensivregister.de/api/public/reporting/laendertabelle
1609435144,26562,21781,4781,5644,3121,https://www.intensivregister.de/api/public/reporting/laendertabelle
1609438753,26562,21780,4782,5643,3120,https://www.intensivregister.de/api/public/reporting/laendertabelle
1609445949,26560,21784,4776,5643,3118,https://www.intensivregister.de/api/public/reporting/laendertabelle
1609453146,26544,21773,4771,5642,3118,https://www.intensivregister.de/api/public/reporting/laendertabelle
1609456743,26544,21769,4775,5644,3121,https://www.intensivregister.de/api/public/reporting/laendertabelle
1609460351,26544,21762,4782,5642,3120,https://www.intensivregister.de/api/public/reporting/laendertabelle
1609463949,26544,21764,4780,5644,3120,https://www.intensivregister.de/api/public/reporting/laendertabelle
1609467548,26542,21768,4774,5645,3122,https://www.intensivregister.de/api/public/reporting/laendertabelle
1609471146,26542,21764,4778,5645,3125,https://www.intensivregister.de/api/public/reporting/laendertabelle
1609474743,26538,21761,4777,5651,3131,https://www.intensivregister.de/api/public/reporting/laendertabelle
1609478352,26537,21741,4796,5639,3132,https://www.intensivregister.de/api/public/reporting/laendertabelle
1609481951,26542,21702,4840,5611,3140,https://www.intensivregister.de/api/public/reporting/laendertabelle
1609485549,26529,21671,4858,5604,3129,https://www.intensivregister.de/api/public/reporting/laendertabelle
1609489147,26504,21622,4882,5595,3111,https://www.intensivregister.de/api/public/reporting/laendertabelle
1609492746,26479,21645,4834,5600,3113,https://www.intensivregister.de/api/public/reporting/laendertabelle
1609496345,26474,21631,4843,5597,3114,https://www.intensivregister.de/api/public/reporting/laendertabelle
1609499953,26472,21631,4841,5595,3116,https://www.intensivregister.de/api/public/reporting/laendertabelle
1609503551,26472,21635,4837,5597,3117,https://www.intensivregister.de/api/public/reporting/laendertabelle
1609507149,26474,21639,4835,5598,3117,https://www.intensivregister.de/api/public/reporting/laendertabelle
1609510747,26474,21642,4832,5597,3117,https://www.intensivregister.de/api/public/reporting/laendertabelle
1609514345,26474,21643,4831,5598,3120,https://www.intensivregister.de/api/public/reporting/laendertabelle
1609517944,26470,21639,4831,5599,3118,https://www.intensivregister.de/api/public/reporting/laendertabelle
1609521551,26470,21639,4831,5604,3120,https://www.intensivregister.de/api/public/reporting/laendertabelle
1609525149,26468,21640,4828,5604,3120,https://www.intensivregister.de/api/public/reporting/laendertabelle
1609528747,26471,21646,4825,5606,3122,https://www.intensivregister.de/api/public/reporting/laendertabelle
1609532345,26471,21645,4826,5606,3122,https://www.intensivregister.de/api/public/reporting/laendertabelle
1609535943,26471,21644,4827,5607,3122,https://www.intensivregister.de/api/public/reporting/laendertabelle
1609539551,26468,21646,4822,5609,3121,https://www.intensivregister.de/api/public/reporting/laendertabelle
1609543149,26468,21645,4823,5609,3121,https://www.intensivregister.de/api/public/reporting/laendertabelle
1609546749,26468,21639,4829,5608,3120,https://www.intensivregister.de/api/public/reporting/laendertabelle
1609557546,26470,21641,4829,5614,3118,https://www.intensivregister.de/api/public/reporting/laendertabelle
1609561144,26475,21645,4830,5613,3119,https://www.intensivregister.de/api/public/reporting/laendertabelle
1609564752,26482,21648,4834,5616,3114,https://www.intensivregister.de/api/public/reporting/laendertabelle
1609568351,26499,21708,4791,5653,3110,https://www.intensivregister.de/api/public/reporting/laendertabelle
1609571948,26525,21748,4777,5670,3109,https://www.intensivregister.de/api/public/reporting/laendertabelle
1609575546,26535,21779,4756,5713,3124,https://www.intensivregister.de/api/public/reporting/laendertabelle
1609579144,26534,21787,4747,5723,3125,https://www.intensivregister.de/api/public/reporting/laendertabelle
1609582751,26540,21788,4752,5739,3124,https://www.intensivregister.de/api/public/reporting/laendertabelle
1609586348,26540,21794,4746,5737,3123,https://www.intensivregister.de/api/public/reporting/laendertabelle
1609589951,26538,21795,4743,5733,3120,https://www.intensivregister.de/api/public/reporting/laendertabelle
1609593544,26533,21795,4738,5734,3121,https://www.intensivregister.de/api/public/reporting/laendertabelle
1609597147,26533,21790,4743,5729,3122,https://www.intensivregister.de/api/public/reporting/laendertabelle
1609600749,26533,21789,4744,5731,3124,https://www.intensivregister.de/api/public/reporting/laendertabelle
1609604350,26532,21787,4745,5730,3123,https://www.intensivregister.de/api/public/reporting/laendertabelle
1609607952,26528,21789,4739,5730,3125,https://www.intensivregister.de/api/public/reporting/laendertabelle
1609615146,26528,21791,4737,5730,3126,https://www.intensivregister.de/api/public/reporting/laendertabelle
1609622349,26528,21790,4738,5729,3125,https://www.intensivregister.de/api/public/reporting/laendertabelle
1609625952,26531,21794,4737,5729,3125,https://www.intensivregister.de/api/public/reporting/laendertabelle
1609629543,26532,21801,4731,5730,3126,https://www.intensivregister.de/api/public/reporting/laendertabelle
1609633145,26532,21799,4733,5732,3127,https://www.intensivregister.de/api/public/reporting/laendertabelle
1609636747,26532,21800,4732,5732,3127,https://www.intensivregister.de/api/public/reporting/laendertabelle
1609640348,26535,21795,4740,5730,3128,https://www.intensivregister.de/api/public/reporting/laendertabelle
1609643950,26534,21790,4744,5730,3126,https://www.intensivregister.de/api/public/reporting/laendertabelle
1609647551,26534,21791,4743,5732,3124,https://www.intensivregister.de/api/public/reporting/laendertabelle
1609651153,26539,21788,4751,5722,3121,https://www.intensivregister.de/api/public/reporting/laendertabelle
1609654745,26547,21812,4735,5721,3134,https://www.intensivregister.de/api/public/reporting/laendertabelle
1609658346,26547,21851,4696,5744,3145,https://www.intensivregister.de/api/public/reporting/laendertabelle
1609661948,26542,21881,4661,5755,3160,https://www.intensivregister.de/api/public/reporting/laendertabelle
1609665549,26546,21900,4646,5766,3174,https://www.intensivregister.de/api/public/reporting/laendertabelle
1609669145,26553,21894,4659,5764,3170,https://www.intensivregister.de/api/public/reporting/laendertabelle
1609672746,26552,21901,4651,5770,3170,https://www.intensivregister.de/api/public/reporting/laendertabelle
1609676348,26481,21847,4634,5768,3172,https://www.intensivregister.de/api/public/reporting/laendertabelle
1609679950,26479,21848,4631,5769,3174,https://www.intensivregister.de/api/public/reporting/laendertabelle
1609683552,26479,21844,4635,5770,3173,https://www.intensivregister.de/api/public/reporting/laendertabelle
1609687144,26453,21820,4633,5769,3172,https://www.intensivregister.de/api/public/reporting/laendertabelle
1609690746,26526,21879,4647,5774,3178,https://www.intensivregister.de/api/public/reporting/laendertabelle
1609694348,26526,21882,4644,5775,3178,https://www.intensivregister.de/api/public/reporting/laendertabelle
1609697949,26526,21889,4637,5778,3178,https://www.intensivregister.de/api/public/reporting/laendertabelle
1609701552,26526,21895,4631,5780,3179,https://www.intensivregister.de/api/public/reporting/laendertabelle
1609705152,26526,21897,4629,5784,3180,https://www.intensivregister.de/api/public/reporting/laendertabelle
1609708744,26514,21877,4637,5784,3180,https://www.intensivregister.de/api/public/reporting/laendertabelle
1609712346,26516,21874,4642,5785,3180,https://www.intensivregister.de/api/public/reporting/laendertabelle
1609715947,26516,21864,4652,5784,3180,https://www.intensivregister.de/api/public/reporting/laendertabelle
1609719552,26516,21862,4654,5783,3180,https://www.intensivregister.de/api/public/reporting/laendertabelle
1609723153,26516,21865,4651,5782,3179,https://www.intensivregister.de/api/public/reporting/laendertabelle
1609726746,26514,21866,4648,5783,3180,https://www.intensivregister.de/api/public/reporting/laendertabelle
1609730346,26510,21866,4644,5783,3182,https://www.intensivregister.de/api/public/reporting/laendertabelle
1609733948,26512,21833,4679,5772,3177,https://www.intensivregister.de/api/public/reporting/laendertabelle
1609737549,26514,21854,4660,5772,3173,https://www.intensivregister.de/api/public/reporting/laendertabelle
1609741153,26572,21921,4651,5771,3184,https://www.intensivregister.de/api/public/reporting/laendertabelle
1609744745,26616,21968,4648,5773,3187,https://www.intensivregister.de/api/public/reporting/laendertabelle
1609748349,26667,21991,4676,5756,3199,https://www.intensivregister.de/api/public/reporting/laendertabelle
1609751948,26689,21985,4704,5746,3214,https://www.intensivregister.de/api/public/reporting/laendertabelle
1609755545,26691,21996,4695,5745,3211,https://www.intensivregister.de/api/public/reporting/laendertabelle
1609759144,26682,21988,4694,5749,3212,https://www.intensivregister.de/api/public/reporting/laendertabelle
1609762744,26684,21990,4694,5751,3212,https://www.intensivregister.de/api/public/reporting/laendertabelle
1609766344,26679,21990,4689,5753,3216,https://www.intensivregister.de/api/public/reporting/laendertabelle
1609769952,26683,21988,4695,5752,3215,https://www.intensivregister.de/api/public/reporting/laendertabelle
1609773551,26683,21998,4685,5754,3216,https://www.intensivregister.de/api/public/reporting/laendertabelle
1609777150,26691,22002,4689,5756,3216,https://www.intensivregister.de/api/public/reporting/laendertabelle
1609780749,26691,21999,4692,5757,3216,https://www.intensivregister.de/api/public/reporting/laendertabelle
1609784348,26693,21998,4695,5756,3216,https://www.intensivregister.de/api/public/reporting/laendertabelle
1609787948,26693,21996,4697,5754,3216,https://www.intensivregister.de/api/public/reporting/laendertabelle
1609791548,26693,21994,4699,5754,3216,https://www.intensivregister.de/api/public/reporting/laendertabelle
1609798745,26694,21995,4699,5752,3216,https://www.intensivregister.de/api/public/reporting/laendertabelle
1609802353,26695,21995,4700,5752,3217,https://www.intensivregister.de/api/public/reporting/laendertabelle
1609809549,26695,22000,4695,5753,3216,https://www.intensivregister.de/api/public/reporting/laendertabelle
1609813149,26722,22034,4688,5750,3212,https://www.intensivregister.de/api/public/reporting/laendertabelle
1609816748,26721,22030,4691,5747,3210,https://www.intensivregister.de/api/public/reporting/laendertabelle
1609820348,26751,22055,4696,5743,3202,https://www.intensivregister.de/api/public/reporting/laendertabelle
1609823946,26768,22169,4599,5722,3198,https://www.intensivregister.de/api/public/reporting/laendertabelle
1609827547,26816,22244,4572,5706,3182,https://www.intensivregister.de/api/public/reporting/laendertabelle
1609831145,26829,22340,4489,5679,3184,https://www.intensivregister.de/api/public/reporting/laendertabelle
1609834744,26867,22359,4508,5676,3182,https://www.intensivregister.de/api/public/reporting/laendertabelle
1609838343,26875,22360,4515,5681,3183,https://www.intensivregister.de/api/public/reporting/laendertabelle
1609841944,26875,22368,4507,5677,3178,https://www.intensivregister.de/api/public/reporting/laendertabelle
1609845546,26869,22362,4507,5673,3175,https://www.intensivregister.de/api/public/reporting/laendertabelle
1609849148,26869,22360,4509,5673,3175,https://www.intensivregister.de/api/public/reporting/laendertabelle
1609852750,26864,22366,4498,5678,3180,https://www.intensivregister.de/api/public/reporting/laendertabelle
1609856352,26864,22364,4500,5676,3180,https://www.intensivregister.de/api/public/reporting/laendertabelle
1609859944,26863,22363,4500,5672,3179,https://www.intensivregister.de/api/public/reporting/laendertabelle
1609863546,26864,22366,4498,5673,3178,https://www.intensivregister.de/api/public/reporting/laendertabelle
1609867148,26864,22367,4497,5674,3178,https://www.intensivregister.de/api/public/reporting/laendertabelle
1609870751,26863,22365,4498,5675,3180,https://www.intensivregister.de/api/public/reporting/laendertabelle
1609874352,26863,22361,4502,5676,3181,https://www.intensivregister.de/api/public/reporting/laendertabelle
1609881546,26863,22361,4502,5677,3182,https://www.intensivregister.de/api/public/reporting/laendertabelle
1609885149,26863,22363,4500,5675,3183,https://www.intensivregister.de/api/public/reporting/laendertabelle
1609888750,26862,22362,4500,5676,3183,https://www.intensivregister.de/api/public/reporting/laendertabelle
1609895944,26860,22370,4490,5678,3183,https://www.intensivregister.de/api/public/reporting/laendertabelle
1609899545,26859,22366,4493,5675,3181,https://www.intensivregister.de/api/public/reporting/laendertabelle
1609903147,26861,22361,4500,5676,3181,https://www.intensivregister.de/api/public/reporting/laendertabelle
1609906750,26860,22371,4489,5666,3169,https://www.intensivregister.de/api/public/reporting/laendertabelle
1609910351,26869,22419,4450,5661,3165,https://www.intensivregister.de/api/public/reporting/laendertabelle
1609913944,26903,22437,4466,5611,3146,https://www.intensivregister.de/api/public/reporting/laendertabelle
1609917545,26909,22498,4411,5585,3141,https://www.intensivregister.de/api/public/reporting/laendertabelle
1609921148,26924,22495,4429,5578,3138,https://www.intensivregister.de/api/public/reporting/laendertabelle
1609924750,26932,22471,4461,5569,3127,https://www.intensivregister.de/api/public/reporting/laendertabelle
1609928352,26929,22477,4452,5573,3125,https://www.intensivregister.de/api/public/reporting/laendertabelle
1609931944,26931,22490,4441,5571,3121,https://www.intensivregister.de/api/public/reporting/laendertabelle
1609935546,26934,22492,4442,5572,3123,https://www.intensivregister.de/api/public/reporting/laendertabelle
1609939149,26929,22490,4439,5571,3124,https://www.intensivregister.de/api/public/reporting/laendertabelle
1609942751,26927,22489,4438,5573,3124,https://www.intensivregister.de/api/public/reporting/laendertabelle
1609946343,26927,22487,4440,5572,3124,https://www.intensivregister.de/api/public/reporting/laendertabelle
1609949945,26927,22486,4441,5574,3125,https://www.intensivregister.de/api/public/reporting/laendertabelle
1609957150,26928,22487,4441,5574,3125,https://www.intensivregister.de/api/public/reporting/laendertabelle
1609960752,26928,22488,4440,5574,3125,https://www.intensivregister.de/api/public/reporting/laendertabelle
1609964344,26928,22487,4441,5574,3125,https://www.intensivregister.de/api/public/reporting/laendertabelle
1609967947,26927,22486,4441,5574,3125,https://www.intensivregister.de/api/public/reporting/laendertabelle
1609971550,26926,22482,4444,5572,3125,https://www.intensivregister.de/api/public/reporting/laendertabelle
1609975152,26928,22491,4437,5571,3125,https://www.intensivregister.de/api/public/reporting/laendertabelle
1609978749,26928,22488,4440,5569,3125,https://www.intensivregister.de/api/public/reporting/laendertabelle
1609982351,26930,22489,4441,5568,3126,https://www.intensivregister.de/api/public/reporting/laendertabelle
1609985944,26934,22494,4440,5572,3128,https://www.intensivregister.de/api/public/reporting/laendertabelle
1609989544,26934,22492,4442,5575,3127,https://www.intensivregister.de/api/public/reporting/laendertabelle
1609993143,26943,22480,4463,5555,3127,https://www.intensivregister.de/api/public/reporting/laendertabelle
1609996752,26958,22507,4451,5543,3115,https://www.intensivregister.de/api/public/reporting/laendertabelle
1610000351,26948,22458,4490,5536,3113,https://www.intensivregister.de/api/public/reporting/laendertabelle
1610003950,26928,22448,4480,5514,3104,https://www.intensivregister.de/api/public/reporting/laendertabelle
1610007550,26931,22464,4467,5511,3106,https://www.intensivregister.de/api/public/reporting/laendertabelle
1610011148,26941,22462,4479,5494,3103,https://www.intensivregister.de/api/public/reporting/laendertabelle
1610014750,26937,22463,4474,5490,3096,https://www.intensivregister.de/api/public/reporting/laendertabelle
1610018354,26939,22460,4479,5491,3098,https://www.intensivregister.de/api/public/reporting/laendertabelle
1610021949,26940,22461,4479,5490,3098,https://www.intensivregister.de/api/public/reporting/laendertabelle
1610025546,26937,22466,4471,5492,3098,https://www.intensivregister.de/api/public/reporting/laendertabelle
1610029152,26940,22474,4466,5499,3102,https://www.intensivregister.de/api/public/reporting/laendertabelle
1610032753,26951,22483,4468,5502,3103,https://www.intensivregister.de/api/public/reporting/laendertabelle
1610036345,26951,22491,4460,5503,3104,https://www.intensivregister.de/api/public/reporting/laendertabelle
1610039953,26950,22492,4458,5504,3104,https://www.intensivregister.de/api/public/reporting/laendertabelle
1610043549,26951,22493,4458,5503,3104,https://www.intensivregister.de/api/public/reporting/laendertabelle
1610054351,26951,22493,4458,5504,3104,https://www.intensivregister.de/api/public/reporting/laendertabelle
1610057948,26950,22494,4456,5507,3107,https://www.intensivregister.de/api/public/reporting/laendertabelle
1610061545,26952,22489,4463,5505,3106,https://www.intensivregister.de/api/public/reporting/laendertabelle
1610065153,26952,22487,4465,5504,3106,https://www.intensivregister.de/api/public/reporting/laendertabelle
1610068749,26953,22490,4463,5505,3107,https://www.intensivregister.de/api/public/reporting/laendertabelle
1610072346,26953,22494,4459,5505,3107,https://www.intensivregister.de/api/public/reporting/laendertabelle
1610075953,26949,22496,4453,5505,3105,https://www.intensivregister.de/api/public/reporting/laendertabelle
1610079550,26945,22502,4443,5507,3112,https://www.intensivregister.de/api/public/reporting/laendertabelle
1610083146,26930,22541,4389,5481,3085,https://www.intensivregister.de/api/public/reporting/laendertabelle
1610086744,26917,22560,4357,5464,3083,https://www.intensivregister.de/api/public/reporting/laendertabelle
1610090352,26923,22573,4350,5453,3074,https://www.intensivregister.de/api/public/reporting/laendertabelle
1610093951,26922,22566,4356,5477,3069,https://www.intensivregister.de/api/public/reporting/laendertabelle
1610097557,26933,22572,4361,5481,3072,https://www.intensivregister.de/api/public/reporting/laendertabelle
1610101144,26930,22565,4365,5479,3073,https://www.intensivregister.de/api/public/reporting/laendertabelle
1610104752,26933,22564,4369,5482,3071,https://www.intensivregister.de/api/public/reporting/laendertabelle
1610108452,26930,22569,4361,5486,3072,https://www.intensivregister.de/api/public/reporting/laendertabelle
1610111947,26931,22564,4367,5489,3070,https://www.intensivregister.de/api/public/reporting/laendertabelle
1610115545,26933,22565,4368,5491,3070,https://www.intensivregister.de/api/public/reporting/laendertabelle
1610119152,26934,22578,4356,5495,3071,https://www.intensivregister.de/api/public/reporting/laendertabelle
1610122749,26933,22578,4355,5494,3070,https://www.intensivregister.de/api/public/reporting/laendertabelle
1610126346,26933,22579,4354,5495,3072,https://www.intensivregister.de/api/public/reporting/laendertabelle
1610129944,26933,22578,4355,5496,3073,https://www.intensivregister.de/api/public/reporting/laendertabelle
1610133550,26935,22582,4353,5497,3074,https://www.intensivregister.de/api/public/reporting/laendertabelle
1610140744,26935,22583,4352,5497,3074,https://www.intensivregister.de/api/public/reporting/laendertabelle
1610144351,26930,22581,4349,5497,3074,https://www.intensivregister.de/api/public/reporting/laendertabelle
1610147948,26930,22579,4351,5495,3073,https://www.intensivregister.de/api/public/reporting/laendertabelle
1610151545,26930,22583,4347,5496,3076,https://www.intensivregister.de/api/public/reporting/laendertabelle
1610155152,26932,22582,4350,5496,3076,https://www.intensivregister.de/api/public/reporting/laendertabelle
1610158748,26931,22577,4354,5502,3074,https://www.intensivregister.de/api/public/reporting/laendertabelle
1610162345,26932,22580,4352,5503,3074,https://www.intensivregister.de/api/public/reporting/laendertabelle
1610165945,26932,22566,4366,5497,3074,https://www.intensivregister.de/api/public/reporting/laendertabelle
1610169549,26915,22539,4376,5489,3077,https://www.intensivregister.de/api/public/reporting/laendertabelle
1610173144,26903,22445,4458,5461,3077,https://www.intensivregister.de/api/public/reporting/laendertabelle
1610176749,26875,22399,4476,5432,3068,https://www.intensivregister.de/api/public/reporting/laendertabelle
1610180344,26825,22303,4522,5418,3061,https://www.intensivregister.de/api/public/reporting/laendertabelle
1610183948,26819,22280,4539,5412,3069,https://www.intensivregister.de/api/public/reporting/laendertabelle
1610187543,26821,22275,4546,5413,3067,https://www.intensivregister.de/api/public/reporting/laendertabelle
1610191148,26818,22274,4544,5407,3071,https://www.intensivregister.de/api/public/reporting/laendertabelle
1610194753,26819,22273,4546,5408,3070,https://www.intensivregister.de/api/public/reporting/laendertabelle
1610198348,26819,22271,4548,5409,3072,https://www.intensivregister.de/api/public/reporting/laendertabelle
1610201952,26819,22273,4546,5409,3072,https://www.intensivregister.de/api/public/reporting/laendertabelle
1610205547,26820,22261,4559,5407,3073,https://www.intensivregister.de/api/public/reporting/laendertabelle
1610209153,26819,22255,4564,5406,3073,https://www.intensivregister.de/api/public/reporting/laendertabelle
1610219950,26819,22255,4564,5405,3071,https://www.intensivregister.de/api/public/reporting/laendertabelle
1610223547,26819,22257,4562,5407,3071,https://www.intensivregister.de/api/public/reporting/laendertabelle
1610230752,26819,22249,4570,5404,3073,https://www.intensivregister.de/api/public/reporting/laendertabelle
1610234348,26821,22247,4574,5405,3073,https://www.intensivregister.de/api/public/reporting/laendertabelle
1610237945,26821,22243,4578,5405,3073,https://www.intensivregister.de/api/public/reporting/laendertabelle
1610241552,26823,22244,4579,5405,3073,https://www.intensivregister.de/api/public/reporting/laendertabelle
1610245148,26823,22245,4578,5404,3073,https://www.intensivregister.de/api/public/reporting/laendertabelle
1610248745,26821,22243,4578,5403,3072,https://www.intensivregister.de/api/public/reporting/laendertabelle
1610252351,26819,22229,4590,5392,3069,https://www.intensivregister.de/api/public/reporting/laendertabelle
1610255948,26804,22150,4654,5373,3066,https://www.intensivregister.de/api/public/reporting/laendertabelle
1610259544,26790,22039,4751,5363,3051,https://www.intensivregister.de/api/public/reporting/laendertabelle
1610263151,26770,21905,4865,5333,3043,https://www.intensivregister.de/api/public/reporting/laendertabelle
1610266749,26749,21832,4917,5330,3050,https://www.intensivregister.de/api/public/reporting/laendertabelle
1610270344,26723,21785,4938,5321,3050,https://www.intensivregister.de/api/public/reporting/laendertabelle
1610273952,26724,21789,4935,5317,3047,https://www.intensivregister.de/api/public/reporting/laendertabelle
1610277548,26724,21782,4942,5319,3050,https://www.intensivregister.de/api/public/reporting/laendertabelle
1610281145,26721,21776,4945,5321,3051,https://www.intensivregister.de/api/public/reporting/laendertabelle
1610284752,26721,21775,4946,5319,3046,https://www.intensivregister.de/api/public/reporting/laendertabelle
1610288350,26721,21777,4944,5320,3048,https://www.intensivregister.de/api/public/reporting/laendertabelle
1610291947,26721,21778,4943,5320,3048,https://www.intensivregister.de/api/public/reporting/laendertabelle
1610295545,26721,21778,4943,5317,3048,https://www.intensivregister.de/api/public/reporting/laendertabelle
1610299152,26721,21781,4940,5317,3048,https://www.intensivregister.de/api/public/reporting/laendertabelle
1610302747,26721,21779,4942,5317,3046,https://www.intensivregister.de/api/public/reporting/laendertabelle
1610306344,26721,21778,4943,5317,3046,https://www.intensivregister.de/api/public/reporting/laendertabelle
1610309950,26718,21778,4940,5317,3046,https://www.intensivregister.de/api/public/reporting/laendertabelle
1610317144,26718,21780,4938,5319,3046,https://www.intensivregister.de/api/public/reporting/laendertabelle
1610320750,26718,21782,4936,5323,3046,https://www.intensivregister.de/api/public/reporting/laendertabelle
1610324347,26718,21784,4934,5323,3045,https://www.intensivregister.de/api/public/reporting/laendertabelle
1610327953,26718,21778,4940,5323,3045,https://www.intensivregister.de/api/public/reporting/laendertabelle
1610331549,26718,21783,4935,5324,3045,https://www.intensivregister.de/api/public/reporting/laendertabelle
1610335145,26718,21788,4930,5321,3047,https://www.intensivregister.de/api/public/reporting/laendertabelle
1610338752,26731,21827,4904,5335,3045,https://www.intensivregister.de/api/public/reporting/laendertabelle
1610342348,26756,21851,4905,5331,3059,https://www.intensivregister.de/api/public/reporting/laendertabelle
1610345947,26803,21899,4904,5322,3032,https://www.intensivregister.de/api/public/reporting/laendertabelle
1610349545,26790,21926,4864,5300,3025,https://www.intensivregister.de/api/public/reporting/laendertabelle
1610353152,26816,21972,4844,5308,3018,https://www.intensivregister.de/api/public/reporting/laendertabelle
1610356750,26818,22011,4807,5290,3008,https://www.intensivregister.de/api/public/reporting/laendertabelle
1610360347,26820,22023,4797,5290,3005,https://www.intensivregister.de/api/public/reporting/laendertabelle
1610363945,26825,22027,4798,5291,3003,https://www.intensivregister.de/api/public/reporting/laendertabelle
1610367552,26822,22031,4791,5291,3001,https://www.intensivregister.de/api/public/reporting/laendertabelle
1610371149,26820,22026,4794,5292,3003,https://www.intensivregister.de/api/public/reporting/laendertabelle
1610374747,26821,22031,4790,5293,3002,https://www.intensivregister.de/api/public/reporting/laendertabelle
1610378343,26823,22041,4782,5294,3003,https://www.intensivregister.de/api/public/reporting/laendertabelle
1610381950,26800,22026,4774,5293,3003,https://www.intensivregister.de/api/public/reporting/laendertabelle
1610385547,26800,22028,4772,5294,3003,https://www.intensivregister.de/api/public/reporting/laendertabelle
1610389145,26800,22029,4771,5297,3007,https://www.intensivregister.de/api/public/reporting/laendertabelle
1610392751,26800,22034,4766,5297,3007,https://www.intensivregister.de/api/public/reporting/laendertabelle
1610396348,26800,22037,4763,5297,3007,https://www.intensivregister.de/api/public/reporting/laendertabelle
1610399945,26799,22042,4757,5298,3008,https://www.intensivregister.de/api/public/reporting/laendertabelle
1610403551,26799,22049,4750,5301,3007,https://www.intensivregister.de/api/public/reporting/laendertabelle
1610407147,26799,22049,4750,5302,3007,https://www.intensivregister.de/api/public/reporting/laendertabelle
1610410744,26796,22042,4754,5304,3006,https://www.intensivregister.de/api/public/reporting/laendertabelle
1610414350,26796,22043,4753,5304,3006,https://www.intensivregister.de/api/public/reporting/laendertabelle
1610417948,26798,22048,4750,5307,3007,https://www.intensivregister.de/api/public/reporting/laendertabelle
1610421545,26800,22049,4751,5306,3008,https://www.intensivregister.de/api/public/reporting/laendertabelle
1610425151,26825,22109,4716,5293,3000,https://www.intensivregister.de/api/public/reporting/laendertabelle
1610428748,26907,22247,4660,5283,2992,https://www.intensivregister.de/api/public/reporting/laendertabelle
1610432345,26947,22362,4585,5279,3000,https://www.intensivregister.de/api/public/reporting/laendertabelle
1610435952,26973,22383,4590,5243,2996,https://www.intensivregister.de/api/public/reporting/laendertabelle
1610439550,26996,22426,4570,5229,3000,https://www.intensivregister.de/api/public/reporting/laendertabelle
1610443148,27014,22434,4580,5229,3000,https://www.intensivregister.de/api/public/reporting/laendertabelle
1610446746,27013,22441,4572,5231,3001,https://www.intensivregister.de/api/public/reporting/laendertabelle
1610450354,27012,22435,4577,5231,3001,https://www.intensivregister.de/api/public/reporting/laendertabelle
1610453951,27008,22429,4579,5226,2999,https://www.intensivregister.de/api/public/reporting/laendertabelle
1610457550,27010,22429,4581,5227,2998,https://www.intensivregister.de/api/public/reporting/laendertabelle
1610461146,27004,22429,4575,5223,2998,https://www.intensivregister.de/api/public/reporting/laendertabelle
1610464744,27003,22428,4575,5222,2998,https://www.intensivregister.de/api/public/reporting/laendertabelle
1610468345,27001,22427,4574,5224,3001,https://www.intensivregister.de/api/public/reporting/laendertabelle
1610471953,27001,22426,4575,5223,3000,https://www.intensivregister.de/api/public/reporting/laendertabelle
1610475551,26995,22425,4570,5224,3000,https://www.intensivregister.de/api/public/reporting/laendertabelle
1610479148,26995,22425,4570,5225,3001,https://www.intensivregister.de/api/public/reporting/laendertabelle
1610482745,26995,22424,4571,5225,3000,https://www.intensivregister.de/api/public/reporting/laendertabelle
1610489951,26995,22423,4572,5223,2998,https://www.intensivregister.de/api/public/reporting/laendertabelle
1610493544,26995,22427,4568,5223,2999,https://www.intensivregister.de/api/public/reporting/laendertabelle
1610497149,26996,22421,4575,5223,2999,https://www.intensivregister.de/api/public/reporting/laendertabelle
1610500743,26995,22421,4574,5223,2999,https://www.intensivregister.de/api/public/reporting/laendertabelle
1610504348,26994,22419,4575,5224,2999,https://www.intensivregister.de/api/public/reporting/laendertabelle
1610507953,26995,22416,4579,5224,2998,https://www.intensivregister.de/api/public/reporting/laendertabelle
1610511547,27005,22444,4561,5208,2999,https://www.intensivregister.de/api/public/reporting/laendertabelle
1610515151,27022,22461,4561,5194,2982,https://www.intensivregister.de/api/public/reporting/laendertabelle
1610518746,27025,22515,4510,5191,2978,https://www.intensivregister.de/api/public/reporting/laendertabelle
1610522352,27007,22537,4470,5179,2971,https://www.intensivregister.de/api/public/reporting/laendertabelle
1610525947,27025,22576,4449,5179,2966,https://www.intensivregister.de/api/public/reporting/laendertabelle
1610529553,26991,22568,4423,5183,2969,https://www.intensivregister.de/api/public/reporting/laendertabelle
1610533148,26981,22555,4426,5182,2973,https://www.intensivregister.de/api/public/reporting/laendertabelle
1610536743,26979,22558,4421,5182,2977,https://www.intensivregister.de/api/public/reporting/laendertabelle
1610540349,26977,22556,4421,5184,2977,https://www.intensivregister.de/api/public/reporting/laendertabelle
1610543944,26977,22560,4417,5184,2976,https://www.intensivregister.de/api/public/reporting/laendertabelle
1610547549,27001,22580,4421,5185,2977,https://www.intensivregister.de/api/public/reporting/laendertabelle
1610551148,26997,22582,4415,5187,2978,https://www.intensivregister.de/api/public/reporting/laendertabelle
1610558352,26997,22583,4414,5187,2978,https://www.intensivregister.de/api/public/reporting/laendertabelle
1610561949,26997,22581,4416,5187,2978,https://www.intensivregister.de/api/public/reporting/laendertabelle
1610572751,26997,22583,4414,5188,2978,https://www.intensivregister.de/api/public/reporting/laendertabelle
1610576347,26902,22493,4409,5174,2967,https://www.intensivregister.de/api/public/reporting/laendertabelle
1610579945,26904,22497,4407,5173,2967,https://www.intensivregister.de/api/public/reporting/laendertabelle
1610583551,26902,22493,4409,5172,2967,https://www.intensivregister.de/api/public/reporting/laendertabelle
1610587149,26906,22497,4409,5171,2968,https://www.intensivregister.de/api/public/reporting/laendertabelle
1610590745,26911,22504,4407,5173,2969,https://www.intensivregister.de/api/public/reporting/laendertabelle
1610594352,26916,22504,4412,5174,2970,https://www.intensivregister.de/api/public/reporting/laendertabelle
1610597949,26920,22531,4389,5167,2969,https://www.intensivregister.de/api/public/reporting/laendertabelle
1610601545,26934,22558,4376,5137,2947,https://www.intensivregister.de/api/public/reporting/laendertabelle
1610605153,26918,22524,4394,5122,2943,https://www.intensivregister.de/api/public/reporting/laendertabelle
1610608750,26912,22531,4381,5124,2940,https://www.intensivregister.de/api/public/reporting/laendertabelle
1610612348,27012,22609,4403,5124,2949,https://www.intensivregister.de/api/public/reporting/laendertabelle
1610615946,27002,22613,4389,5124,2945,https://www.intensivregister.de/api/public/reporting/laendertabelle
1610619543,27005,22614,4391,5121,2943,https://www.intensivregister.de/api/public/reporting/laendertabelle
1610623151,26992,22601,4391,5119,2943,https://www.intensivregister.de/api/public/reporting/laendertabelle
1610626748,26992,22598,4394,5124,2946,https://www.intensivregister.de/api/public/reporting/laendertabelle
1610630347,26989,22595,4394,5124,2947,https://www.intensivregister.de/api/public/reporting/laendertabelle
1610633944,26991,22593,4398,5124,2948,https://www.intensivregister.de/api/public/reporting/laendertabelle
1610637552,26991,22594,4397,5123,2947,https://www.intensivregister.de/api/public/reporting/laendertabelle
1610641149,26990,22593,4397,5124,2946,https://www.intensivregister.de/api/public/reporting/laendertabelle
1610644747,26988,22596,4392,5125,2946,https://www.intensivregister.de/api/public/reporting/laendertabelle
1610648345,26988,22602,4386,5125,2947,https://www.intensivregister.de/api/public/reporting/laendertabelle
1610655548,26988,22602,4386,5127,2947,https://www.intensivregister.de/api/public/reporting/laendertabelle
1610662751,26989,22594,4395,5123,2946,https://www.intensivregister.de/api/public/reporting/laendertabelle
1610666349,26985,22593,4392,5121,2946,https://www.intensivregister.de/api/public/reporting/laendertabelle
1610669945,26985,22592,4393,5120,2944,https://www.intensivregister.de/api/public/reporting/laendertabelle
1610673552,26984,22591,4393,5119,2944,https://www.intensivregister.de/api/public/reporting/laendertabelle
1610677149,26981,22587,4394,5118,2942,https://www.intensivregister.de/api/public/reporting/laendertabelle
1610680746,26979,22591,4388,5117,2943,https://www.intensivregister.de/api/public/reporting/laendertabelle
1610684352,26965,22581,4384,5111,2943,https://www.intensivregister.de/api/public/reporting/laendertabelle
1610687950,26953,22588,4365,5114,2954,https://www.intensivregister.de/api/public/reporting/laendertabelle
1610691548,26978,22609,4369,5094,2941,https://www.intensivregister.de/api/public/reporting/laendertabelle
1610695145,26958,22601,4357,5068,2944,https://www.intensivregister.de/api/public/reporting/laendertabelle
1610698744,26950,22597,4353,5064,2941,https://www.intensivregister.de/api/public/reporting/laendertabelle
1610702351,26970,22567,4403,5070,2935,https://www.intensivregister.de/api/public/reporting/laendertabelle
1610705949,26970,22579,4391,5069,2932,https://www.intensivregister.de/api/public/reporting/laendertabelle
1610709546,26964,22574,4390,5070,2931,https://www.intensivregister.de/api/public/reporting/laendertabelle
1610713144,26963,22573,4390,5072,2933,https://www.intensivregister.de/api/public/reporting/laendertabelle
1610716751,26960,22570,4390,5071,2931,https://www.intensivregister.de/api/public/reporting/laendertabelle
1610720349,26962,22565,4397,5070,2931,https://www.intensivregister.de/api/public/reporting/laendertabelle
1610723946,26956,22573,4383,5069,2930,https://www.intensivregister.de/api/public/reporting/laendertabelle
1610727544,26956,22571,4385,5070,2929,https://www.intensivregister.de/api/public/reporting/laendertabelle
1610731152,26956,22569,4387,5070,2930,https://www.intensivregister.de/api/public/reporting/laendertabelle
1610741953,26956,22571,4385,5070,2930,https://www.intensivregister.de/api/public/reporting/laendertabelle
1610745549,26956,22573,4383,5071,2930,https://www.intensivregister.de/api/public/reporting/laendertabelle
1610749145,26954,22568,4386,5072,2929,https://www.intensivregister.de/api/public/reporting/laendertabelle
1610752871,26953,22590,4363,5073,2931,https://www.intensivregister.de/api/public/reporting/laendertabelle
1610756344,26953,22595,4358,5071,2931,https://www.intensivregister.de/api/public/reporting/laendertabelle
1610759946,26953,22594,4359,5075,2931,https://www.intensivregister.de/api/public/reporting/laendertabelle
1610763548,26955,22589,4366,5074,2930,https://www.intensivregister.de/api/public/reporting/laendertabelle
1610767150,26958,22592,4366,5077,2928,https://www.intensivregister.de/api/public/reporting/laendertabelle
1610770752,26963,22583,4380,5072,2927,https://www.intensivregister.de/api/public/reporting/laendertabelle
1610774344,26969,22548,4421,5076,2937,https://www.intensivregister.de/api/public/reporting/laendertabelle
1610777952,26928,22518,4410,5055,2918,https://www.intensivregister.de/api/public/reporting/laendertabelle
1610781548,26887,22434,4453,5032,2893,https://www.intensivregister.de/api/public/reporting/laendertabelle
1610785146,26875,22330,4545,5021,2874,https://www.intensivregister.de/api/public/reporting/laendertabelle
1610788752,26881,22339,4542,5014,2867,https://www.intensivregister.de/api/public/reporting/laendertabelle
1610792350,26866,22322,4544,5012,2866,https://www.intensivregister.de/api/public/reporting/laendertabelle
1610795946,26870,22312,4558,5015,2867,https://www.intensivregister.de/api/public/reporting/laendertabelle
1610799554,26869,22305,4564,5014,2865,https://www.intensivregister.de/api/public/reporting/laendertabelle
1610803149,26869,22305,4564,5012,2865,https://www.intensivregister.de/api/public/reporting/laendertabelle
1610806745,26869,22296,4573,5010,2865,https://www.intensivregister.de/api/public/reporting/laendertabelle
1610810353,26870,22293,4577,5009,2863,https://www.intensivregister.de/api/public/reporting/laendertabelle
1610813947,26870,22294,4576,5010,2865,https://www.intensivregister.de/api/public/reporting/laendertabelle
1610817544,26870,22291,4579,5009,2865,https://www.intensivregister.de/api/public/reporting/laendertabelle
1610821150,26870,22289,4581,5009,2865,https://www.intensivregister.de/api/public/reporting/laendertabelle
1610824746,26870,22290,4580,5008,2864,https://www.intensivregister.de/api/public/reporting/laendertabelle
1610828353,26870,22290,4580,5009,2865,https://www.intensivregister.de/api/public/reporting/laendertabelle
1610835547,26870,22283,4587,5009,2864,https://www.intensivregister.de/api/public/reporting/laendertabelle
1610839143,26870,22281,4589,5008,2863,https://www.intensivregister.de/api/public/reporting/laendertabelle
1610842750,26868,22278,4590,5007,2862,https://www.intensivregister.de/api/public/reporting/laendertabelle
1610846347,26868,22288,4580,5007,2862,https://www.intensivregister.de/api/public/reporting/laendertabelle
1610849955,26868,22285,4583,5009,2864,https://www.intensivregister.de/api/public/reporting/laendertabelle
1610853552,26866,22281,4585,5011,2865,https://www.intensivregister.de/api/public/reporting/laendertabelle
1610857154,26863,22273,4590,5012,2863,https://www.intensivregister.de/api/public/reporting/laendertabelle
1610860753,26871,22221,4650,5017,2848,https://www.intensivregister.de/api/public/reporting/laendertabelle
1610864344,26854,22061,4793,4998,2845,https://www.intensivregister.de/api/public/reporting/laendertabelle
1610867944,26872,22002,4870,4994,2844,https://www.intensivregister.de/api/public/reporting/laendertabelle
1610871545,26862,21964,4898,4972,2827,https://www.intensivregister.de/api/public/reporting/laendertabelle
1610875146,26838,21890,4948,4970,2835,https://www.intensivregister.de/api/public/reporting/laendertabelle
1610878747,26841,21885,4956,4972,2835,https://www.intensivregister.de/api/public/reporting/laendertabelle
1610882349,26842,21882,4960,4971,2836,https://www.intensivregister.de/api/public/reporting/laendertabelle
1610885951,26842,21879,4963,4972,2836,https://www.intensivregister.de/api/public/reporting/laendertabelle
1610889552,26837,21877,4960,4972,2836,https://www.intensivregister.de/api/public/reporting/laendertabelle
1610893143,26835,21877,4958,4975,2835,https://www.intensivregister.de/api/public/reporting/laendertabelle
1610896746,26835,21874,4961,4972,2833,https://www.intensivregister.de/api/public/reporting/laendertabelle
1610900348,26835,21871,4964,4971,2832,https://www.intensivregister.de/api/public/reporting/laendertabelle
1610903948,26835,21875,4960,4971,2832,https://www.intensivregister.de/api/public/reporting/laendertabelle
1610907551,26835,21875,4960,4969,2833,https://www.intensivregister.de/api/public/reporting/laendertabelle
1610911152,26835,21870,4965,4969,2833,https://www.intensivregister.de/api/public/reporting/laendertabelle
1610914744,26835,21872,4963,4970,2834,https://www.intensivregister.de/api/public/reporting/laendertabelle
1610918463,26835,21871,4964,4970,2834,https://www.intensivregister.de/api/public/reporting/laendertabelle
1610921947,26836,21874,4962,4972,2836,https://www.intensivregister.de/api/public/reporting/laendertabelle
1610925549,26834,21876,4958,4972,2835,https://www.intensivregister.de/api/public/reporting/laendertabelle
1610929151,26833,21877,4956,4972,2835,https://www.intensivregister.de/api/public/reporting/laendertabelle
1610932753,26833,21883,4950,4970,2835,https://www.intensivregister.de/api/public/reporting/laendertabelle
1610936468,26832,21882,4950,4971,2836,https://www.intensivregister.de/api/public/reporting/laendertabelle
1610939946,26832,21883,4949,4973,2835,https://www.intensivregister.de/api/public/reporting/laendertabelle
1610943548,26826,21883,4943,4982,2832,https://www.intensivregister.de/api/public/reporting/laendertabelle
1610947150,26829,21892,4937,4991,2850,https://www.intensivregister.de/api/public/reporting/laendertabelle
1610950746,26900,21995,4905,5000,2852,https://www.intensivregister.de/api/public/reporting/laendertabelle
1610954347,26934,22031,4903,5012,2859,https://www.intensivregister.de/api/public/reporting/laendertabelle
1610957947,26960,22109,4851,5005,2865,https://www.intensivregister.de/api/public/reporting/laendertabelle
1610961547,26977,22118,4859,5009,2870,https://www.intensivregister.de/api/public/reporting/laendertabelle
1610965147,26986,22119,4867,5007,2869,https://www.intensivregister.de/api/public/reporting/laendertabelle
1610968752,26989,22124,4865,5004,2867,https://www.intensivregister.de/api/public/reporting/laendertabelle
1610972346,26989,22122,4867,5003,2867,https://www.intensivregister.de/api/public/reporting/laendertabelle
1610975949,26986,22126,4860,5007,2869,https://www.intensivregister.de/api/public/reporting/laendertabelle
1610979552,26986,22127,4859,5008,2866,https://www.intensivregister.de/api/public/reporting/laendertabelle
1610983145,26986,22130,4856,5006,2866,https://www.intensivregister.de/api/public/reporting/laendertabelle
1610986748,26986,22129,4857,5009,2868,https://www.intensivregister.de/api/public/reporting/laendertabelle
1610993946,26988,22132,4856,5009,2868,https://www.intensivregister.de/api/public/reporting/laendertabelle
1610997546,26988,22130,4858,5009,2868,https://www.intensivregister.de/api/public/reporting/laendertabelle
1611008460,26988,22133,4855,5009,2868,https://www.intensivregister.de/api/public/reporting/laendertabelle
1611011951,26988,22126,4862,5005,2867,https://www.intensivregister.de/api/public/reporting/laendertabelle
1611019258,26987,22123,4864,5005,2867,https://www.intensivregister.de/api/public/reporting/laendertabelle
1611022858,26987,22128,4859,5006,2868,https://www.intensivregister.de/api/public/reporting/laendertabelle
1611026343,26988,22127,4861,5006,2872,https://www.intensivregister.de/api/public/reporting/laendertabelle
1611029946,26996,22185,4811,5001,2869,https://www.intensivregister.de/api/public/reporting/laendertabelle
1611033549,27016,22296,4720,4978,2865,https://www.intensivregister.de/api/public/reporting/laendertabelle
1611037150,27028,22436,4592,4952,2863,https://www.intensivregister.de/api/public/reporting/laendertabelle
1611040753,27023,22501,4522,4944,2863,https://www.intensivregister.de/api/public/reporting/laendertabelle
1611044345,27022,22569,4453,4949,2870,https://www.intensivregister.de/api/public/reporting/laendertabelle
1611048053,27029,22605,4424,4949,2865,https://www.intensivregister.de/api/public/reporting/laendertabelle
1611051551,27029,22605,4424,4942,2858,https://www.intensivregister.de/api/public/reporting/laendertabelle
1611055143,27029,22606,4423,4935,2855,https://www.intensivregister.de/api/public/reporting/laendertabelle
1611058747,27026,22610,4416,4937,2855,https://www.intensivregister.de/api/public/reporting/laendertabelle
1611062461,27029,22620,4409,4936,2855,https://www.intensivregister.de/api/public/reporting/laendertabelle
1611066061,27030,22621,4409,4937,2855,https://www.intensivregister.de/api/public/reporting/laendertabelle
1611069672,27030,22621,4409,4936,2856,https://www.intensivregister.de/api/public/reporting/laendertabelle
1611073146,27027,22635,4392,4939,2859,https://www.intensivregister.de/api/public/reporting/laendertabelle
1611076859,27027,22639,4388,4940,2860,https://www.intensivregister.de/api/public/reporting/laendertabelle
1611080506,27028,22640,4388,4940,2860,https://www.intensivregister.de/api/public/reporting/laendertabelle
1611084076,27026,22642,4384,4940,2860,https://www.intensivregister.de/api/public/reporting/laendertabelle
1611087546,27026,22642,4384,4939,2859,https://www.intensivregister.de/api/public/reporting/laendertabelle
1611091257,27026,22642,4384,4938,2860,https://www.intensivregister.de/api/public/reporting/laendertabelle
1611094750,27026,22639,4387,4940,2860,https://www.intensivregister.de/api/public/reporting/laendertabelle
1611098473,27027,22637,4390,4939,2860,https://www.intensivregister.de/api/public/reporting/laendertabelle
1611109273,27027,22633,4394,4940,2859,https://www.intensivregister.de/api/public/reporting/laendertabelle
1611112914,27028,22626,4402,4943,2857,https://www.intensivregister.de/api/public/reporting/laendertabelle
1611116464,27046,22658,4388,4925,2836,https://www.intensivregister.de/api/public/reporting/laendertabelle
1611120053,27055,22629,4426,4869,2810,https://www.intensivregister.de/api/public/reporting/laendertabelle
1611123549,27047,22642,4405,4844,2773,https://www.intensivregister.de/api/public/reporting/laendertabelle
1611127152,27074,22718,4356,4829,2775,https://www.intensivregister.de/api/public/reporting/laendertabelle
1611130744,27071,22732,4339,4834,2778,https://www.intensivregister.de/api/public/reporting/laendertabelle
1611134346,27078,22752,4326,4836,2777,https://www.intensivregister.de/api/public/reporting/laendertabelle
1611138060,27075,22754,4321,4832,2773,https://www.intensivregister.de/api/public/reporting/laendertabelle
1611141551,27074,22740,4334,4827,2767,https://www.intensivregister.de/api/public/reporting/laendertabelle
1611145147,27075,22739,4336,4827,2768,https://www.intensivregister.de/api/public/reporting/laendertabelle
1611148750,27075,22745,4330,4825,2770,https://www.intensivregister.de/api/public/reporting/laendertabelle
1611152477,27075,22743,4332,4829,2768,https://www.intensivregister.de/api/public/reporting/laendertabelle
1611155948,27075,22742,4333,4828,2768,https://www.intensivregister.de/api/public/reporting/laendertabelle
1611159551,27075,22742,4333,4827,2768,https://www.intensivregister.de/api/public/reporting/laendertabelle
1611163146,27075,22739,4336,4826,2768,https://www.intensivregister.de/api/public/reporting/laendertabelle
1611166866,27075,22743,4332,4830,2769,https://www.intensivregister.de/api/public/reporting/laendertabelle
1611174463,27075,22742,4333,4831,2769,https://www.intensivregister.de/api/public/reporting/laendertabelle
1611181370,27076,22744,4332,4829,2769,https://www.intensivregister.de/api/public/reporting/laendertabelle
1611184882,27076,22746,4330,4828,2769,https://www.intensivregister.de/api/public/reporting/laendertabelle
1611188513,27078,22739,4339,4825,2767,https://www.intensivregister.de/api/public/reporting/laendertabelle
1611192055,27077,22740,4337,4825,2767,https://www.intensivregister.de/api/public/reporting/laendertabelle
1611195723,27076,22738,4338,4823,2767,https://www.intensivregister.de/api/public/reporting/laendertabelle
1611199263,27074,22735,4339,4822,2763,https://www.intensivregister.de/api/public/reporting/laendertabelle
1611202747,27079,22751,4328,4813,2763,https://www.intensivregister.de/api/public/reporting/laendertabelle
1611206521,27107,22797,4310,4805,2764,https://www.intensivregister.de/api/public/reporting/laendertabelle
1611209945,27096,22833,4263,4807,2761,https://www.intensivregister.de/api/public/reporting/laendertabelle
1611213549,27082,22811,4271,4791,2754,https://www.intensivregister.de/api/public/reporting/laendertabelle
1611217271,27072,22825,4247,4787,2734,https://www.intensivregister.de/api/public/reporting/laendertabelle
1611221274,27069,22838,4231,4787,2725,https://www.intensivregister.de/api/public/reporting/laendertabelle
1611224865,27071,22842,4229,4794,2727,https://www.intensivregister.de/api/public/reporting/laendertabelle
1611228080,27067,22844,4223,4794,2726,https://www.intensivregister.de/api/public/reporting/laendertabelle
1611231670,27064,22826,4238,4790,2725,https://www.intensivregister.de/api/public/reporting/laendertabelle
1611235685,27071,22840,4231,4790,2725,https://www.intensivregister.de/api/public/reporting/laendertabelle
1611238861,27071,22836,4235,4790,2725,https://www.intensivregister.de/api/public/reporting/laendertabelle
1611242520,27072,22838,4234,4792,2724,https://www.intensivregister.de/api/public/reporting/laendertabelle
1611246123,27072,22838,4234,4794,2727,https://www.intensivregister.de/api/public/reporting/laendertabelle
1611249665,27071,22832,4239,4793,2726,https://www.intensivregister.de/api/public/reporting/laendertabelle
1611253325,27073,22834,4239,4793,2726,https://www.intensivregister.de/api/public/reporting/laendertabelle
1611256964,27073,22835,4238,4794,2726,https://www.intensivregister.de/api/public/reporting/laendertabelle
1611260468,27073,22843,4230,4794,2726,https://www.intensivregister.de/api/public/reporting/laendertabelle
1611268083,27073,22844,4229,4796,2726,https://www.intensivregister.de/api/public/reporting/laendertabelle
1611271373,27074,22844,4230,4797,2727,https://www.intensivregister.de/api/public/reporting/laendertabelle
1611274874,27074,22843,4231,4797,2727,https://www.intensivregister.de/api/public/reporting/laendertabelle
1611278563,27075,22848,4227,4797,2727,https://www.intensivregister.de/api/public/reporting/laendertabelle
1611282107,27079,22854,4225,4798,2729,https://www.intensivregister.de/api/public/reporting/laendertabelle
1611286072,27078,22850,4228,4800,2728,https://www.intensivregister.de/api/public/reporting/laendertabelle
1611289366,27074,22880,4194,4785,2720,https://www.intensivregister.de/api/public/reporting/laendertabelle
1611292959,27052,22841,4211,4788,2698,https://www.intensivregister.de/api/public/reporting/laendertabelle
1611296483,27055,22871,4184,4790,2701,https://www.intensivregister.de/api/public/reporting/laendertabelle
1611300438,27027,22884,4143,4785,2697,https://www.intensivregister.de/api/public/reporting/laendertabelle
1611303668,27026,22915,4111,4763,2684,https://www.intensivregister.de/api/public/reporting/laendertabelle
1611307314,27034,22903,4131,4767,2690,https://www.intensivregister.de/api/public/reporting/laendertabelle
1611311279,27042,22912,4130,4774,2691,https://www.intensivregister.de/api/public/reporting/laendertabelle
1611314564,27040,22911,4129,4780,2692,https://www.intensivregister.de/api/public/reporting/laendertabelle
1611318061,27037,22906,4131,4779,2693,https://www.intensivregister.de/api/public/reporting/laendertabelle
1611322078,27037,22902,4135,4785,2695,https://www.intensivregister.de/api/public/reporting/laendertabelle
1611325278,27031,22897,4134,4776,2691,https://www.intensivregister.de/api/public/reporting/laendertabelle
1611328872,27029,22895,4134,4779,2689,https://www.intensivregister.de/api/public/reporting/laendertabelle
1611332351,27027,22900,4127,4777,2689,https://www.intensivregister.de/api/public/reporting/laendertabelle
1611335945,27027,22904,4123,4776,2688,https://www.intensivregister.de/api/public/reporting/laendertabelle
1611347242,27027,22905,4122,4776,2687,https://www.intensivregister.de/api/public/reporting/laendertabelle
1611354121,27026,22888,4138,4775,2686,https://www.intensivregister.de/api/public/reporting/laendertabelle
1611357713,27022,22888,4134,4775,2686,https://www.intensivregister.de/api/public/reporting/laendertabelle
1611361272,27022,22887,4135,4775,2686,https://www.intensivregister.de/api/public/reporting/laendertabelle
1611365044,27022,22887,4135,4777,2688,https://www.intensivregister.de/api/public/reporting/laendertabelle
1611368526,27020,22879,4141,4774,2686,https://www.intensivregister.de/api/public/reporting/laendertabelle
1611372118,27014,22871,4143,4777,2687,https://www.intensivregister.de/api/public/reporting/laendertabelle
1611376808,27013,22868,4145,4780,2684,https://www.intensivregister.de/api/public/reporting/laendertabelle
1611379365,27002,22821,4181,4755,2673,https://www.intensivregister.de/api/public/reporting/laendertabelle
1611382877,26955,22700,4255,4731,2643,https://www.intensivregister.de/api/public/reporting/laendertabelle
1611386563,26922,22629,4293,4685,2621,https://www.intensivregister.de/api/public/reporting/laendertabelle
1611390142,26916,22570,4346,4677,2613,https://www.intensivregister.de/api/public/reporting/laendertabelle
1611394032,26896,22507,4389,4661,2613,https://www.intensivregister.de/api/public/reporting/laendertabelle
1611397708,26894,22496,4398,4658,2614,https://www.intensivregister.de/api/public/reporting/laendertabelle
1611400880,26899,22497,4402,4657,2612,https://www.intensivregister.de/api/public/reporting/laendertabelle
1611404475,26899,22494,4405,4659,2612,https://www.intensivregister.de/api/public/reporting/laendertabelle
1611408088,26899,22492,4407,4657,2609,https://www.intensivregister.de/api/public/reporting/laendertabelle
1611411554,26899,22489,4410,4656,2608,https://www.intensivregister.de/api/public/reporting/laendertabelle
1611415277,26899,22487,4412,4656,2609,https://www.intensivregister.de/api/public/reporting/laendertabelle
1611418873,26899,22486,4413,4656,2609,https://www.intensivregister.de/api/public/reporting/laendertabelle
1611422569,26899,22484,4415,4656,2609,https://www.intensivregister.de/api/public/reporting/laendertabelle
1611426127,26899,22480,4419,4661,2614,https://www.intensivregister.de/api/public/reporting/laendertabelle
1611429670,26899,22479,4420,4661,2615,https://www.intensivregister.de/api/public/reporting/laendertabelle
1611440571,26899,22475,4424,4659,2615,https://www.intensivregister.de/api/public/reporting/laendertabelle
1611444157,26900,22475,4425,4659,2615,https://www.intensivregister.de/api/public/reporting/laendertabelle
1611448074,26898,22473,4425,4659,2615,https://www.intensivregister.de/api/public/reporting/laendertabelle
1611451379,26898,22472,4426,4659,2615,https://www.intensivregister.de/api/public/reporting/laendertabelle
1611454927,26895,22472,4423,4660,2614,https://www.intensivregister.de/api/public/reporting/laendertabelle
1611458488,26896,22463,4433,4660,2620,https://www.intensivregister.de/api/public/reporting/laendertabelle
1611462498,26892,22454,4438,4655,2613,https://www.intensivregister.de/api/public/reporting/laendertabelle
1611466181,26880,22370,4510,4644,2605,https://www.intensivregister.de/api/public/reporting/laendertabelle
1611469276,26871,22288,4583,4641,2623,https://www.intensivregister.de/api/public/reporting/laendertabelle
1611473234,26838,22197,4641,4647,2620,https://www.intensivregister.de/api/public/reporting/laendertabelle
1611476542,26814,22104,4710,4633,2617,https://www.intensivregister.de/api/public/reporting/laendertabelle
1611480127,26819,22071,4748,4630,2623,https://www.intensivregister.de/api/public/reporting/laendertabelle
1611483728,26819,22061,4758,4627,2625,https://www.intensivregister.de/api/public/reporting/laendertabelle
1611487284,26818,22062,4756,4627,2626,https://www.intensivregister.de/api/public/reporting/laendertabelle
1611490882,26818,22059,4759,4625,2626,https://www.intensivregister.de/api/public/reporting/laendertabelle
1611494478,26819,22056,4763,4626,2626,https://www.intensivregister.de/api/public/reporting/laendertabelle
1611498494,26822,22060,4762,4628,2623,https://www.intensivregister.de/api/public/reporting/laendertabelle
1611505283,26822,22054,4768,4628,2623,https://www.intensivregister.de/api/public/reporting/laendertabelle
1611509295,26822,22051,4771,4628,2623,https://www.intensivregister.de/api/public/reporting/laendertabelle
1611516076,26822,22050,4772,4628,2624,https://www.intensivregister.de/api/public/reporting/laendertabelle
1611519738,26822,22054,4768,4631,2624,https://www.intensivregister.de/api/public/reporting/laendertabelle
1611526888,26825,22053,4772,4631,2623,https://www.intensivregister.de/api/public/reporting/laendertabelle
1611530573,26824,22052,4772,4629,2623,https://www.intensivregister.de/api/public/reporting/laendertabelle
1611534449,26824,22049,4775,4629,2624,https://www.intensivregister.de/api/public/reporting/laendertabelle
1611537666,26827,22051,4776,4630,2624,https://www.intensivregister.de/api/public/reporting/laendertabelle
1611541281,26827,22046,4781,4629,2624,https://www.intensivregister.de/api/public/reporting/laendertabelle
1611544928,26833,22057,4776,4626,2624,https://www.intensivregister.de/api/public/reporting/laendertabelle
1611548477,26835,22066,4769,4624,2622,https://www.intensivregister.de/api/public/reporting/laendertabelle
1611552170,26868,22108,4760,4636,2629,https://www.intensivregister.de/api/public/reporting/laendertabelle
1611555782,26914,22161,4753,4627,2599,https://www.intensivregister.de/api/public/reporting/laendertabelle
1611559376,26929,22152,4777,4634,2618,https://www.intensivregister.de/api/public/reporting/laendertabelle
1611562874,26944,22153,4791,4619,2633,https://www.intensivregister.de/api/public/reporting/laendertabelle
1611566852,26930,22129,4801,4620,2631,https://www.intensivregister.de/api/public/reporting/laendertabelle
1611570503,26929,22124,4805,4618,2629,https://www.intensivregister.de/api/public/reporting/laendertabelle
1611573689,26930,22122,4808,4619,2627,https://www.intensivregister.de/api/public/reporting/laendertabelle
1611577647,26930,22116,4814,4616,2625,https://www.intensivregister.de/api/public/reporting/laendertabelle
1611580874,26932,22115,4817,4615,2625,https://www.intensivregister.de/api/public/reporting/laendertabelle
1611584540,26932,22108,4824,4616,2627,https://www.intensivregister.de/api/public/reporting/laendertabelle
1611588176,26932,22109,4823,4616,2627,https://www.intensivregister.de/api/public/reporting/laendertabelle
1611592054,26932,22106,4826,4616,2627,https://www.intensivregister.de/api/public/reporting/laendertabelle
1611595290,26934,22110,4824,4615,2627,https://www.intensivregister.de/api/public/reporting/laendertabelle
1611599287,26934,22107,4827,4616,2628,https://www.intensivregister.de/api/public/reporting/laendertabelle
1611602483,26934,22107,4827,4618,2626,https://www.intensivregister.de/api/public/reporting/laendertabelle
1611606138,26934,22109,4825,4618,2625,https://www.intensivregister.de/api/public/reporting/laendertabelle
1611610099,26934,22108,4826,4618,2625,https://www.intensivregister.de/api/public/reporting/laendertabelle
1611613696,26931,22110,4821,4617,2623,https://www.intensivregister.de/api/public/reporting/laendertabelle
1611616985,26931,22110,4821,4618,2622,https://www.intensivregister.de/api/public/reporting/laendertabelle
1611620474,26929,22111,4818,4619,2622,https://www.intensivregister.de/api/public/reporting/laendertabelle
1611624071,26929,22115,4814,4619,2622,https://www.intensivregister.de/api/public/reporting/laendertabelle
1611628052,26930,22122,4808,4620,2622,https://www.intensivregister.de/api/public/reporting/laendertabelle
1611631337,26933,22123,4810,4625,2625,https://www.intensivregister.de/api/public/reporting/laendertabelle
1611635283,26940,22185,4755,4621,2625,https://www.intensivregister.de/api/public/reporting/laendertabelle
1611638852,26943,22284,4659,4596,2608,https://www.intensivregister.de/api/public/reporting/laendertabelle
1611642123,26947,22383,4564,4590,2581,https://www.intensivregister.de/api/public/reporting/laendertabelle
1611645738,26965,22424,4541,4578,2562,https://www.intensivregister.de/api/public/reporting/laendertabelle
1611649390,26963,22516,4447,4560,2544,https://www.intensivregister.de/api/public/reporting/laendertabelle
1611652980,26992,22570,4422,4573,2547,https://www.intensivregister.de/api/public/reporting/laendertabelle
1611656540,26992,22565,4427,4569,2546,https://www.intensivregister.de/api/public/reporting/laendertabelle
1611660130,26991,22573,4418,4569,2547,https://www.intensivregister.de/api/public/reporting/laendertabelle
1611663762,26991,22572,4419,4568,2547,https://www.intensivregister.de/api/public/reporting/laendertabelle
1611734282,26984,22722,4262,4497,2497,https://www.intensivregister.de/api/public/reporting/laendertabelle
1611735735,26985,22756,4229,4486,2495,https://www.intensivregister.de/api/public/reporting/laendertabelle
1611739751,26974,22760,4214,4494,2503,https://www.intensivregister.de/api/public/reporting/laendertabelle
1611743148,26974,22770,4204,4500,2503,https://www.intensivregister.de/api/public/reporting/laendertabelle
1611746907,26976,22775,4201,4497,2501,https://www.intensivregister.de/api/public/reporting/laendertabelle
1611750555,26984,22778,4206,4498,2499,https://www.intensivregister.de/api/public/reporting/laendertabelle
1611753739,26987,22777,4210,4500,2502,https://www.intensivregister.de/api/public/reporting/laendertabelle
1611757268,26983,22772,4211,4496,2503,https://www.intensivregister.de/api/public/reporting/laendertabelle
1611761303,26985,22772,4213,4497,2502,https://www.intensivregister.de/api/public/reporting/laendertabelle
1611764473,27000,22782,4218,4494,2501,https://www.intensivregister.de/api/public/reporting/laendertabelle
1611768437,26998,22782,4216,4494,2502,https://www.intensivregister.de/api/public/reporting/laendertabelle
1611772051,26998,22786,4212,4496,2502,https://www.intensivregister.de/api/public/reporting/laendertabelle
1611775338,26998,22785,4213,4495,2501,https://www.intensivregister.de/api/public/reporting/laendertabelle
1611786072,26999,22785,4214,4494,2501,https://www.intensivregister.de/api/public/reporting/laendertabelle
1611789791,27001,22793,4208,4491,2502,https://www.intensivregister.de/api/public/reporting/laendertabelle
1611793278,27001,22790,4211,4491,2502,https://www.intensivregister.de/api/public/reporting/laendertabelle
1611796975,27001,22791,4210,4490,2500,https://www.intensivregister.de/api/public/reporting/laendertabelle
1611800348,27003,22795,4208,4488,2500,https://www.intensivregister.de/api/public/reporting/laendertabelle
1611803949,26996,22788,4208,4492,2496,https://www.intensivregister.de/api/public/reporting/laendertabelle
1611807688,26987,22759,4228,4489,2496,https://www.intensivregister.de/api/public/reporting/laendertabelle
1611811418,26981,22684,4297,4468,2479,https://www.intensivregister.de/api/public/reporting/laendertabelle
1611814751,26968,22667,4301,4479,2499,https://www.intensivregister.de/api/public/reporting/laendertabelle
1611818480,26948,22617,4331,4471,2492,https://www.intensivregister.de/api/public/reporting/laendertabelle
1611822149,26950,22621,4329,4461,2486,https://www.intensivregister.de/api/public/reporting/laendertabelle
1611825687,26957,22610,4347,4435,2486,https://www.intensivregister.de/api/public/reporting/laendertabelle
1611829707,26958,22618,4340,4439,2483,https://www.intensivregister.de/api/public/reporting/laendertabelle
1611832872,26959,22611,4348,4435,2483,https://www.intensivregister.de/api/public/reporting/laendertabelle
1611836574,26962,22618,4344,4436,2482,https://www.intensivregister.de/api/public/reporting/laendertabelle
1611840531,26961,22617,4344,4435,2482,https://www.intensivregister.de/api/public/reporting/laendertabelle
1611843667,26958,22616,4342,4434,2480,https://www.intensivregister.de/api/public/reporting/laendertabelle
1611847362,26963,22619,4344,4436,2478,https://www.intensivregister.de/api/public/reporting/laendertabelle
1611851303,26963,22613,4350,4436,2478,https://www.intensivregister.de/api/public/reporting/laendertabelle
1611854639,26965,22612,4353,4434,2479,https://www.intensivregister.de/api/public/reporting/laendertabelle
1611858521,26965,22616,4349,4438,2480,https://www.intensivregister.de/api/public/reporting/laendertabelle
1611872875,26968,22618,4350,4442,2481,https://www.intensivregister.de/api/public/reporting/laendertabelle
1611876469,26968,22612,4356,4441,2480,https://www.intensivregister.de/api/public/reporting/laendertabelle
1611879717,26968,22613,4355,4441,2480,https://www.intensivregister.de/api/public/reporting/laendertabelle
1611883390,26968,22607,4361,4441,2480,https://www.intensivregister.de/api/public/reporting/laendertabelle
1611886943,26970,22607,4363,4441,2479,https://www.intensivregister.de/api/public/reporting/laendertabelle
1611890456,26966,22589,4377,4442,2478,https://www.intensivregister.de/api/public/reporting/laendertabelle
1611894116,26968,22600,4368,4434,2464,https://www.intensivregister.de/api/public/reporting/laendertabelle
1611897790,26953,22596,4357,4407,2447,https://www.intensivregister.de/api/public/reporting/laendertabelle
1611901372,26963,22586,4377,4400,2433,https://www.intensivregister.de/api/public/reporting/laendertabelle
1611904975,26970,22635,4335,4387,2429,https://www.intensivregister.de/api/public/reporting/laendertabelle
1611908523,26962,22643,4319,4378,2413,https://www.intensivregister.de/api/public/reporting/laendertabelle
1611912131,26962,22645,4317,4373,2410,https://www.intensivregister.de/api/public/reporting/laendertabelle
1611915690,26956,22643,4313,4378,2410,https://www.intensivregister.de/api/public/reporting/laendertabelle
1611919337,26959,22641,4318,4381,2411,https://www.intensivregister.de/api/public/reporting/laendertabelle
1611923279,26957,22637,4320,4383,2411,https://www.intensivregister.de/api/public/reporting/laendertabelle
1611926520,26955,22635,4320,4380,2411,https://www.intensivregister.de/api/public/reporting/laendertabelle
1611930152,26955,22633,4322,4377,2410,https://www.intensivregister.de/api/public/reporting/laendertabelle
1611934117,26955,22633,4322,4374,2409,https://www.intensivregister.de/api/public/reporting/laendertabelle
1611937282,26955,22627,4328,4370,2407,https://www.intensivregister.de/api/public/reporting/laendertabelle
1611941284,26956,22626,4330,4368,2406,https://www.intensivregister.de/api/public/reporting/laendertabelle
1611948126,26956,22624,4332,4368,2407,https://www.intensivregister.de/api/public/reporting/laendertabelle
1611959302,26958,22625,4333,4365,2408,https://www.intensivregister.de/api/public/reporting/laendertabelle
1611962475,26956,22623,4333,4365,2408,https://www.intensivregister.de/api/public/reporting/laendertabelle
1611966173,26956,22624,4332,4365,2408,https://www.intensivregister.de/api/public/reporting/laendertabelle
1611970096,26954,22619,4335,4360,2408,https://www.intensivregister.de/api/public/reporting/laendertabelle
1611973651,26954,22615,4339,4359,2407,https://www.intensivregister.de/api/public/reporting/laendertabelle
1611977270,26956,22621,4335,4359,2407,https://www.intensivregister.de/api/public/reporting/laendertabelle
1611980469,26954,22632,4322,4353,2402,https://www.intensivregister.de/api/public/reporting/laendertabelle
1611984455,26941,22604,4337,4351,2408,https://www.intensivregister.de/api/public/reporting/laendertabelle
1611987680,26912,22571,4341,4341,2407,https://www.intensivregister.de/api/public/reporting/laendertabelle
1611991284,26900,22556,4344,4345,2401,https://www.intensivregister.de/api/public/reporting/laendertabelle
1611994987,26850,22395,4455,4350,2401,https://www.intensivregister.de/api/public/reporting/laendertabelle
1611998614,26850,22381,4469,4361,2406,https://www.intensivregister.de/api/public/reporting/laendertabelle
1612002524,26844,22347,4497,4352,2391,https://www.intensivregister.de/api/public/reporting/laendertabelle
1612006078,26841,22352,4489,4351,2391,https://www.intensivregister.de/api/public/reporting/laendertabelle
1612009381,26840,22354,4486,4353,2393,https://www.intensivregister.de/api/public/reporting/laendertabelle
1612012894,26840,22356,4484,4353,2393,https://www.intensivregister.de/api/public/reporting/laendertabelle
1612016566,26836,22354,4482,4354,2393,https://www.intensivregister.de/api/public/reporting/laendertabelle
1612023776,26836,22353,4483,4354,2394,https://www.intensivregister.de/api/public/reporting/laendertabelle
1612027435,26836,22356,4480,4354,2393,https://www.intensivregister.de/api/public/reporting/laendertabelle
1612031364,26836,22348,4488,4354,2393,https://www.intensivregister.de/api/public/reporting/laendertabelle
1612034577,26836,22348,4488,4353,2392,https://www.intensivregister.de/api/public/reporting/laendertabelle
1612042099,26833,22345,4488,4356,2392,https://www.intensivregister.de/api/public/reporting/laendertabelle
1612045644,26828,22338,4490,4355,2391,https://www.intensivregister.de/api/public/reporting/laendertabelle
1612048876,26828,22332,4496,4357,2394,https://www.intensivregister.de/api/public/reporting/laendertabelle
1612056076,26828,22329,4499,4357,2394,https://www.intensivregister.de/api/public/reporting/laendertabelle
1612059699,26828,22325,4503,4357,2395,https://www.intensivregister.de/api/public/reporting/laendertabelle
1612063264,26827,22320,4507,4360,2389,https://www.intensivregister.de/api/public/reporting/laendertabelle
1612066929,26824,22295,4529,4357,2380,https://www.intensivregister.de/api/public/reporting/laendertabelle
1612070464,26823,22218,4605,4344,2369,https://www.intensivregister.de/api/public/reporting/laendertabelle
1612074189,26822,22139,4683,4335,2356,https://www.intensivregister.de/api/public/reporting/laendertabelle
1612078088,26800,22004,4796,4332,2346,https://www.intensivregister.de/api/public/reporting/laendertabelle
1612081680,26804,21982,4822,4346,2341,https://www.intensivregister.de/api/public/reporting/laendertabelle
1612084976,26796,21979,4817,4349,2337,https://www.intensivregister.de/api/public/reporting/laendertabelle
1612088491,26795,21963,4832,4350,2336,https://www.intensivregister.de/api/public/reporting/laendertabelle
1612092190,26795,21955,4840,4353,2337,https://www.intensivregister.de/api/public/reporting/laendertabelle
1612095794,26799,21958,4841,4355,2338,https://www.intensivregister.de/api/public/reporting/laendertabelle
1612099285,26799,21956,4843,4354,2338,https://www.intensivregister.de/api/public/reporting/laendertabelle
1612103254,26793,21949,4844,4355,2338,https://www.intensivregister.de/api/public/reporting/laendertabelle
1612106489,26793,21953,4840,4354,2338,https://www.intensivregister.de/api/public/reporting/laendertabelle
1612110455,26793,21951,4842,4352,2338,https://www.intensivregister.de/api/public/reporting/laendertabelle
1612113766,26793,21953,4840,4351,2338,https://www.intensivregister.de/api/public/reporting/laendertabelle
1612117294,26793,21952,4841,4351,2338,https://www.intensivregister.de/api/public/reporting/laendertabelle
1612120976,26793,21953,4840,4353,2339,https://www.intensivregister.de/api/public/reporting/laendertabelle
1612124904,26793,21954,4839,4353,2339,https://www.intensivregister.de/api/public/reporting/laendertabelle
1612132098,26795,21954,4841,4353,2339,https://www.intensivregister.de/api/public/reporting/laendertabelle
1612135707,26793,21954,4839,4352,2340,https://www.intensivregister.de/api/public/reporting/laendertabelle
1612138877,26793,21949,4844,4352,2340,https://www.intensivregister.de/api/public/reporting/laendertabelle
1612146091,26792,21950,4842,4351,2341,https://www.intensivregister.de/api/public/reporting/laendertabelle
1612150109,26794,21952,4842,4360,2342,https://www.intensivregister.de/api/public/reporting/laendertabelle
1612153372,26799,21990,4809,4357,2346,https://www.intensivregister.de/api/public/reporting/laendertabelle
1612156888,26804,21992,4812,4354,2348,https://www.intensivregister.de/api/public/reporting/laendertabelle
1612160478,26849,22086,4763,4341,2352,https://www.intensivregister.de/api/public/reporting/laendertabelle
1612164573,26870,22166,4704,4326,2361,https://www.intensivregister.de/api/public/reporting/laendertabelle
1612167743,26895,22225,4670,4333,2359,https://www.intensivregister.de/api/public/reporting/laendertabelle
1612171351,26902,22194,4708,4321,2349,https://www.intensivregister.de/api/public/reporting/laendertabelle
1612174957,26909,22185,4724,4320,2348,https://www.intensivregister.de/api/public/reporting/laendertabelle
1612178346,26907,22190,4717,4321,2349,https://www.intensivregister.de/api/public/reporting/laendertabelle
1612181945,26906,22199,4707,4321,2350,https://www.intensivregister.de/api/public/reporting/laendertabelle
1612185545,26905,22197,4708,4322,2352,https://www.intensivregister.de/api/public/reporting/laendertabelle
1612189156,26904,22198,4706,4329,2352,https://www.intensivregister.de/api/public/reporting/laendertabelle
1612192753,26904,22201,4703,4328,2352,https://www.intensivregister.de/api/public/reporting/laendertabelle
1612199953,26904,22198,4706,4327,2351,https://www.intensivregister.de/api/public/reporting/laendertabelle
1612203552,26904,22195,4709,4331,2356,https://www.intensivregister.de/api/public/reporting/laendertabelle
1612217951,26905,22192,4713,4331,2356,https://www.intensivregister.de/api/public/reporting/laendertabelle
1612221551,26905,22205,4700,4332,2357,https://www.intensivregister.de/api/public/reporting/laendertabelle
1612225151,26905,22205,4700,4331,2356,https://www.intensivregister.de/api/public/reporting/laendertabelle
1612228752,26905,22203,4702,4332,2356,https://www.intensivregister.de/api/public/reporting/laendertabelle
1612232353,26906,22203,4703,4331,2357,https://www.intensivregister.de/api/public/reporting/laendertabelle
1612235953,26909,22217,4692,4333,2355,https://www.intensivregister.de/api/public/reporting/laendertabelle
1612239553,26937,22230,4707,4322,2361,https://www.intensivregister.de/api/public/reporting/laendertabelle
1612243154,26963,22332,4631,4307,2352,https://www.intensivregister.de/api/public/reporting/laendertabelle
1612246755,27002,22472,4530,4303,2371,https://www.intensivregister.de/api/public/reporting/laendertabelle
1612250357,26995,22467,4528,4290,2372,https://www.intensivregister.de/api/public/reporting/laendertabelle
1612253945,27000,22490,4510,4265,2358,https://www.intensivregister.de/api/public/reporting/laendertabelle
1612257545,27007,22540,4467,4263,2357,https://www.intensivregister.de/api/public/reporting/laendertabelle
1612261145,27002,22552,4450,4258,2356,https://www.intensivregister.de/api/public/reporting/laendertabelle
1612264746,26996,22555,4441,4256,2355,https://www.intensivregister.de/api/public/reporting/laendertabelle
1612268346,26996,22555,4441,4259,2356,https://www.intensivregister.de/api/public/reporting/laendertabelle
1612271947,27010,22577,4433,4258,2357,https://www.intensivregister.de/api/public/reporting/laendertabelle
1612275548,27008,22579,4429,4254,2357,https://www.intensivregister.de/api/public/reporting/laendertabelle
1612282749,27008,22576,4432,4254,2356,https://www.intensivregister.de/api/public/reporting/laendertabelle
1612286350,27008,22577,4431,4255,2357,https://www.intensivregister.de/api/public/reporting/laendertabelle
1612289950,27008,22577,4431,4253,2356,https://www.intensivregister.de/api/public/reporting/laendertabelle
1612297152,27008,22575,4433,4251,2356,https://www.intensivregister.de/api/public/reporting/laendertabelle
1612300753,27008,22573,4435,4250,2355,https://www.intensivregister.de/api/public/reporting/laendertabelle
1612304353,27008,22570,4438,4250,2355,https://www.intensivregister.de/api/public/reporting/laendertabelle
1612307954,27008,22574,4434,4251,2355,https://www.intensivregister.de/api/public/reporting/laendertabelle
1612311556,27008,22570,4438,4250,2355,https://www.intensivregister.de/api/public/reporting/laendertabelle
1612315145,27008,22576,4432,4252,2356,https://www.intensivregister.de/api/public/reporting/laendertabelle
1612318747,27008,22582,4426,4252,2356,https://www.intensivregister.de/api/public/reporting/laendertabelle
1612322348,27011,22584,4427,4252,2353,https://www.intensivregister.de/api/public/reporting/laendertabelle
1612325949,27026,22624,4402,4246,2355,https://www.intensivregister.de/api/public/reporting/laendertabelle
1612329550,27030,22688,4342,4243,2353,https://www.intensivregister.de/api/public/reporting/laendertabelle
1612333150,27062,22704,4358,4246,2326,https://www.intensivregister.de/api/public/reporting/laendertabelle
1612336751,27074,22760,4314,4225,2312,https://www.intensivregister.de/api/public/reporting/laendertabelle
1612340353,27081,22819,4262,4237,2318,https://www.intensivregister.de/api/public/reporting/laendertabelle
1612343954,27081,22829,4252,4219,2317,https://www.intensivregister.de/api/public/reporting/laendertabelle
1612347544,27083,22837,4246,4222,2318,https://www.intensivregister.de/api/public/reporting/laendertabelle
1612351145,27086,22834,4252,4218,2317,https://www.intensivregister.de/api/public/reporting/laendertabelle
1612354747,27086,22841,4245,4217,2318,https://www.intensivregister.de/api/public/reporting/laendertabelle
1612358348,27084,22842,4242,4218,2319,https://www.intensivregister.de/api/public/reporting/laendertabelle
1612361949,27084,22838,4246,4217,2320,https://www.intensivregister.de/api/public/reporting/laendertabelle
1613402350,26786,21802,4984,3440,1933,https://www.intensivregister.de/api/public/reporting/laendertabelle
1613405950,26786,21805,4981,3441,1931,https://www.intensivregister.de/api/public/reporting/laendertabelle
1613409550,26786,21805,4981,3442,1931,https://www.intensivregister.de/api/public/reporting/laendertabelle
1613416755,26786,21806,4980,3442,1931,https://www.intensivregister.de/api/public/reporting/laendertabelle
1613427553,26786,21807,4979,3442,1931,https://www.intensivregister.de/api/public/reporting/laendertabelle
1613431153,26788,21814,4974,3440,1930,https://www.intensivregister.de/api/public/reporting/laendertabelle
1613434752,26788,21817,4971,3440,1930,https://www.intensivregister.de/api/public/reporting/laendertabelle
1613438351,26788,21818,4970,3440,1929,https://www.intensivregister.de/api/public/reporting/laendertabelle
1613441951,26787,21814,4973,3441,1930,https://www.intensivregister.de/api/public/reporting/laendertabelle
1613445551,26792,21808,4984,3438,1927,https://www.intensivregister.de/api/public/reporting/laendertabelle
1613449151,26809,21890,4919,3433,1923,https://www.intensivregister.de/api/public/reporting/laendertabelle
1613452752,26826,21994,4832,3405,1920,https://www.intensivregister.de/api/public/reporting/laendertabelle
1613456350,26863,22105,4758,3390,1911,https://www.intensivregister.de/api/public/reporting/laendertabelle
1613459949,26883,22201,4682,3370,1905,https://www.intensivregister.de/api/public/reporting/laendertabelle
1613463762,26905,22269,4636,3363,1918,https://www.intensivregister.de/api/public/reporting/laendertabelle
1613467146,26898,22280,4618,3356,1911,https://www.intensivregister.de/api/public/reporting/laendertabelle
1613470746,26902,22281,4621,3352,1909,https://www.intensivregister.de/api/public/reporting/laendertabelle
1613474345,26902,22283,4619,3352,1909,https://www.intensivregister.de/api/public/reporting/laendertabelle
1613477945,26901,22276,4625,3350,1907,https://www.intensivregister.de/api/public/reporting/laendertabelle
1613481545,26901,22277,4624,3351,1908,https://www.intensivregister.de/api/public/reporting/laendertabelle
1613485145,26904,22280,4624,3351,1908,https://www.intensivregister.de/api/public/reporting/laendertabelle
1613488744,26902,22281,4621,3350,1908,https://www.intensivregister.de/api/public/reporting/laendertabelle
1613492344,26902,22281,4621,3347,1908,https://www.intensivregister.de/api/public/reporting/laendertabelle
1613495944,26902,22278,4624,3348,1909,https://www.intensivregister.de/api/public/reporting/laendertabelle
1613499543,26903,22276,4627,3348,1909,https://www.intensivregister.de/api/public/reporting/laendertabelle
1613503153,26903,22277,4626,3349,1909,https://www.intensivregister.de/api/public/reporting/laendertabelle
1613513952,26905,22277,4628,3350,1908,https://www.intensivregister.de/api/public/reporting/laendertabelle
1613517552,26900,22273,4627,3348,1907,https://www.intensivregister.de/api/public/reporting/laendertabelle
1613521151,26898,22284,4614,3349,1907,https://www.intensivregister.de/api/public/reporting/laendertabelle
1613524750,26896,22281,4615,3349,1907,https://www.intensivregister.de/api/public/reporting/laendertabelle
1613528349,26896,22280,4616,3349,1907,https://www.intensivregister.de/api/public/reporting/laendertabelle
1613535549,26903,22293,4610,3345,1904,https://www.intensivregister.de/api/public/reporting/laendertabelle
1613539148,26903,22260,4643,3309,1886,https://www.intensivregister.de/api/public/reporting/laendertabelle
1613542748,26885,22297,4588,3288,1860,https://www.intensivregister.de/api/public/reporting/laendertabelle
1613546348,26898,22306,4592,3266,1842,https://www.intensivregister.de/api/public/reporting/laendertabelle
1613549948,26922,22345,4577,3271,1848,https://www.intensivregister.de/api/public/reporting/laendertabelle
1613553547,26892,22348,4544,3252,1841,https://www.intensivregister.de/api/public/reporting/laendertabelle
1613557147,26896,22337,4559,3253,1845,https://www.intensivregister.de/api/public/reporting/laendertabelle
1613560747,26896,22338,4558,3253,1845,https://www.intensivregister.de/api/public/reporting/laendertabelle
1613564346,26897,22334,4563,3254,1846,https://www.intensivregister.de/api/public/reporting/laendertabelle
1613567946,26899,22342,4557,3255,1846,https://www.intensivregister.de/api/public/reporting/laendertabelle
1613571546,26897,22335,4562,3256,1848,https://www.intensivregister.de/api/public/reporting/laendertabelle
1613582346,26897,22335,4562,3254,1847,https://www.intensivregister.de/api/public/reporting/laendertabelle
1613585945,26897,22337,4560,3252,1847,https://www.intensivregister.de/api/public/reporting/laendertabelle
1613589545,26897,22337,4560,3251,1847,https://www.intensivregister.de/api/public/reporting/laendertabelle
1613593145,26897,22340,4557,3252,1847,https://www.intensivregister.de/api/public/reporting/laendertabelle
1613600344,26897,22332,4565,3252,1847,https://www.intensivregister.de/api/public/reporting/laendertabelle
1613603945,26897,22330,4567,3253,1848,https://www.intensivregister.de/api/public/reporting/laendertabelle
1613607544,26896,22329,4567,3253,1848,https://www.intensivregister.de/api/public/reporting/laendertabelle
1613611145,26896,22328,4568,3253,1848,https://www.intensivregister.de/api/public/reporting/laendertabelle
1613614747,26893,22322,4571,3251,1847,https://www.intensivregister.de/api/public/reporting/laendertabelle
1613618345,26892,22331,4561,3257,1848,https://www.intensivregister.de/api/public/reporting/laendertabelle
1613621946,26887,22321,4566,3254,1845,https://www.intensivregister.de/api/public/reporting/laendertabelle
1613625545,26911,22315,4596,3231,1812,https://www.intensivregister.de/api/public/reporting/laendertabelle
1613629145,26909,22314,4595,3227,1812,https://www.intensivregister.de/api/public/reporting/laendertabelle
1613632745,26899,22299,4600,3185,1814,https://www.intensivregister.de/api/public/reporting/laendertabelle
1613636345,26906,22319,4587,3184,1811,https://www.intensivregister.de/api/public/reporting/laendertabelle
1613639945,26905,22326,4579,3177,1806,https://www.intensivregister.de/api/public/reporting/laendertabelle
1613643545,26904,22322,4582,3174,1805,https://www.intensivregister.de/api/public/reporting/laendertabelle
1613647145,26895,22318,4577,3171,1805,https://www.intensivregister.de/api/public/reporting/laendertabelle
1613650744,26890,22316,4574,3175,1810,https://www.intensivregister.de/api/public/reporting/laendertabelle
1613654344,26890,22310,4580,3175,1811,https://www.intensivregister.de/api/public/reporting/laendertabelle
1613657944,26889,22308,4581,3176,1813,https://www.intensivregister.de/api/public/reporting/laendertabelle
1613661544,26889,22307,4582,3176,1813,https://www.intensivregister.de/api/public/reporting/laendertabelle
1613665143,26889,22307,4582,3175,1812,https://www.intensivregister.de/api/public/reporting/laendertabelle
1613672353,26889,22308,4581,3176,1812,https://www.intensivregister.de/api/public/reporting/laendertabelle
1613675952,26892,22314,4578,3176,1810,https://www.intensivregister.de/api/public/reporting/laendertabelle
1613686751,26892,22309,4583,3178,1810,https://www.intensivregister.de/api/public/reporting/laendertabelle
1613690351,26894,22312,4582,3177,1810,https://www.intensivregister.de/api/public/reporting/laendertabelle
1613693951,26894,22315,4579,3177,1810,https://www.intensivregister.de/api/public/reporting/laendertabelle
1613697551,26896,22316,4580,3178,1810,https://www.intensivregister.de/api/public/reporting/laendertabelle
1613701150,26896,22319,4577,3178,1809,https://www.intensivregister.de/api/public/reporting/laendertabelle
1613704750,26901,22318,4583,3183,1810,https://www.intensivregister.de/api/public/reporting/laendertabelle
1613708349,26884,22263,4621,3182,1807,https://www.intensivregister.de/api/public/reporting/laendertabelle
1613711949,26875,22305,4570,3151,1800,https://www.intensivregister.de/api/public/reporting/laendertabelle
1613715549,26869,22355,4514,3155,1788,https://www.intensivregister.de/api/public/reporting/laendertabelle
1613719149,26872,22372,4500,3146,1778,https://www.intensivregister.de/api/public/reporting/laendertabelle
1613722748,26849,22349,4500,3132,1769,https://www.intensivregister.de/api/public/reporting/laendertabelle
1613726349,26814,22327,4487,3127,1766,https://www.intensivregister.de/api/public/reporting/laendertabelle
1613729948,26814,22324,4490,3122,1762,https://www.intensivregister.de/api/public/reporting/laendertabelle
1613733548,26813,22318,4495,3123,1762,https://www.intensivregister.de/api/public/reporting/laendertabelle
1613737148,26814,22309,4505,3126,1762,https://www.intensivregister.de/api/public/reporting/laendertabelle
1613740748,26814,22311,4503,3129,1762,https://www.intensivregister.de/api/public/reporting/laendertabelle
1613744348,26814,22313,4501,3127,1762,https://www.intensivregister.de/api/public/reporting/laendertabelle
1613747946,26816,22319,4497,3129,1763,https://www.intensivregister.de/api/public/reporting/laendertabelle
1613751545,26816,22320,4496,3126,1761,https://www.intensivregister.de/api/public/reporting/laendertabelle
1613758753,26816,22320,4496,3127,1761,https://www.intensivregister.de/api/public/reporting/laendertabelle
1613773149,26813,22307,4506,3127,1761,https://www.intensivregister.de/api/public/reporting/laendertabelle
1613776748,26812,22309,4503,3128,1761,https://www.intensivregister.de/api/public/reporting/laendertabelle
1613780347,26810,22305,4505,3129,1761,https://www.intensivregister.de/api/public/reporting/laendertabelle
1613783946,26810,22301,4509,3128,1761,https://www.intensivregister.de/api/public/reporting/laendertabelle
1613787549,26809,22299,4510,3128,1761,https://www.intensivregister.de/api/public/reporting/laendertabelle
1613791153,26811,22291,4520,3132,1761,https://www.intensivregister.de/api/public/reporting/laendertabelle
1613794746,26802,22278,4524,3131,1763,https://www.intensivregister.de/api/public/reporting/laendertabelle
1613798350,26783,22218,4565,3116,1757,https://www.intensivregister.de/api/public/reporting/laendertabelle
1613801943,26781,22218,4563,3110,1762,https://www.intensivregister.de/api/public/reporting/laendertabelle
1613805547,26740,22102,4638,3091,1748,https://www.intensivregister.de/api/public/reporting/laendertabelle
1613809150,26715,22063,4652,3090,1750,https://www.intensivregister.de/api/public/reporting/laendertabelle
1613812744,26691,22037,4654,3079,1752,https://www.intensivregister.de/api/public/reporting/laendertabelle
1613816347,26685,22033,4652,3078,1752,https://www.intensivregister.de/api/public/reporting/laendertabelle
1613819951,26683,22025,4658,3081,1752,https://www.intensivregister.de/api/public/reporting/laendertabelle
1613823545,26680,22017,4663,3080,1750,https://www.intensivregister.de/api/public/reporting/laendertabelle
1613827148,26681,22015,4666,3081,1751,https://www.intensivregister.de/api/public/reporting/laendertabelle
1613834345,26681,22013,4668,3082,1751,https://www.intensivregister.de/api/public/reporting/laendertabelle
1613837949,26681,22011,4670,3081,1751,https://www.intensivregister.de/api/public/reporting/laendertabelle
1613841552,26681,22014,4667,3082,1751,https://www.intensivregister.de/api/public/reporting/laendertabelle
1613845146,26681,22013,4668,3081,1751,https://www.intensivregister.de/api/public/reporting/laendertabelle
1613859550,26681,22004,4677,3080,1750,https://www.intensivregister.de/api/public/reporting/laendertabelle
1613863143,26681,22010,4671,3080,1750,https://www.intensivregister.de/api/public/reporting/laendertabelle
1613866747,26681,22009,4672,3080,1750,https://www.intensivregister.de/api/public/reporting/laendertabelle
1613870350,26681,22012,4669,3080,1750,https://www.intensivregister.de/api/public/reporting/laendertabelle
1613873943,26682,22009,4673,3080,1750,https://www.intensivregister.de/api/public/reporting/laendertabelle
1613877543,26682,22005,4677,3084,1752,https://www.intensivregister.de/api/public/reporting/laendertabelle
1613881143,26682,21996,4686,3089,1754,https://www.intensivregister.de/api/public/reporting/laendertabelle
1613884743,26686,21978,4708,3087,1755,https://www.intensivregister.de/api/public/reporting/laendertabelle
1613888344,26649,21826,4823,3088,1776,https://www.intensivregister.de/api/public/reporting/laendertabelle
1613891944,26626,21721,4905,3085,1753,https://www.intensivregister.de/api/public/reporting/laendertabelle
1613895544,26613,21674,4939,3072,1731,https://www.intensivregister.de/api/public/reporting/laendertabelle
1613899145,26604,21630,4974,3056,1734,https://www.intensivregister.de/api/public/reporting/laendertabelle
1613902746,26603,21625,4978,3058,1736,https://www.intensivregister.de/api/public/reporting/laendertabelle
1613906346,26601,21629,4972,3057,1735,https://www.intensivregister.de/api/public/reporting/laendertabelle
1613909946,26600,21621,4979,3059,1735,https://www.intensivregister.de/api/public/reporting/laendertabelle
1613913547,26600,21622,4978,3061,1735,https://www.intensivregister.de/api/public/reporting/laendertabelle
1613917148,26600,21624,4976,3063,1735,https://www.intensivregister.de/api/public/reporting/laendertabelle
1613920747,26597,21622,4975,3064,1735,https://www.intensivregister.de/api/public/reporting/laendertabelle
1613924348,26598,21625,4973,3064,1735,https://www.intensivregister.de/api/public/reporting/laendertabelle
1613927948,26598,21619,4979,3062,1733,https://www.intensivregister.de/api/public/reporting/laendertabelle
1613931549,26598,21619,4979,3063,1733,https://www.intensivregister.de/api/public/reporting/laendertabelle
1613935149,26598,21623,4975,3063,1733,https://www.intensivregister.de/api/public/reporting/laendertabelle
1613945950,26598,21619,4979,3064,1733,https://www.intensivregister.de/api/public/reporting/laendertabelle
1613949550,26598,21614,4984,3064,1734,https://www.intensivregister.de/api/public/reporting/laendertabelle
1613953151,26597,21622,4975,3064,1734,https://www.intensivregister.de/api/public/reporting/laendertabelle
1613956751,26597,21623,4974,3063,1734,https://www.intensivregister.de/api/public/reporting/laendertabelle
1613960351,26599,21627,4972,3062,1734,https://www.intensivregister.de/api/public/reporting/laendertabelle
1613963952,26599,21632,4967,3069,1733,https://www.intensivregister.de/api/public/reporting/laendertabelle
1613967552,26611,21673,4938,3063,1734,https://www.intensivregister.de/api/public/reporting/laendertabelle
1613971153,26675,21668,5007,3063,1731,https://www.intensivregister.de/api/public/reporting/laendertabelle
1613974753,26691,21671,5020,3055,1744,https://www.intensivregister.de/api/public/reporting/laendertabelle
1613978343,26736,21730,5006,3049,1760,https://www.intensivregister.de/api/public/reporting/laendertabelle
1613981944,26770,21819,4951,3060,1775,https://www.intensivregister.de/api/public/reporting/laendertabelle
1613985545,26778,21822,4956,3058,1778,https://www.intensivregister.de/api/public/reporting/laendertabelle
1613989145,26776,21834,4942,3061,1780,https://www.intensivregister.de/api/public/reporting/laendertabelle
1613992746,26776,21832,4944,3060,1780,https://www.intensivregister.de/api/public/reporting/laendertabelle
1613996347,26782,21828,4954,3059,1779,https://www.intensivregister.de/api/public/reporting/laendertabelle
1613999947,26782,21832,4950,3060,1779,https://www.intensivregister.de/api/public/reporting/laendertabelle
1614003547,26781,21827,4954,3060,1779,https://www.intensivregister.de/api/public/reporting/laendertabelle
1614007148,26781,21831,4950,3060,1779,https://www.intensivregister.de/api/public/reporting/laendertabelle
1614010749,26780,21830,4950,3059,1778,https://www.intensivregister.de/api/public/reporting/laendertabelle
1614014349,26780,21831,4949,3061,1778,https://www.intensivregister.de/api/public/reporting/laendertabelle
1614017949,26780,21832,4948,3063,1779,https://www.intensivregister.de/api/public/reporting/laendertabelle
1614025150,26780,21832,4948,3062,1779,https://www.intensivregister.de/api/public/reporting/laendertabelle
1614032350,26782,21840,4942,3061,1778,https://www.intensivregister.de/api/public/reporting/laendertabelle
1614035953,26778,21842,4936,3062,1778,https://www.intensivregister.de/api/public/reporting/laendertabelle
1614039551,26778,21841,4937,3063,1778,https://www.intensivregister.de/api/public/reporting/laendertabelle
1614043152,26778,21842,4936,3063,1778,https://www.intensivregister.de/api/public/reporting/laendertabelle
1614046752,26778,21850,4928,3062,1778,https://www.intensivregister.de/api/public/reporting/laendertabelle
1614050353,26775,21843,4932,3060,1776,https://www.intensivregister.de/api/public/reporting/laendertabelle
1614053943,26795,21886,4909,3052,1772,https://www.intensivregister.de/api/public/reporting/laendertabelle
1614057544,26801,21929,4872,3048,1776,https://www.intensivregister.de/api/public/reporting/laendertabelle
1614061145,26833,22075,4758,3044,1778,https://www.intensivregister.de/api/public/reporting/laendertabelle
1614064745,26862,22234,4628,3041,1767,https://www.intensivregister.de/api/public/reporting/laendertabelle
1614068346,26869,22272,4597,3044,1773,https://www.intensivregister.de/api/public/reporting/laendertabelle
1614071946,26881,22300,4581,3038,1767,https://www.intensivregister.de/api/public/reporting/laendertabelle
1614075547,26906,22319,4587,3040,1766,https://www.intensivregister.de/api/public/reporting/laendertabelle
1614079147,26906,22325,4581,3041,1767,https://www.intensivregister.de/api/public/reporting/laendertabelle
1614082748,26905,22321,4584,3041,1768,https://www.intensivregister.de/api/public/reporting/laendertabelle
1614086349,26907,22324,4583,3039,1768,https://www.intensivregister.de/api/public/reporting/laendertabelle
1614089949,26906,22326,4580,3040,1769,https://www.intensivregister.de/api/public/reporting/laendertabelle
1614093550,26906,22328,4578,3042,1770,https://www.intensivregister.de/api/public/reporting/laendertabelle
1614097150,26898,22323,4575,3041,1770,https://www.intensivregister.de/api/public/reporting/laendertabelle
1614100750,26898,22322,4576,3041,1770,https://www.intensivregister.de/api/public/reporting/laendertabelle
1614104351,26898,22321,4577,3040,1769,https://www.intensivregister.de/api/public/reporting/laendertabelle
1614107951,26898,22322,4576,3039,1768,https://www.intensivregister.de/api/public/reporting/laendertabelle
1614111551,26898,22325,4573,3039,1768,https://www.intensivregister.de/api/public/reporting/laendertabelle
1614118752,26898,22324,4574,3039,1769,https://www.intensivregister.de/api/public/reporting/laendertabelle
1614122353,26898,22327,4571,3039,1767,https://www.intensivregister.de/api/public/reporting/laendertabelle
1614125943,26898,22328,4570,3038,1766,https://www.intensivregister.de/api/public/reporting/laendertabelle
1614129547,26898,22330,4568,3038,1766,https://www.intensivregister.de/api/public/reporting/laendertabelle
1614133147,26899,22330,4569,3038,1767,https://www.intensivregister.de/api/public/reporting/laendertabelle
1614136748,26905,22356,4549,3034,1767,https://www.intensivregister.de/api/public/reporting/laendertabelle
1614140349,26889,22378,4511,3028,1762,https://www.intensivregister.de/api/public/reporting/laendertabelle
1614143949,26885,22405,4480,3001,1758,https://www.intensivregister.de/api/public/reporting/laendertabelle
1614147550,26900,22427,4473,2998,1751,https://www.intensivregister.de/api/public/reporting/laendertabelle
1614151150,26898,22488,4410,2983,1760,https://www.intensivregister.de/api/public/reporting/laendertabelle
1614154752,26912,22505,4407,2956,1743,https://www.intensivregister.de/api/public/reporting/laendertabelle
1614158344,26910,22486,4424,2953,1743,https://www.intensivregister.de/api/public/reporting/laendertabelle
1614161951,26911,22485,4426,2958,1747,https://www.intensivregister.de/api/public/reporting/laendertabelle
1614165548,26913,22489,4424,2958,1744,https://www.intensivregister.de/api/public/reporting/laendertabelle
1614169146,26915,22482,4433,2960,1745,https://www.intensivregister.de/api/public/reporting/laendertabelle
1614172744,26915,22482,4433,2959,1745,https://www.intensivregister.de/api/public/reporting/laendertabelle
1614176351,26915,22481,4434,2959,1745,https://www.intensivregister.de/api/public/reporting/laendertabelle
1614179957,26915,22479,4436,2962,1746,https://www.intensivregister.de/api/public/reporting/laendertabelle
1614183551,26915,22480,4435,2963,1746,https://www.intensivregister.de/api/public/reporting/laendertabelle
1614187149,26915,22476,4439,2962,1745,https://www.intensivregister.de/api/public/reporting/laendertabelle
1614205153,26915,22470,4445,2962,1745,https://www.intensivregister.de/api/public/reporting/laendertabelle
1614208750,26915,22468,4447,2962,1745,https://www.intensivregister.de/api/public/reporting/laendertabelle
1614212348,26915,22462,4453,2962,1745,https://www.intensivregister.de/api/public/reporting/laendertabelle
1614215946,26916,22454,4462,2962,1745,https://www.intensivregister.de/api/public/reporting/laendertabelle
1614219544,26917,22460,4457,2960,1744,https://www.intensivregister.de/api/public/reporting/laendertabelle
1614223152,26920,22458,4462,2958,1744,https://www.intensivregister.de/api/public/reporting/laendertabelle
1614226749,26929,22469,4460,2948,1736,https://www.intensivregister.de/api/public/reporting/laendertabelle
1614230347,26931,22464,4467,2947,1728,https://www.intensivregister.de/api/public/reporting/laendertabelle
1614233945,26937,22418,4519,2918,1713,https://www.intensivregister.de/api/public/reporting/laendertabelle
1614237543,26933,22443,4490,2905,1710,https://www.intensivregister.de/api/public/reporting/laendertabelle
1614241151,26928,22434,4494,2901,1707,https://www.intensivregister.de/api/public/reporting/laendertabelle
1614244749,26932,22438,4494,2898,1706,https://www.intensivregister.de/api/public/reporting/laendertabelle
1614248347,26932,22433,4499,2897,1707,https://www.intensivregister.de/api/public/reporting/laendertabelle
1614251945,26932,22432,4500,2895,1707,https://www.intensivregister.de/api/public/reporting/laendertabelle
1614255543,26932,22424,4508,2895,1707,https://www.intensivregister.de/api/public/reporting/laendertabelle
1614259151,26932,22420,4512,2895,1707,https://www.intensivregister.de/api/public/reporting/laendertabelle
1614262748,26935,22419,4516,2896,1707,https://www.intensivregister.de/api/public/reporting/laendertabelle
1614266347,26935,22418,4517,2897,1707,https://www.intensivregister.de/api/public/reporting/laendertabelle
1614269945,26935,22410,4525,2894,1704,https://www.intensivregister.de/api/public/reporting/laendertabelle
1614277151,26935,22413,4522,2894,1704,https://www.intensivregister.de/api/public/reporting/laendertabelle
1614280749,26935,22417,4518,2894,1705,https://www.intensivregister.de/api/public/reporting/laendertabelle
1614284346,26935,22421,4514,2894,1705,https://www.intensivregister.de/api/public/reporting/laendertabelle
1614291552,26935,22425,4510,2895,1705,https://www.intensivregister.de/api/public/reporting/laendertabelle
1614295150,26933,22420,4513,2896,1706,https://www.intensivregister.de/api/public/reporting/laendertabelle
1614298748,26933,22417,4516,2896,1706,https://www.intensivregister.de/api/public/reporting/laendertabelle
1614302346,26933,22420,4513,2896,1706,https://www.intensivregister.de/api/public/reporting/laendertabelle
1614305944,26933,22426,4507,2898,1708,https://www.intensivregister.de/api/public/reporting/laendertabelle
1614309551,26933,22425,4508,2901,1706,https://www.intensivregister.de/api/public/reporting/laendertabelle
1614313149,26940,22452,4488,2899,1710,https://www.intensivregister.de/api/public/reporting/laendertabelle
1614316747,26915,22429,4486,2884,1695,https://www.intensivregister.de/api/public/reporting/laendertabelle
1614320345,26907,22429,4478,2866,1701,https://www.intensivregister.de/api/public/reporting/laendertabelle
1614323943,26901,22409,4492,2861,1693,https://www.intensivregister.de/api/public/reporting/laendertabelle
1614327551,26888,22366,4522,2857,1690,https://www.intensivregister.de/api/public/reporting/laendertabelle
1614331149,26874,22323,4551,2849,1682,https://www.intensivregister.de/api/public/reporting/laendertabelle
1614334747,26873,22322,4551,2848,1683,https://www.intensivregister.de/api/public/reporting/laendertabelle
1614338345,26870,22325,4545,2850,1685,https://www.intensivregister.de/api/public/reporting/laendertabelle
1614341953,26870,22318,4552,2847,1682,https://www.intensivregister.de/api/public/reporting/laendertabelle
1614345551,26868,22314,4554,2846,1682,https://www.intensivregister.de/api/public/reporting/laendertabelle
1614349149,26868,22319,4549,2849,1682,https://www.intensivregister.de/api/public/reporting/laendertabelle
1614359953,26863,22316,4547,2848,1682,https://www.intensivregister.de/api/public/reporting/laendertabelle
1614363550,26863,22314,4549,2848,1683,https://www.intensivregister.de/api/public/reporting/laendertabelle
1614377952,26863,22308,4555,2849,1684,https://www.intensivregister.de/api/public/reporting/laendertabelle
1614381550,26861,22308,4553,2849,1683,https://www.intensivregister.de/api/public/reporting/laendertabelle
1614385148,26861,22298,4563,2851,1683,https://www.intensivregister.de/api/public/reporting/laendertabelle
1614392344,26861,22292,4569,2850,1683,https://www.intensivregister.de/api/public/reporting/laendertabelle
1614395952,26860,22303,4557,2849,1678,https://www.intensivregister.de/api/public/reporting/laendertabelle
1614399550,26858,22288,4570,2850,1680,https://www.intensivregister.de/api/public/reporting/laendertabelle
1614403148,26855,22264,4591,2846,1678,https://www.intensivregister.de/api/public/reporting/laendertabelle
1614406746,26822,22233,4589,2836,1688,https://www.intensivregister.de/api/public/reporting/laendertabelle
1614410344,26763,22042,4721,2838,1694,https://www.intensivregister.de/api/public/reporting/laendertabelle
1614413952,26743,21964,4779,2824,1660,https://www.intensivregister.de/api/public/reporting/laendertabelle
1614417559,26713,21937,4776,2827,1657,https://www.intensivregister.de/api/public/reporting/laendertabelle
1614421147,26712,21922,4790,2826,1654,https://www.intensivregister.de/api/public/reporting/laendertabelle
1614424745,26713,21918,4795,2826,1653,https://www.intensivregister.de/api/public/reporting/laendertabelle
1614428343,26715,21918,4797,2826,1654,https://www.intensivregister.de/api/public/reporting/laendertabelle
1614431951,26716,21921,4795,2824,1653,https://www.intensivregister.de/api/public/reporting/laendertabelle
1614435549,26718,21915,4803,2824,1653,https://www.intensivregister.de/api/public/reporting/laendertabelle
1614446353,26718,21916,4802,2824,1654,https://www.intensivregister.de/api/public/reporting/laendertabelle
1614449951,26718,21917,4801,2825,1654,https://www.intensivregister.de/api/public/reporting/laendertabelle
1614453549,26720,21922,4798,2824,1654,https://www.intensivregister.de/api/public/reporting/laendertabelle
1614457147,26716,21922,4794,2823,1653,https://www.intensivregister.de/api/public/reporting/laendertabelle
1614460745,26716,21920,4796,2823,1653,https://www.intensivregister.de/api/public/reporting/laendertabelle
1614464343,26716,21922,4794,2824,1654,https://www.intensivregister.de/api/public/reporting/laendertabelle
1614467951,26715,21911,4804,2824,1654,https://www.intensivregister.de/api/public/reporting/laendertabelle
1614471550,26714,21905,4809,2822,1654,https://www.intensivregister.de/api/public/reporting/laendertabelle
1614475148,26714,21906,4808,2822,1654,https://www.intensivregister.de/api/public/reporting/laendertabelle
1614478746,26714,21901,4813,2825,1655,https://www.intensivregister.de/api/public/reporting/laendertabelle
1614482344,26714,21893,4821,2824,1655,https://www.intensivregister.de/api/public/reporting/laendertabelle
1614485952,26708,21870,4838,2819,1654,https://www.intensivregister.de/api/public/reporting/laendertabelle
1614489550,26701,21788,4913,2811,1646,https://www.intensivregister.de/api/public/reporting/laendertabelle
1614493150,26674,21632,5042,2828,1648,https://www.intensivregister.de/api/public/reporting/laendertabelle
1614496747,26643,21524,5119,2827,1657,https://www.intensivregister.de/api/public/reporting/laendertabelle
1614500345,26631,21477,5154,2841,1662,https://www.intensivregister.de/api/public/reporting/laendertabelle
1614503943,26620,21458,5162,2837,1658,https://www.intensivregister.de/api/public/reporting/laendertabelle
1614507551,26618,21458,5160,2837,1657,https://www.intensivregister.de/api/public/reporting/laendertabelle
1614511149,26619,21451,5168,2836,1657,https://www.intensivregister.de/api/public/reporting/laendertabelle
1614514748,26618,21448,5170,2837,1660,https://www.intensivregister.de/api/public/reporting/laendertabelle
1614518347,26618,21448,5170,2838,1660,https://www.intensivregister.de/api/public/reporting/laendertabelle
1614521944,26618,21443,5175,2838,1660,https://www.intensivregister.de/api/public/reporting/laendertabelle
1614529150,26618,21444,5174,2838,1661,https://www.intensivregister.de/api/public/reporting/laendertabelle
1614532750,26618,21443,5175,2838,1661,https://www.intensivregister.de/api/public/reporting/laendertabelle
1614536352,26618,21445,5173,2839,1661,https://www.intensivregister.de/api/public/reporting/laendertabelle
1614539944,26618,21450,5168,2839,1661,https://www.intensivregister.de/api/public/reporting/laendertabelle
1614543545,26618,21451,5167,2839,1661,https://www.intensivregister.de/api/public/reporting/laendertabelle
1614550748,26617,21456,5161,2836,1659,https://www.intensivregister.de/api/public/reporting/laendertabelle
1614554350,26617,21458,5159,2836,1659,https://www.intensivregister.de/api/public/reporting/laendertabelle
1614557951,26619,21453,5166,2834,1659,https://www.intensivregister.de/api/public/reporting/laendertabelle
1614565145,26617,21460,5157,2835,1659,https://www.intensivregister.de/api/public/reporting/laendertabelle
1614568746,26617,21464,5153,2838,1662,https://www.intensivregister.de/api/public/reporting/laendertabelle
1614572347,26626,21485,5141,2838,1662,https://www.intensivregister.de/api/public/reporting/laendertabelle
1614575949,26637,21506,5131,2841,1659,https://www.intensivregister.de/api/public/reporting/laendertabelle
1614579551,26685,21564,5121,2854,1645,https://www.intensivregister.de/api/public/reporting/laendertabelle
1614583143,26751,21664,5087,2862,1637,https://www.intensivregister.de/api/public/reporting/laendertabelle
1614586745,26786,21699,5087,2862,1638,https://www.intensivregister.de/api/public/reporting/laendertabelle
1614590348,26798,21700,5098,2867,1643,https://www.intensivregister.de/api/public/reporting/laendertabelle
1614593950,26805,21706,5099,2869,1646,https://www.intensivregister.de/api/public/reporting/laendertabelle
1614597552,26815,21712,5103,2869,1646,https://www.intensivregister.de/api/public/reporting/laendertabelle
1614601144,26815,21720,5095,2871,1647,https://www.intensivregister.de/api/public/reporting/laendertabelle
1614604747,26815,21715,5100,2871,1649,https://www.intensivregister.de/api/public/reporting/laendertabelle
1614608349,26815,21711,5104,2869,1648,https://www.intensivregister.de/api/public/reporting/laendertabelle
1614611950,26812,21713,5099,2870,1648,https://www.intensivregister.de/api/public/reporting/laendertabelle
1614619145,26812,21707,5105,2869,1648,https://www.intensivregister.de/api/public/reporting/laendertabelle
1614622746,26813,21709,5104,2869,1648,https://www.intensivregister.de/api/public/reporting/laendertabelle
1614629950,26813,21711,5102,2870,1649,https://www.intensivregister.de/api/public/reporting/laendertabelle
1614633551,26813,21712,5101,2870,1649,https://www.intensivregister.de/api/public/reporting/laendertabelle
1614637143,26817,21721,5096,2867,1649,https://www.intensivregister.de/api/public/reporting/laendertabelle
1614640745,26817,21721,5096,2864,1646,https://www.intensivregister.de/api/public/reporting/laendertabelle
1614644346,26817,21725,5092,2864,1646,https://www.intensivregister.de/api/public/reporting/laendertabelle
1614651549,26820,21712,5108,2859,1643,https://www.intensivregister.de/api/public/reporting/laendertabelle
1614655151,26821,21722,5099,2862,1644,https://www.intensivregister.de/api/public/reporting/laendertabelle
1614658752,26830,21752,5078,2860,1645,https://www.intensivregister.de/api/public/reporting/laendertabelle
1614662344,26851,21906,4945,2873,1646,https://www.intensivregister.de/api/public/reporting/laendertabelle
1614665947,26889,22111,4778,2854,1620,https://www.intensivregister.de/api/public/reporting/laendertabelle
1614669548,26888,22177,4711,2844,1607,https://www.intensivregister.de/api/public/reporting/laendertabelle
1614673151,26922,22245,4677,2851,1613,https://www.intensivregister.de/api/public/reporting/laendertabelle
1614676753,26944,22312,4632,2853,1615,https://www.intensivregister.de/api/public/reporting/laendertabelle
1614680345,26944,22301,4643,2853,1615,https://www.intensivregister.de/api/public/reporting/laendertabelle
1614683947,26947,22309,4638,2853,1615,https://www.intensivregister.de/api/public/reporting/laendertabelle
1614687549,27045,22374,4671,2854,1616,https://www.intensivregister.de/api/public/reporting/laendertabelle
1614691152,27045,22375,4670,2853,1616,https://www.intensivregister.de/api/public/reporting/laendertabelle
1614694743,27047,22379,4668,2853,1617,https://www.intensivregister.de/api/public/reporting/laendertabelle
1614698345,27047,22381,4666,2851,1616,https://www.intensivregister.de/api/public/reporting/laendertabelle
1614701947,27047,22385,4662,2851,1616,https://www.intensivregister.de/api/public/reporting/laendertabelle
1614705549,27047,22382,4665,2851,1616,https://www.intensivregister.de/api/public/reporting/laendertabelle
1614709152,27048,22381,4667,2851,1616,https://www.intensivregister.de/api/public/reporting/laendertabelle
1614716344,27048,22382,4666,2852,1616,https://www.intensivregister.de/api/public/reporting/laendertabelle
1614723547,27047,22377,4670,2853,1616,https://www.intensivregister.de/api/public/reporting/laendertabelle
1614727149,27048,22377,4671,2853,1616,https://www.intensivregister.de/api/public/reporting/laendertabelle
1614730750,27049,22373,4676,2851,1615,https://www.intensivregister.de/api/public/reporting/laendertabelle
1614734353,27049,22371,4678,2849,1614,https://www.intensivregister.de/api/public/reporting/laendertabelle
1614737944,27049,22369,4680,2848,1615,https://www.intensivregister.de/api/public/reporting/laendertabelle
1614741545,27048,22356,4692,2848,1615,https://www.intensivregister.de/api/public/reporting/laendertabelle
1614745147,27062,22376,4686,2847,1619,https://www.intensivregister.de/api/public/reporting/laendertabelle
1614748749,27044,22383,4661,2853,1636,https://www.intensivregister.de/api/public/reporting/laendertabelle
1614752351,27053,22378,4675,2828,1617,https://www.intensivregister.de/api/public/reporting/laendertabelle
1614755943,27057,22411,4646,2833,1624,https://www.intensivregister.de/api/public/reporting/laendertabelle
1614759546,27055,22401,4654,2831,1628,https://www.intensivregister.de/api/public/reporting/laendertabelle
1614763148,27063,22363,4700,2826,1630,https://www.intensivregister.de/api/public/reporting/laendertabelle
1614766750,27063,22366,4697,2827,1631,https://www.intensivregister.de/api/public/reporting/laendertabelle
1614770353,27063,22361,4702,2830,1631,https://www.intensivregister.de/api/public/reporting/laendertabelle
1614773945,27063,22359,4704,2829,1629,https://www.intensivregister.de/api/public/reporting/laendertabelle
1614777547,27061,22354,4707,2829,1629,https://www.intensivregister.de/api/public/reporting/laendertabelle
1614781150,27062,22351,4711,2830,1629,https://www.intensivregister.de/api/public/reporting/laendertabelle
1614788343,27062,22349,4713,2830,1629,https://www.intensivregister.de/api/public/reporting/laendertabelle
1614791946,27062,22348,4714,2831,1630,https://www.intensivregister.de/api/public/reporting/laendertabelle
1614795548,27063,22349,4714,2831,1630,https://www.intensivregister.de/api/public/reporting/laendertabelle
1614799149,27063,22349,4714,2833,1630,https://www.intensivregister.de/api/public/reporting/laendertabelle
1614802751,27063,22348,4715,2833,1630,https://www.intensivregister.de/api/public/reporting/laendertabelle
1614809944,27062,22351,4711,2833,1630,https://www.intensivregister.de/api/public/reporting/laendertabelle
1614813548,27065,22349,4716,2834,1630,https://www.intensivregister.de/api/public/reporting/laendertabelle
1614817147,27065,22352,4713,2834,1630,https://www.intensivregister.de/api/public/reporting/laendertabelle
1614824351,27067,22359,4708,2836,1630,https://www.intensivregister.de/api/public/reporting/laendertabelle
1614827952,27063,22351,4712,2834,1630,https://www.intensivregister.de/api/public/reporting/laendertabelle
1614831543,27064,22373,4691,2832,1630,https://www.intensivregister.de/api/public/reporting/laendertabelle
1614835145,27066,22314,4752,2838,1635,https://www.intensivregister.de/api/public/reporting/laendertabelle
1614838747,27073,22331,4742,2838,1626,https://www.intensivregister.de/api/public/reporting/laendertabelle
1614842349,27057,22328,4729,2812,1618,https://www.intensivregister.de/api/public/reporting/laendertabelle
1614845951,27014,22331,4683,2806,1598,https://www.intensivregister.de/api/public/reporting/laendertabelle
1614849543,27030,22354,4676,2816,1595,https://www.intensivregister.de/api/public/reporting/laendertabelle
1614853147,27030,22354,4676,2810,1594,https://www.intensivregister.de/api/public/reporting/laendertabelle
1614856748,27028,22353,4675,2810,1593,https://www.intensivregister.de/api/public/reporting/laendertabelle
1614860350,27028,22343,4685,2810,1593,https://www.intensivregister.de/api/public/reporting/laendertabelle
1614863952,27028,22339,4689,2810,1593,https://www.intensivregister.de/api/public/reporting/laendertabelle
1614867544,27028,22341,4687,2810,1594,https://www.intensivregister.de/api/public/reporting/laendertabelle
1614871146,27027,22341,4686,2810,1594,https://www.intensivregister.de/api/public/reporting/laendertabelle
1614874748,27026,22339,4687,2810,1594,https://www.intensivregister.de/api/public/reporting/laendertabelle
1614878350,27026,22340,4686,2810,1594,https://www.intensivregister.de/api/public/reporting/laendertabelle
1614885544,27027,22338,4689,2810,1594,https://www.intensivregister.de/api/public/reporting/laendertabelle
1614889144,27027,22338,4689,2811,1595,https://www.intensivregister.de/api/public/reporting/laendertabelle
1614892746,27027,22337,4690,2811,1595,https://www.intensivregister.de/api/public/reporting/laendertabelle
1614896348,27027,22330,4697,2811,1595,https://www.intensivregister.de/api/public/reporting/laendertabelle
1614899949,27027,22333,4694,2810,1594,https://www.intensivregister.de/api/public/reporting/laendertabelle
1614903551,27027,22333,4694,2811,1595,https://www.intensivregister.de/api/public/reporting/laendertabelle
1614907152,27027,22334,4693,2810,1595,https://www.intensivregister.de/api/public/reporting/laendertabelle
1614910744,27026,22332,4694,2810,1595,https://www.intensivregister.de/api/public/reporting/laendertabelle
1614914345,27025,22319,4706,2806,1591,https://www.intensivregister.de/api/public/reporting/laendertabelle
1614917946,27017,22333,4684,2805,1588,https://www.intensivregister.de/api/public/reporting/laendertabelle
1614921548,26989,22317,4672,2791,1590,https://www.intensivregister.de/api/public/reporting/laendertabelle
1614925150,27061,22369,4692,2786,1573,https://www.intensivregister.de/api/public/reporting/laendertabelle
1614928752,26999,22370,4629,2781,1574,https://www.intensivregister.de/api/public/reporting/laendertabelle
1614932344,27002,22379,4623,2771,1579,https://www.intensivregister.de/api/public/reporting/laendertabelle
1614935946,26991,22362,4629,2761,1581,https://www.intensivregister.de/api/public/reporting/laendertabelle
1614939547,26992,22378,4614,2767,1584,https://www.intensivregister.de/api/public/reporting/laendertabelle
1614943150,26991,22376,4615,2767,1584,https://www.intensivregister.de/api/public/reporting/laendertabelle
1614946752,26992,22359,4633,2764,1584,https://www.intensivregister.de/api/public/reporting/laendertabelle
1614950346,26993,22356,4637,2770,1585,https://www.intensivregister.de/api/public/reporting/laendertabelle
1614953945,26994,22353,4641,2769,1586,https://www.intensivregister.de/api/public/reporting/laendertabelle
1614957547,26994,22349,4645,2767,1586,https://www.intensivregister.de/api/public/reporting/laendertabelle
1614961149,26994,22346,4648,2767,1587,https://www.intensivregister.de/api/public/reporting/laendertabelle
1614968352,26994,22348,4646,2767,1587,https://www.intensivregister.de/api/public/reporting/laendertabelle
1614971944,26994,22346,4648,2769,1586,https://www.intensivregister.de/api/public/reporting/laendertabelle
1614975545,26994,22346,4648,2771,1586,https://www.intensivregister.de/api/public/reporting/laendertabelle
1614982748,26993,22342,4651,2772,1586,https://www.intensivregister.de/api/public/reporting/laendertabelle
1614986350,26994,22342,4652,2772,1586,https://www.intensivregister.de/api/public/reporting/laendertabelle
1614989952,26992,22336,4656,2772,1585,https://www.intensivregister.de/api/public/reporting/laendertabelle
1614993543,26992,22332,4660,2774,1587,https://www.intensivregister.de/api/public/reporting/laendertabelle
1614997145,26993,22332,4661,2773,1587,https://www.intensivregister.de/api/public/reporting/laendertabelle
1615000746,26993,22350,4643,2775,1586,https://www.intensivregister.de/api/public/reporting/laendertabelle
1615004348,26990,22330,4660,2774,1588,https://www.intensivregister.de/api/public/reporting/laendertabelle
1615007950,26985,22329,4656,2774,1589,https://www.intensivregister.de/api/public/reporting/laendertabelle
1615011553,26971,22258,4713,2765,1576,https://www.intensivregister.de/api/public/reporting/laendertabelle
1615015143,26915,22061,4854,2761,1574,https://www.intensivregister.de/api/public/reporting/laendertabelle
1615018744,26900,22032,4868,2750,1576,https://www.intensivregister.de/api/public/reporting/laendertabelle
1615022346,26904,21985,4919,2755,1577,https://www.intensivregister.de/api/public/reporting/laendertabelle
1615025948,26905,21978,4927,2757,1579,https://www.intensivregister.de/api/public/reporting/laendertabelle
1615029550,26905,21976,4929,2757,1580,https://www.intensivregister.de/api/public/reporting/laendertabelle
1615033152,26905,21972,4933,2757,1581,https://www.intensivregister.de/api/public/reporting/laendertabelle
1615036743,26906,21973,4933,2758,1581,https://www.intensivregister.de/api/public/reporting/laendertabelle
1615040345,26900,21966,4934,2759,1581,https://www.intensivregister.de/api/public/reporting/laendertabelle
1615043947,26900,21965,4935,2758,1580,https://www.intensivregister.de/api/public/reporting/laendertabelle
1615047549,26899,21963,4936,2758,1580,https://www.intensivregister.de/api/public/reporting/laendertabelle
1615051151,26902,21959,4943,2756,1580,https://www.intensivregister.de/api/public/reporting/laendertabelle
1615054743,26903,21961,4942,2756,1580,https://www.intensivregister.de/api/public/reporting/laendertabelle
1615061948,26903,21961,4942,2757,1581,https://www.intensivregister.de/api/public/reporting/laendertabelle
1615069150,26903,21953,4950,2756,1581,https://www.intensivregister.de/api/public/reporting/laendertabelle
1615072752,26903,21941,4962,2757,1581,https://www.intensivregister.de/api/public/reporting/laendertabelle
1615076343,26901,21938,4963,2757,1581,https://www.intensivregister.de/api/public/reporting/laendertabelle
1615083547,26901,21938,4963,2754,1579,https://www.intensivregister.de/api/public/reporting/laendertabelle
1615087148,26898,21939,4959,2754,1580,https://www.intensivregister.de/api/public/reporting/laendertabelle
1615090750,26887,21924,4963,2757,1577,https://www.intensivregister.de/api/public/reporting/laendertabelle
1615094352,26888,21904,4984,2760,1577,https://www.intensivregister.de/api/public/reporting/laendertabelle
1615097944,26866,21791,5075,2764,1578,https://www.intensivregister.de/api/public/reporting/laendertabelle
1615101545,26842,21669,5173,2768,1586,https://www.intensivregister.de/api/public/reporting/laendertabelle
1615105147,26835,21592,5243,2781,1586,https://www.intensivregister.de/api/public/reporting/laendertabelle
1615108750,26823,21554,5269,2788,1586,https://www.intensivregister.de/api/public/reporting/laendertabelle
1615112351,26825,21545,5280,2790,1590,https://www.intensivregister.de/api/public/reporting/laendertabelle
1615115948,26823,21532,5291,2791,1589,https://www.intensivregister.de/api/public/reporting/laendertabelle
1615119550,26823,21533,5290,2791,1589,https://www.intensivregister.de/api/public/reporting/laendertabelle
1615123152,26823,21534,5289,2791,1589,https://www.intensivregister.de/api/public/reporting/laendertabelle
1615126744,26823,21533,5290,2791,1589,https://www.intensivregister.de/api/public/reporting/laendertabelle
1615130346,26823,21535,5288,2792,1589,https://www.intensivregister.de/api/public/reporting/laendertabelle
1615133948,26823,21536,5287,2792,1589,https://www.intensivregister.de/api/public/reporting/laendertabelle
1615137549,26821,21535,5286,2791,1589,https://www.intensivregister.de/api/public/reporting/laendertabelle
1615141151,26821,21533,5288,2791,1589,https://www.intensivregister.de/api/public/reporting/laendertabelle
1615144743,26821,21532,5289,2791,1589,https://www.intensivregister.de/api/public/reporting/laendertabelle
1615148345,26821,21533,5288,2791,1589,https://www.intensivregister.de/api/public/reporting/laendertabelle
1615155549,26821,21532,5289,2789,1589,https://www.intensivregister.de/api/public/reporting/laendertabelle
1615159151,26822,21533,5289,2789,1589,https://www.intensivregister.de/api/public/reporting/laendertabelle
1615162753,26822,21535,5287,2790,1589,https://www.intensivregister.de/api/public/reporting/laendertabelle
1615169946,26822,21540,5282,2791,1589,https://www.intensivregister.de/api/public/reporting/laendertabelle
1615173547,26825,21535,5290,2792,1589,https://www.intensivregister.de/api/public/reporting/laendertabelle
1615177149,26828,21545,5283,2794,1588,https://www.intensivregister.de/api/public/reporting/laendertabelle
1615180750,26843,21570,5273,2811,1595,https://www.intensivregister.de/api/public/reporting/laendertabelle
1615184352,26902,21599,5303,2816,1578,https://www.intensivregister.de/api/public/reporting/laendertabelle
1615187945,26945,21691,5254,2823,1587,https://www.intensivregister.de/api/public/reporting/laendertabelle
1615191546,26969,21744,5225,2839,1582,https://www.intensivregister.de/api/public/reporting/laendertabelle
1615195149,26986,21773,5213,2867,1600,https://www.intensivregister.de/api/public/reporting/laendertabelle
1615198751,26986,21779,5207,2867,1601,https://www.intensivregister.de/api/public/reporting/laendertabelle
1615202344,26992,21791,5201,2869,1605,https://www.intensivregister.de/api/public/reporting/laendertabelle
1615205946,26992,21780,5212,2868,1604,https://www.intensivregister.de/api/public/reporting/laendertabelle
1615209548,26992,21782,5210,2867,1604,https://www.intensivregister.de/api/public/reporting/laendertabelle
1615213150,26990,21789,5201,2870,1605,https://www.intensivregister.de/api/public/reporting/laendertabelle
1615216752,26990,21787,5203,2871,1605,https://www.intensivregister.de/api/public/reporting/laendertabelle
1615220345,26990,21789,5201,2872,1605,https://www.intensivregister.de/api/public/reporting/laendertabelle
1615227548,26990,21791,5199,2873,1605,https://www.intensivregister.de/api/public/reporting/laendertabelle
1615241945,26990,21797,5193,2874,1606,https://www.intensivregister.de/api/public/reporting/laendertabelle
1615245547,26990,21806,5184,2874,1606,https://www.intensivregister.de/api/public/reporting/laendertabelle
1615249148,26990,21807,5183,2874,1606,https://www.intensivregister.de/api/public/reporting/laendertabelle
1615252750,26991,21809,5182,2874,1606,https://www.intensivregister.de/api/public/reporting/laendertabelle
1615256351,26992,21818,5174,2873,1606,https://www.intensivregister.de/api/public/reporting/laendertabelle
1615259943,26995,21829,5166,2872,1607,https://www.intensivregister.de/api/public/reporting/laendertabelle
1615263547,27013,21881,5132,2868,1603,https://www.intensivregister.de/api/public/reporting/laendertabelle
1615267149,27024,21933,5091,2863,1597,https://www.intensivregister.de/api/public/reporting/laendertabelle
1615270752,27053,22008,5045,2848,1595,https://www.intensivregister.de/api/public/reporting/laendertabelle
1615274344,27095,22131,4964,2813,1583,https://www.intensivregister.de/api/public/reporting/laendertabelle
1615277946,27092,22150,4942,2794,1575,https://www.intensivregister.de/api/public/reporting/laendertabelle
1615281549,27096,22169,4927,2786,1573,https://www.intensivregister.de/api/public/reporting/laendertabelle
1615285151,27096,22171,4925,2788,1571,https://www.intensivregister.de/api/public/reporting/laendertabelle
1615288746,27096,22171,4925,2786,1571,https://www.intensivregister.de/api/public/reporting/laendertabelle
1615292346,27095,22167,4928,2785,1572,https://www.intensivregister.de/api/public/reporting/laendertabelle
1615295949,27095,22169,4926,2787,1573,https://www.intensivregister.de/api/public/reporting/laendertabelle
1615299551,27095,22167,4928,2783,1572,https://www.intensivregister.de/api/public/reporting/laendertabelle
1615303143,27095,22165,4930,2784,1572,https://www.intensivregister.de/api/public/reporting/laendertabelle
1615306746,27096,22168,4928,2784,1572,https://www.intensivregister.de/api/public/reporting/laendertabelle
1615310348,27096,22164,4932,2784,1573,https://www.intensivregister.de/api/public/reporting/laendertabelle
1615317552,27096,22165,4931,2784,1573,https://www.intensivregister.de/api/public/reporting/laendertabelle
1615328347,27096,22167,4929,2782,1571,https://www.intensivregister.de/api/public/reporting/laendertabelle
1615331949,27096,22175,4921,2783,1571,https://www.intensivregister.de/api/public/reporting/laendertabelle
1615335551,27096,22175,4921,2782,1571,https://www.intensivregister.de/api/public/reporting/laendertabelle
1615339143,27096,22180,4916,2782,1571,https://www.intensivregister.de/api/public/reporting/laendertabelle
1615342745,27096,22176,4920,2781,1572,https://www.intensivregister.de/api/public/reporting/laendertabelle
1615346349,27095,22179,4916,2776,1570,https://www.intensivregister.de/api/public/reporting/laendertabelle
1615349948,27095,22194,4901,2776,1575,https://www.intensivregister.de/api/public/reporting/laendertabelle
1615353550,27092,22207,4885,2770,1579,https://www.intensivregister.de/api/public/reporting/laendertabelle
1615357143,27081,22257,4824,2742,1575,https://www.intensivregister.de/api/public/reporting/laendertabelle
1615360745,27105,22344,4761,2739,1562,https://www.intensivregister.de/api/public/reporting/laendertabelle
1615364348,27100,22401,4699,2731,1572,https://www.intensivregister.de/api/public/reporting/laendertabelle
1615367951,27104,22424,4680,2737,1571,https://www.intensivregister.de/api/public/reporting/laendertabelle
1615371543,27107,22427,4680,2739,1571,https://www.intensivregister.de/api/public/reporting/laendertabelle
1615375146,27104,22426,4678,2744,1572,https://www.intensivregister.de/api/public/reporting/laendertabelle
1615378748,27104,22425,4679,2742,1572,https://www.intensivregister.de/api/public/reporting/laendertabelle
1615382350,27104,22422,4682,2740,1570,https://www.intensivregister.de/api/public/reporting/laendertabelle
1615385943,27104,22416,4688,2741,1570,https://www.intensivregister.de/api/public/reporting/laendertabelle
1615389545,27104,22421,4683,2741,1570,https://www.intensivregister.de/api/public/reporting/laendertabelle
1615393147,27104,22419,4685,2742,1570,https://www.intensivregister.de/api/public/reporting/laendertabelle
1615400351,27104,22422,4682,2743,1570,https://www.intensivregister.de/api/public/reporting/laendertabelle
1615403943,27105,22424,4681,2746,1573,https://www.intensivregister.de/api/public/reporting/laendertabelle
1615414748,27105,22418,4687,2746,1573,https://www.intensivregister.de/api/public/reporting/laendertabelle
1615418350,27104,22409,4695,2746,1572,https://www.intensivregister.de/api/public/reporting/laendertabelle
1615421952,27104,22403,4701,2746,1572,https://www.intensivregister.de/api/public/reporting/laendertabelle
1615425543,27104,22401,4703,2747,1572,https://www.intensivregister.de/api/public/reporting/laendertabelle
1615429145,27104,22404,4700,2747,1572,https://www.intensivregister.de/api/public/reporting/laendertabelle
1615432746,27103,22393,4710,2745,1572,https://www.intensivregister.de/api/public/reporting/laendertabelle
1615436348,27100,22392,4708,2747,1572,https://www.intensivregister.de/api/public/reporting/laendertabelle
1615439950,27109,22441,4668,2788,1576,https://www.intensivregister.de/api/public/reporting/laendertabelle
1615443552,27112,22440,4672,2794,1579,https://www.intensivregister.de/api/public/reporting/laendertabelle
1615447146,27108,22475,4633,2784,1569,https://www.intensivregister.de/api/public/reporting/laendertabelle
1615450749,27102,22504,4598,2774,1560,https://www.intensivregister.de/api/public/reporting/laendertabelle
1615454350,27090,22492,4598,2760,1557,https://www.intensivregister.de/api/public/reporting/laendertabelle
1615457952,27087,22490,4597,2759,1558,https://www.intensivregister.de/api/public/reporting/laendertabelle
1615461545,27087,22486,4601,2756,1557,https://www.intensivregister.de/api/public/reporting/laendertabelle
1615465148,27087,22485,4602,2757,1558,https://www.intensivregister.de/api/public/reporting/laendertabelle
1615468750,27087,22480,4607,2756,1558,https://www.intensivregister.de/api/public/reporting/laendertabelle
1615472352,27085,22478,4607,2756,1558,https://www.intensivregister.de/api/public/reporting/laendertabelle
1615475945,27085,22478,4607,2755,1558,https://www.intensivregister.de/api/public/reporting/laendertabelle
1615483149,27085,22479,4606,2757,1560,https://www.intensivregister.de/api/public/reporting/laendertabelle
1615486751,27085,22480,4605,2757,1560,https://www.intensivregister.de/api/public/reporting/laendertabelle
1615490343,27085,22478,4607,2757,1560,https://www.intensivregister.de/api/public/reporting/laendertabelle
1615497546,27085,22478,4607,2758,1560,https://www.intensivregister.de/api/public/reporting/laendertabelle
1615501148,27083,22479,4604,2759,1561,https://www.intensivregister.de/api/public/reporting/laendertabelle
1615504749,27083,22484,4599,2759,1561,https://www.intensivregister.de/api/public/reporting/laendertabelle
1615508351,27083,22484,4599,2757,1559,https://www.intensivregister.de/api/public/reporting/laendertabelle
1615511953,27083,22498,4585,2759,1560,https://www.intensivregister.de/api/public/reporting/laendertabelle
1615515544,27084,22493,4591,2758,1557,https://www.intensivregister.de/api/public/reporting/laendertabelle
1615519146,27084,22494,4590,2762,1558,https://www.intensivregister.de/api/public/reporting/laendertabelle
1615522747,27085,22489,4596,2751,1556,https://www.intensivregister.de/api/public/reporting/laendertabelle
1615526349,27083,22487,4596,2732,1556,https://www.intensivregister.de/api/public/reporting/laendertabelle
1615529951,27074,22502,4572,2739,1549,https://www.intensivregister.de/api/public/reporting/laendertabelle
1615533543,27062,22542,4520,2754,1557,https://www.intensivregister.de/api/public/reporting/laendertabelle
1615537145,27063,22544,4519,2751,1559,https://www.intensivregister.de/api/public/reporting/laendertabelle
1615540748,27058,22529,4529,2756,1559,https://www.intensivregister.de/api/public/reporting/laendertabelle
1615544350,27052,22530,4522,2756,1560,https://www.intensivregister.de/api/public/reporting/laendertabelle
1615547952,27049,22520,4529,2759,1560,https://www.intensivregister.de/api/public/reporting/laendertabelle
1615551545,27048,22518,4530,2757,1560,https://www.intensivregister.de/api/public/reporting/laendertabelle
1615555147,27048,22511,4537,2757,1560,https://www.intensivregister.de/api/public/reporting/laendertabelle
1615558749,27047,22503,4544,2760,1560,https://www.intensivregister.de/api/public/reporting/laendertabelle
1615562351,27046,22510,4536,2760,1559,https://www.intensivregister.de/api/public/reporting/laendertabelle
1615565943,27045,22505,4540,2761,1559,https://www.intensivregister.de/api/public/reporting/laendertabelle
1615587544,27045,22493,4552,2760,1559,https://www.intensivregister.de/api/public/reporting/laendertabelle
1615591146,27043,22491,4552,2762,1559,https://www.intensivregister.de/api/public/reporting/laendertabelle
1615594747,27042,22494,4548,2763,1559,https://www.intensivregister.de/api/public/reporting/laendertabelle
1615598349,27042,22500,4542,2763,1559,https://www.intensivregister.de/api/public/reporting/laendertabelle
1615601951,27044,22497,4547,2763,1560,https://www.intensivregister.de/api/public/reporting/laendertabelle
1615605552,27039,22495,4544,2767,1561,https://www.intensivregister.de/api/public/reporting/laendertabelle
1615609144,27039,22501,4538,2773,1558,https://www.intensivregister.de/api/public/reporting/laendertabelle
1615612745,27026,22474,4552,2777,1555,https://www.intensivregister.de/api/public/reporting/laendertabelle
1615616347,26990,22352,4638,2758,1552,https://www.intensivregister.de/api/public/reporting/laendertabelle
1615619948,26937,22225,4712,2747,1552,https://www.intensivregister.de/api/public/reporting/laendertabelle
1615623550,26902,22144,4758,2730,1538,https://www.intensivregister.de/api/public/reporting/laendertabelle
1615627152,26888,22099,4789,2721,1544,https://www.intensivregister.de/api/public/reporting/laendertabelle
1615630743,26884,22102,4782,2730,1544,https://www.intensivregister.de/api/public/reporting/laendertabelle
1615634345,26882,22097,4785,2730,1543,https://www.intensivregister.de/api/public/reporting/laendertabelle
1615637946,26881,22088,4793,2728,1542,https://www.intensivregister.de/api/public/reporting/laendertabelle
1615641548,26881,22089,4792,2728,1542,https://www.intensivregister.de/api/public/reporting/laendertabelle
1615645150,26881,22075,4806,2726,1541,https://www.intensivregister.de/api/public/reporting/laendertabelle
1615648751,26881,22074,4807,2726,1541,https://www.intensivregister.de/api/public/reporting/laendertabelle
1615652343,26881,22073,4808,2727,1541,https://www.intensivregister.de/api/public/reporting/laendertabelle
1615655945,26881,22072,4809,2727,1541,https://www.intensivregister.de/api/public/reporting/laendertabelle
1615659546,26879,22062,4817,2728,1540,https://www.intensivregister.de/api/public/reporting/laendertabelle
1615670351,26879,22063,4816,2728,1540,https://www.intensivregister.de/api/public/reporting/laendertabelle
1615673943,26878,22054,4824,2728,1540,https://www.intensivregister.de/api/public/reporting/laendertabelle
1615677544,26874,22041,4833,2730,1541,https://www.intensivregister.de/api/public/reporting/laendertabelle
1615681145,26874,22042,4832,2727,1541,https://www.intensivregister.de/api/public/reporting/laendertabelle
1615684747,26872,22042,4830,2727,1541,https://www.intensivregister.de/api/public/reporting/laendertabelle
1615688348,26867,22049,4818,2727,1541,https://www.intensivregister.de/api/public/reporting/laendertabelle
1615691950,26867,22051,4816,2727,1541,https://www.intensivregister.de/api/public/reporting/laendertabelle
1615695551,26865,22053,4812,2724,1541,https://www.intensivregister.de/api/public/reporting/laendertabelle
1615699143,26852,21963,4889,2724,1539,https://www.intensivregister.de/api/public/reporting/laendertabelle
1615702745,26848,21945,4903,2727,1541,https://www.intensivregister.de/api/public/reporting/laendertabelle
1615706346,26816,21841,4975,2742,1551,https://www.intensivregister.de/api/public/reporting/laendertabelle
1615709948,26793,21695,5098,2765,1555,https://www.intensivregister.de/api/public/reporting/laendertabelle
1615713550,26773,21656,5117,2777,1556,https://www.intensivregister.de/api/public/reporting/laendertabelle
1615717152,26771,21641,5130,2776,1556,https://www.intensivregister.de/api/public/reporting/laendertabelle
1615720744,26774,21641,5133,2776,1556,https://www.intensivregister.de/api/public/reporting/laendertabelle
1615724346,26774,21642,5132,2776,1556,https://www.intensivregister.de/api/public/reporting/laendertabelle
1615727948,26773,21641,5132,2778,1558,https://www.intensivregister.de/api/public/reporting/laendertabelle
1615731549,26772,21643,5129,2778,1558,https://www.intensivregister.de/api/public/reporting/laendertabelle
1615735151,26772,21644,5128,2779,1558,https://www.intensivregister.de/api/public/reporting/laendertabelle
1615738743,26772,21642,5130,2779,1558,https://www.intensivregister.de/api/public/reporting/laendertabelle
1615742345,26772,21636,5136,2780,1558,https://www.intensivregister.de/api/public/reporting/laendertabelle
1615745947,26772,21635,5137,2780,1558,https://www.intensivregister.de/api/public/reporting/laendertabelle
1615749548,26772,21636,5136,2780,1558,https://www.intensivregister.de/api/public/reporting/laendertabelle
1615760344,26768,21637,5131,2779,1558,https://www.intensivregister.de/api/public/reporting/laendertabelle
1615763946,26768,21634,5134,2778,1558,https://www.intensivregister.de/api/public/reporting/laendertabelle
1615767548,26767,21630,5137,2777,1558,https://www.intensivregister.de/api/public/reporting/laendertabelle
1615771150,26767,21632,5135,2777,1558,https://www.intensivregister.de/api/public/reporting/laendertabelle
1615774751,26763,21626,5137,2778,1559,https://www.intensivregister.de/api/public/reporting/laendertabelle
1615778343,26766,21624,5142,2777,1560,https://www.intensivregister.de/api/public/reporting/laendertabelle
1615781945,26799,21633,5166,2779,1564,https://www.intensivregister.de/api/public/reporting/laendertabelle
1615785547,26807,21654,5153,2794,1567,https://www.intensivregister.de/api/public/reporting/laendertabelle
1615789150,26867,21692,5175,2812,1597,https://www.intensivregister.de/api/public/reporting/laendertabelle
1615792752,26896,21815,5081,2831,1605,https://www.intensivregister.de/api/public/reporting/laendertabelle
1615796344,26899,21834,5065,2829,1612,https://www.intensivregister.de/api/public/reporting/laendertabelle
1615799946,26918,21835,5083,2831,1611,https://www.intensivregister.de/api/public/reporting/laendertabelle
1615803549,26919,21840,5079,2837,1614,https://www.intensivregister.de/api/public/reporting/laendertabelle
1615807151,26919,21840,5079,2838,1615,https://www.intensivregister.de/api/public/reporting/laendertabelle
1615810743,26921,21843,5078,2840,1615,https://www.intensivregister.de/api/public/reporting/laendertabelle
1615814346,26921,21843,5078,2844,1615,https://www.intensivregister.de/api/public/reporting/laendertabelle
1615817948,26921,21849,5072,2843,1614,https://www.intensivregister.de/api/public/reporting/laendertabelle
1615821550,26921,21851,5070,2843,1614,https://www.intensivregister.de/api/public/reporting/laendertabelle
1615825152,26921,21852,5069,2843,1614,https://www.intensivregister.de/api/public/reporting/laendertabelle
1615828744,26918,21853,5065,2843,1614,https://www.intensivregister.de/api/public/reporting/laendertabelle
1615843151,26918,21854,5064,2843,1614,https://www.intensivregister.de/api/public/reporting/laendertabelle
1615846743,26918,21838,5080,2842,1614,https://www.intensivregister.de/api/public/reporting/laendertabelle
1615850344,26912,21834,5078,2842,1613,https://www.intensivregister.de/api/public/reporting/laendertabelle
1615861149,26919,21832,5087,2844,1614,https://www.intensivregister.de/api/public/reporting/laendertabelle
1615864750,26920,21840,5080,2843,1614,https://www.intensivregister.de/api/public/reporting/laendertabelle
1615868352,26917,21914,5003,2847,1618,https://www.intensivregister.de/api/public/reporting/laendertabelle
1615871944,26948,22091,4857,2833,1626,https://www.intensivregister.de/api/public/reporting/laendertabelle
1615875546,26957,22187,4770,2835,1620,https://www.intensivregister.de/api/public/reporting/laendertabelle
1615879148,26974,22303,4671,2844,1612,https://www.intensivregister.de/api/public/reporting/laendertabelle
1615882751,26983,22340,4643,2847,1612,https://www.intensivregister.de/api/public/reporting/laendertabelle
1615886343,26994,22345,4649,2851,1605,https://www.intensivregister.de/api/public/reporting/laendertabelle
1615889946,27011,22350,4661,2851,1604,https://www.intensivregister.de/api/public/reporting/laendertabelle
1615893548,27012,22358,4654,2850,1605,https://www.intensivregister.de/api/public/reporting/laendertabelle
1615897151,27012,22354,4658,2850,1607,https://www.intensivregister.de/api/public/reporting/laendertabelle
1615900744,27013,22362,4651,2851,1608,https://www.intensivregister.de/api/public/reporting/laendertabelle
1615904348,27012,22362,4650,2851,1608,https://www.intensivregister.de/api/public/reporting/laendertabelle
1615907949,27010,22363,4647,2852,1608,https://www.intensivregister.de/api/public/reporting/laendertabelle
1615911551,27010,22362,4648,2852,1608,https://www.intensivregister.de/api/public/reporting/laendertabelle
1615922348,27010,22364,4646,2853,1610,https://www.intensivregister.de/api/public/reporting/laendertabelle
1615933143,27006,22371,4635,2854,1610,https://www.intensivregister.de/api/public/reporting/laendertabelle
1615936745,27006,22375,4631,2854,1610,https://www.intensivregister.de/api/public/reporting/laendertabelle
1615940347,27006,22381,4625,2853,1609,https://www.intensivregister.de/api/public/reporting/laendertabelle
1615943949,27006,22379,4627,2853,1609,https://www.intensivregister.de/api/public/reporting/laendertabelle
1615947553,27005,22384,4621,2853,1610,https://www.intensivregister.de/api/public/reporting/laendertabelle
1615951152,27004,22399,4605,2855,1613,https://www.intensivregister.de/api/public/reporting/laendertabelle
1615954744,27010,22376,4634,2859,1602,https://www.intensivregister.de/api/public/reporting/laendertabelle
1615958346,27017,22361,4656,2860,1611,https://www.intensivregister.de/api/public/reporting/laendertabelle
1615961948,26994,22393,4601,2870,1599,https://www.intensivregister.de/api/public/reporting/laendertabelle
1615965550,27018,22477,4541,2857,1585,https://www.intensivregister.de/api/public/reporting/laendertabelle
1615969144,27020,22496,4524,2864,1585,https://www.intensivregister.de/api/public/reporting/laendertabelle
1615972746,27013,22474,4539,2861,1573,https://www.intensivregister.de/api/public/reporting/laendertabelle
1615976349,27014,22472,4542,2862,1574,https://www.intensivregister.de/api/public/reporting/laendertabelle
1615979951,27014,22473,4541,2861,1574,https://www.intensivregister.de/api/public/reporting/laendertabelle
1615983544,27010,22474,4536,2861,1575,https://www.intensivregister.de/api/public/reporting/laendertabelle
1615987146,27010,22477,4533,2860,1573,https://www.intensivregister.de/api/public/reporting/laendertabelle
1615990749,27012,22479,4533,2859,1572,https://www.intensivregister.de/api/public/reporting/laendertabelle
1615994352,27012,22480,4532,2856,1570,https://www.intensivregister.de/api/public/reporting/laendertabelle
1615997944,27012,22484,4528,2856,1570,https://www.intensivregister.de/api/public/reporting/laendertabelle
1616001546,27012,22479,4533,2856,1570,https://www.intensivregister.de/api/public/reporting/laendertabelle
1616005148,27012,22478,4534,2856,1570,https://www.intensivregister.de/api/public/reporting/laendertabelle
1616008750,27012,22480,4532,2856,1569,https://www.intensivregister.de/api/public/reporting/laendertabelle
1616015944,27012,22481,4531,2857,1571,https://www.intensivregister.de/api/public/reporting/laendertabelle
1616019546,27013,22478,4535,2856,1570,https://www.intensivregister.de/api/public/reporting/laendertabelle
1616023148,27013,22478,4535,2857,1570,https://www.intensivregister.de/api/public/reporting/laendertabelle
1616026749,27013,22477,4536,2856,1569,https://www.intensivregister.de/api/public/reporting/laendertabelle
1616030351,27013,22476,4537,2855,1569,https://www.intensivregister.de/api/public/reporting/laendertabelle
1616033953,27008,22476,4532,2855,1568,https://www.intensivregister.de/api/public/reporting/laendertabelle
1616037545,27006,22482,4524,2857,1566,https://www.intensivregister.de/api/public/reporting/laendertabelle
1616041147,27007,22483,4524,2856,1569,https://www.intensivregister.de/api/public/reporting/laendertabelle
1616044749,26998,22521,4477,2871,1568,https://www.intensivregister.de/api/public/reporting/laendertabelle
1616048351,27003,22527,4476,2877,1567,https://www.intensivregister.de/api/public/reporting/laendertabelle
1616051944,26989,22483,4506,2885,1582,https://www.intensivregister.de/api/public/reporting/laendertabelle
1616055546,26973,22476,4497,2893,1591,https://www.intensivregister.de/api/public/reporting/laendertabelle
1616059148,26971,22514,4457,2896,1590,https://www.intensivregister.de/api/public/reporting/laendertabelle
1616062750,26972,22521,4451,2898,1590,https://www.intensivregister.de/api/public/reporting/laendertabelle
1616066354,26972,22520,4452,2898,1592,https://www.intensivregister.de/api/public/reporting/laendertabelle
1616069944,26971,22520,4451,2900,1592,https://www.intensivregister.de/api/public/reporting/laendertabelle
1616077148,26971,22513,4458,2899,1588,https://www.intensivregister.de/api/public/reporting/laendertabelle
1616080750,26967,22506,4461,2899,1588,https://www.intensivregister.de/api/public/reporting/laendertabelle
1616084352,26966,22506,4460,2900,1588,https://www.intensivregister.de/api/public/reporting/laendertabelle
1616087944,26966,22503,4463,2900,1588,https://www.intensivregister.de/api/public/reporting/laendertabelle
1616091546,26966,22504,4462,2900,1588,https://www.intensivregister.de/api/public/reporting/laendertabelle
1616098750,26966,22505,4461,2900,1588,https://www.intensivregister.de/api/public/reporting/laendertabelle
1616105943,26965,22504,4461,2898,1588,https://www.intensivregister.de/api/public/reporting/laendertabelle
1616109545,26970,22508,4462,2897,1589,https://www.intensivregister.de/api/public/reporting/laendertabelle
1616113162,26970,22512,4458,2897,1589,https://www.intensivregister.de/api/public/reporting/laendertabelle
1616116748,26969,22511,4458,2897,1589,https://www.intensivregister.de/api/public/reporting/laendertabelle
1616120343,26969,22518,4451,2897,1588,https://www.intensivregister.de/api/public/reporting/laendertabelle
1616123943,26971,22519,4452,2900,1589,https://www.intensivregister.de/api/public/reporting/laendertabelle
1616127543,26967,22492,4475,2890,1588,https://www.intensivregister.de/api/public/reporting/laendertabelle
1616131153,26947,22506,4441,2891,1590,https://www.intensivregister.de/api/public/reporting/laendertabelle
1616134753,26933,22531,4402,2911,1592,https://www.intensivregister.de/api/public/reporting/laendertabelle
1616141952,26916,22512,4404,2941,1595,https://www.intensivregister.de/api/public/reporting/laendertabelle
1616145553,26916,22505,4411,2949,1593,https://www.intensivregister.de/api/public/reporting/laendertabelle
1616149153,26917,22506,4411,2954,1597,https://www.intensivregister.de/api/public/reporting/laendertabelle
1616152743,26915,22506,4409,2955,1596,https://www.intensivregister.de/api/public/reporting/laendertabelle
1616156343,26912,22500,4412,2954,1594,https://www.intensivregister.de/api/public/reporting/laendertabelle
1616159943,26912,22502,4410,2954,1595,https://www.intensivregister.de/api/public/reporting/laendertabelle
1616163543,26912,22501,4411,2954,1593,https://www.intensivregister.de/api/public/reporting/laendertabelle
1616167143,26908,22492,4416,2957,1594,https://www.intensivregister.de/api/public/reporting/laendertabelle
1616170743,26908,22488,4420,2957,1594,https://www.intensivregister.de/api/public/reporting/laendertabelle
1616174343,26908,22489,4419,2957,1594,https://www.intensivregister.de/api/public/reporting/laendertabelle
1616177943,26908,22488,4420,2957,1594,https://www.intensivregister.de/api/public/reporting/laendertabelle
1616181543,26908,22487,4421,2957,1593,https://www.intensivregister.de/api/public/reporting/laendertabelle
1616185143,26908,22485,4423,2957,1593,https://www.intensivregister.de/api/public/reporting/laendertabelle
1616192343,26908,22476,4432,2959,1594,https://www.intensivregister.de/api/public/reporting/laendertabelle
1616195953,26908,22471,4437,2957,1593,https://www.intensivregister.de/api/public/reporting/laendertabelle
1616199553,26906,22470,4436,2957,1593,https://www.intensivregister.de/api/public/reporting/laendertabelle
1616203152,26904,22471,4433,2957,1593,https://www.intensivregister.de/api/public/reporting/laendertabelle
1616206752,26903,22471,4432,2958,1593,https://www.intensivregister.de/api/public/reporting/laendertabelle
1616210352,26904,22463,4441,2960,1592,https://www.intensivregister.de/api/public/reporting/laendertabelle
1616213952,26902,22456,4446,2964,1596,https://www.intensivregister.de/api/public/reporting/laendertabelle
1616217552,26890,22423,4467,2962,1598,https://www.intensivregister.de/api/public/reporting/laendertabelle
1616221152,26876,22389,4487,2967,1599,https://www.intensivregister.de/api/public/reporting/laendertabelle
1616224752,26783,22224,4559,2946,1589,https://www.intensivregister.de/api/public/reporting/laendertabelle
1616228352,26755,22124,4631,2952,1594,https://www.intensivregister.de/api/public/reporting/laendertabelle
1616231952,26743,22092,4651,2956,1596,https://www.intensivregister.de/api/public/reporting/laendertabelle
1616235551,26742,22072,4670,2958,1596,https://www.intensivregister.de/api/public/reporting/laendertabelle
1616239152,26745,22069,4676,2959,1596,https://www.intensivregister.de/api/public/reporting/laendertabelle
1616242751,26742,22061,4681,2961,1598,https://www.intensivregister.de/api/public/reporting/laendertabelle
1616246351,26747,22053,4694,2963,1596,https://www.intensivregister.de/api/public/reporting/laendertabelle
1616249951,26747,22054,4693,2963,1596,https://www.intensivregister.de/api/public/reporting/laendertabelle
1616253551,26747,22053,4694,2963,1596,https://www.intensivregister.de/api/public/reporting/laendertabelle
1616257151,26747,22054,4693,2966,1596,https://www.intensivregister.de/api/public/reporting/laendertabelle
1616264351,26747,22051,4696,2966,1596,https://www.intensivregister.de/api/public/reporting/laendertabelle
1616267950,26747,22051,4696,2967,1596,https://www.intensivregister.de/api/public/reporting/laendertabelle
1616271550,26747,22050,4697,2965,1596,https://www.intensivregister.de/api/public/reporting/laendertabelle
1616275150,26747,22048,4699,2965,1596,https://www.intensivregister.de/api/public/reporting/laendertabelle
1616278750,26747,22037,4710,2968,1597,https://www.intensivregister.de/api/public/reporting/laendertabelle
1616282350,26747,22039,4708,2968,1597,https://www.intensivregister.de/api/public/reporting/laendertabelle
1616285949,26747,22030,4717,2968,1597,https://www.intensivregister.de/api/public/reporting/laendertabelle
1616293150,26746,22030,4716,2967,1595,https://www.intensivregister.de/api/public/reporting/laendertabelle
1616296749,26745,22038,4707,2967,1595,https://www.intensivregister.de/api/public/reporting/laendertabelle
1616300349,26743,22029,4714,2969,1595,https://www.intensivregister.de/api/public/reporting/laendertabelle
1616303949,26738,21984,4754,2978,1591,https://www.intensivregister.de/api/public/reporting/laendertabelle
1616307549,26731,21944,4787,2986,1596,https://www.intensivregister.de/api/public/reporting/laendertabelle
1616311149,26700,21785,4915,3013,1616,https://www.intensivregister.de/api/public/reporting/laendertabelle
1616314749,26697,21691,5006,3022,1629,https://www.intensivregister.de/api/public/reporting/laendertabelle
1616318349,26693,21654,5039,3030,1631,https://www.intensivregister.de/api/public/reporting/laendertabelle
1616321949,26687,21590,5097,3058,1654,https://www.intensivregister.de/api/public/reporting/laendertabelle
1616325549,26684,21592,5092,3058,1656,https://www.intensivregister.de/api/public/reporting/laendertabelle
1616329149,26684,21593,5091,3061,1658,https://www.intensivregister.de/api/public/reporting/laendertabelle
1616332748,26686,21590,5096,3063,1657,https://www.intensivregister.de/api/public/reporting/laendertabelle
1616336348,26682,21598,5084,3064,1658,https://www.intensivregister.de/api/public/reporting/laendertabelle
1616339948,26683,21597,5086,3063,1658,https://www.intensivregister.de/api/public/reporting/laendertabelle
1616343548,26683,21598,5085,3063,1658,https://www.intensivregister.de/api/public/reporting/laendertabelle
1616347148,26683,21595,5088,3061,1656,https://www.intensivregister.de/api/public/reporting/laendertabelle
1616357948,26683,21595,5088,3062,1657,https://www.intensivregister.de/api/public/reporting/laendertabelle
1616365148,26683,21598,5085,3064,1658,https://www.intensivregister.de/api/public/reporting/laendertabelle
1616368748,26683,21597,5086,3064,1658,https://www.intensivregister.de/api/public/reporting/laendertabelle
1616372348,26683,21596,5087,3064,1658,https://www.intensivregister.de/api/public/reporting/laendertabelle
1616375950,26683,21599,5084,3063,1658,https://www.intensivregister.de/api/public/reporting/laendertabelle
1616379550,26682,21598,5084,3062,1658,https://www.intensivregister.de/api/public/reporting/laendertabelle
1616383150,26683,21599,5084,3064,1658,https://www.intensivregister.de/api/public/reporting/laendertabelle
1616386750,26706,21626,5080,3068,1667,https://www.intensivregister.de/api/public/reporting/laendertabelle
1616390350,26711,21622,5089,3066,1665,https://www.intensivregister.de/api/public/reporting/laendertabelle
1616393950,26741,21699,5042,3070,1668,https://www.intensivregister.de/api/public/reporting/laendertabelle
1616397549,26824,21858,4966,3114,1681,https://www.intensivregister.de/api/public/reporting/laendertabelle
1616401149,26869,21919,4950,3140,1677,https://www.intensivregister.de/api/public/reporting/laendertabelle
1616404749,26874,21947,4927,3142,1678,https://www.intensivregister.de/api/public/reporting/laendertabelle
1616408349,26874,21963,4911,3146,1682,https://www.intensivregister.de/api/public/reporting/laendertabelle
1616411949,26875,21971,4904,3149,1681,https://www.intensivregister.de/api/public/reporting/laendertabelle
1616415552,26871,21967,4904,3142,1680,https://www.intensivregister.de/api/public/reporting/laendertabelle
1616419149,26874,21971,4903,3143,1680,https://www.intensivregister.de/api/public/reporting/laendertabelle
1616422749,26874,21976,4898,3147,1682,https://www.intensivregister.de/api/public/reporting/laendertabelle
1616426349,26774,21912,4862,3147,1681,https://www.intensivregister.de/api/public/reporting/laendertabelle
1616429949,26774,21910,4864,3148,1680,https://www.intensivregister.de/api/public/reporting/laendertabelle
1616433549,26774,21908,4866,3149,1680,https://www.intensivregister.de/api/public/reporting/laendertabelle
1616437149,26774,21911,4863,3149,1680,https://www.intensivregister.de/api/public/reporting/laendertabelle
1616440749,26774,21910,4864,3149,1680,https://www.intensivregister.de/api/public/reporting/laendertabelle
1616447949,26774,21910,4864,3151,1681,https://www.intensivregister.de/api/public/reporting/laendertabelle
1616451549,26774,21920,4854,3151,1681,https://www.intensivregister.de/api/public/reporting/laendertabelle
1616455149,26772,21917,4855,3151,1681,https://www.intensivregister.de/api/public/reporting/laendertabelle
1616458749,26772,21916,4856,3151,1681,https://www.intensivregister.de/api/public/reporting/laendertabelle
1616462350,26771,21919,4852,3151,1681,https://www.intensivregister.de/api/public/reporting/laendertabelle
1616465944,26767,21912,4855,3148,1680,https://www.intensivregister.de/api/public/reporting/laendertabelle
1616469548,26767,21932,4835,3150,1678,https://www.intensivregister.de/api/public/reporting/laendertabelle
1616473152,26785,22000,4785,3154,1686,https://www.intensivregister.de/api/public/reporting/laendertabelle
1616476747,26802,22076,4726,3145,1674,https://www.intensivregister.de/api/public/reporting/laendertabelle
1616480351,26804,22183,4621,3140,1680,https://www.intensivregister.de/api/public/reporting/laendertabelle
1616483945,26840,22369,4471,3149,1685,https://www.intensivregister.de/api/public/reporting/laendertabelle
1616487549,26846,22395,4451,3164,1698,https://www.intensivregister.de/api/public/reporting/laendertabelle
1616491144,26857,22437,4420,3167,1709,https://www.intensivregister.de/api/public/reporting/laendertabelle
1616494748,26857,22451,4406,3173,1708,https://www.intensivregister.de/api/public/reporting/laendertabelle
1616498352,26859,22458,4401,3172,1706,https://www.intensivregister.de/api/public/reporting/laendertabelle
1616501946,26859,22463,4396,3171,1704,https://www.intensivregister.de/api/public/reporting/laendertabelle
1616505550,26860,22463,4397,3170,1703,https://www.intensivregister.de/api/public/reporting/laendertabelle
1616509145,26858,22458,4400,3166,1703,https://www.intensivregister.de/api/public/reporting/laendertabelle
1616512748,26858,22454,4404,3166,1703,https://www.intensivregister.de/api/public/reporting/laendertabelle
1616516352,26858,22451,4407,3165,1703,https://www.intensivregister.de/api/public/reporting/laendertabelle
1616519946,26858,22450,4408,3166,1703,https://www.intensivregister.de/api/public/reporting/laendertabelle
1616523551,26858,22453,4405,3166,1702,https://www.intensivregister.de/api/public/reporting/laendertabelle
1616534352,26858,22451,4407,3168,1703,https://www.intensivregister.de/api/public/reporting/laendertabelle
1616537947,26858,22448,4410,3165,1702,https://www.intensivregister.de/api/public/reporting/laendertabelle
1616541549,26858,22441,4417,3167,1703,https://www.intensivregister.de/api/public/reporting/laendertabelle
1616545143,26858,22440,4418,3167,1703,https://www.intensivregister.de/api/public/reporting/laendertabelle
1616548747,26858,22441,4417,3167,1703,https://www.intensivregister.de/api/public/reporting/laendertabelle
1616552351,26858,22443,4415,3165,1703,https://www.intensivregister.de/api/public/reporting/laendertabelle
1616555945,26860,22446,4414,3162,1704,https://www.intensivregister.de/api/public/reporting/laendertabelle
1616559549,26865,22460,4405,3160,1708,https://www.intensivregister.de/api/public/reporting/laendertabelle
1616563152,26872,22509,4363,3182,1705,https://www.intensivregister.de/api/public/reporting/laendertabelle
1616566746,26886,22527,4359,3194,1712,https://www.intensivregister.de/api/public/reporting/laendertabelle
1616570350,26888,22553,4335,3189,1719,https://www.intensivregister.de/api/public/reporting/laendertabelle
1616573944,26905,22589,4316,3206,1735,https://www.intensivregister.de/api/public/reporting/laendertabelle
1616577548,26909,22597,4312,3201,1733,https://www.intensivregister.de/api/public/reporting/laendertabelle
1616581151,26911,22590,4321,3208,1733,https://www.intensivregister.de/api/public/reporting/laendertabelle
1616584745,26911,22595,4316,3213,1735,https://www.intensivregister.de/api/public/reporting/laendertabelle
1616588349,26911,22592,4319,3214,1736,https://www.intensivregister.de/api/public/reporting/laendertabelle
1616591943,26911,22590,4321,3212,1736,https://www.intensivregister.de/api/public/reporting/laendertabelle
1616595548,26911,22589,4322,3211,1736,https://www.intensivregister.de/api/public/reporting/laendertabelle
1616599151,26914,22590,4324,3213,1736,https://www.intensivregister.de/api/public/reporting/laendertabelle
1616602745,26914,22589,4325,3213,1736,https://www.intensivregister.de/api/public/reporting/laendertabelle
1616606349,26914,22587,4327,3213,1735,https://www.intensivregister.de/api/public/reporting/laendertabelle
1616609943,26914,22588,4326,3214,1735,https://www.intensivregister.de/api/public/reporting/laendertabelle
1616613547,26912,22586,4326,3214,1735,https://www.intensivregister.de/api/public/reporting/laendertabelle
1616617151,26912,22587,4325,3214,1735,https://www.intensivregister.de/api/public/reporting/laendertabelle
1616620744,26912,22585,4327,3214,1735,https://www.intensivregister.de/api/public/reporting/laendertabelle
1616624349,26914,22593,4321,3216,1735,https://www.intensivregister.de/api/public/reporting/laendertabelle
1616627953,26910,22586,4324,3216,1734,https://www.intensivregister.de/api/public/reporting/laendertabelle
1616631547,26909,22586,4323,3216,1734,https://www.intensivregister.de/api/public/reporting/laendertabelle
1616635151,26909,22586,4323,3217,1734,https://www.intensivregister.de/api/public/reporting/laendertabelle
1616638749,26915,22589,4326,3217,1736,https://www.intensivregister.de/api/public/reporting/laendertabelle
1616642345,26913,22580,4333,3212,1737,https://www.intensivregister.de/api/public/reporting/laendertabelle
1616645952,26909,22583,4326,3228,1748,https://www.intensivregister.de/api/public/reporting/laendertabelle
1616649548,26926,22573,4353,3245,1755,https://www.intensivregister.de/api/public/reporting/laendertabelle
1616653145,26917,22617,4300,3257,1755,https://www.intensivregister.de/api/public/reporting/laendertabelle
1616656752,26902,22606,4296,3251,1758,https://www.intensivregister.de/api/public/reporting/laendertabelle
1616660349,26902,22601,4301,3246,1755,https://www.intensivregister.de/api/public/reporting/laendertabelle
1616663945,26893,22612,4281,3261,1760,https://www.intensivregister.de/api/public/reporting/laendertabelle
1616667552,26902,22629,4273,3260,1760,https://www.intensivregister.de/api/public/reporting/laendertabelle
1616671149,26899,22623,4276,3254,1759,https://www.intensivregister.de/api/public/reporting/laendertabelle
1616674748,26899,22617,4282,3256,1759,https://www.intensivregister.de/api/public/reporting/laendertabelle
1616678353,26899,22615,4284,3255,1761,https://www.intensivregister.de/api/public/reporting/laendertabelle
1616681949,26896,22619,4277,3256,1763,https://www.intensivregister.de/api/public/reporting/laendertabelle
1616685546,26896,22617,4279,3257,1763,https://www.intensivregister.de/api/public/reporting/laendertabelle
1616689153,26895,22613,4282,3258,1762,https://www.intensivregister.de/api/public/reporting/laendertabelle
1616696345,26895,22617,4278,3259,1762,https://www.intensivregister.de/api/public/reporting/laendertabelle
1616699952,26895,22615,4280,3258,1762,https://www.intensivregister.de/api/public/reporting/laendertabelle
1616703549,26895,22614,4281,3258,1762,https://www.intensivregister.de/api/public/reporting/laendertabelle
1616707145,26895,22616,4279,3258,1762,https://www.intensivregister.de/api/public/reporting/laendertabelle
1616710752,26895,22608,4287,3258,1762,https://www.intensivregister.de/api/public/reporting/laendertabelle
1616714348,26894,22601,4293,3257,1761,https://www.intensivregister.de/api/public/reporting/laendertabelle
1616717945,26887,22599,4288,3258,1761,https://www.intensivregister.de/api/public/reporting/laendertabelle
1616721551,26888,22600,4288,3258,1761,https://www.intensivregister.de/api/public/reporting/laendertabelle
1616725148,26887,22605,4282,3259,1763,https://www.intensivregister.de/api/public/reporting/laendertabelle
1616728744,26886,22611,4275,3265,1765,https://www.intensivregister.de/api/public/reporting/laendertabelle
1616732351,26891,22603,4288,3252,1758,https://www.intensivregister.de/api/public/reporting/laendertabelle
1616735947,26870,22630,4240,3263,1768,https://www.intensivregister.de/api/public/reporting/laendertabelle
1616739544,26849,22717,4132,3293,1795,https://www.intensivregister.de/api/public/reporting/laendertabelle
1616743151,26834,22689,4145,3299,1800,https://www.intensivregister.de/api/public/reporting/laendertabelle
1616746747,26820,22679,4141,3333,1811,https://www.intensivregister.de/api/public/reporting/laendertabelle
1616750344,26808,22659,4149,3334,1820,https://www.intensivregister.de/api/public/reporting/laendertabelle
1616753951,26808,22665,4143,3334,1822,https://www.intensivregister.de/api/public/reporting/laendertabelle
1616757548,26813,22666,4147,3336,1822,https://www.intensivregister.de/api/public/reporting/laendertabelle
1616761144,26815,22659,4156,3337,1821,https://www.intensivregister.de/api/public/reporting/laendertabelle
1616764751,26811,22665,4146,3338,1821,https://www.intensivregister.de/api/public/reporting/laendertabelle
1616768348,26806,22657,4149,3336,1821,https://www.intensivregister.de/api/public/reporting/laendertabelle
1616771945,26807,22660,4147,3338,1821,https://www.intensivregister.de/api/public/reporting/laendertabelle
1616775551,26807,22660,4147,3339,1822,https://www.intensivregister.de/api/public/reporting/laendertabelle
1616779147,26807,22659,4148,3341,1822,https://www.intensivregister.de/api/public/reporting/laendertabelle
1616782744,26806,22660,4146,3342,1822,https://www.intensivregister.de/api/public/reporting/laendertabelle
1616789947,26806,22662,4144,3344,1822,https://www.intensivregister.de/api/public/reporting/laendertabelle
1616797150,26807,22661,4146,3344,1822,https://www.intensivregister.de/api/public/reporting/laendertabelle
1616800747,26805,22659,4146,3348,1822,https://www.intensivregister.de/api/public/reporting/laendertabelle
1616804343,26803,22656,4147,3349,1823,https://www.intensivregister.de/api/public/reporting/laendertabelle
1616811546,26808,22661,4147,3351,1824,https://www.intensivregister.de/api/public/reporting/laendertabelle
1616815151,26797,22659,4138,3349,1824,https://www.intensivregister.de/api/public/reporting/laendertabelle
1616818746,26793,22651,4142,3359,1830,https://www.intensivregister.de/api/public/reporting/laendertabelle
1616822343,26748,22569,4179,3360,1823,https://www.intensivregister.de/api/public/reporting/laendertabelle
1616825948,26722,22445,4277,3356,1832,https://www.intensivregister.de/api/public/reporting/laendertabelle
1616829544,26694,22427,4267,3369,1847,https://www.intensivregister.de/api/public/reporting/laendertabelle
1616833148,26666,22404,4262,3381,1827,https://www.intensivregister.de/api/public/reporting/laendertabelle
1616836743,26657,22366,4291,3392,1835,https://www.intensivregister.de/api/public/reporting/laendertabelle
1616840349,26657,22370,4287,3391,1835,https://www.intensivregister.de/api/public/reporting/laendertabelle
1616843943,26656,22363,4293,3392,1834,https://www.intensivregister.de/api/public/reporting/laendertabelle
1616847548,26656,22363,4293,3395,1836,https://www.intensivregister.de/api/public/reporting/laendertabelle
1616851144,26656,22363,4293,3394,1836,https://www.intensivregister.de/api/public/reporting/laendertabelle
1616854748,26659,22353,4306,3396,1837,https://www.intensivregister.de/api/public/reporting/laendertabelle
1616858343,26661,22353,4308,3397,1837,https://www.intensivregister.de/api/public/reporting/laendertabelle
1616861951,26661,22348,4313,3397,1838,https://www.intensivregister.de/api/public/reporting/laendertabelle
1616865552,26661,22347,4314,3395,1838,https://www.intensivregister.de/api/public/reporting/laendertabelle
1616869148,26661,22346,4315,3395,1839,https://www.intensivregister.de/api/public/reporting/laendertabelle
1616879952,26661,22348,4313,3395,1839,https://www.intensivregister.de/api/public/reporting/laendertabelle
1616883547,26659,22325,4334,3393,1839,https://www.intensivregister.de/api/public/reporting/laendertabelle
1616887152,26656,22315,4341,3394,1839,https://www.intensivregister.de/api/public/reporting/laendertabelle
1616890747,26658,22319,4339,3394,1840,https://www.intensivregister.de/api/public/reporting/laendertabelle
1616894352,26656,22320,4336,3393,1839,https://www.intensivregister.de/api/public/reporting/laendertabelle
1616894347,26654,22312,4342,3393,1840,https://www.intensivregister.de/api/public/reporting/laendertabelle
1616897952,26654,22291,4363,3399,1841,https://www.intensivregister.de/api/public/reporting/laendertabelle
1616901547,26638,22211,4427,3410,1854,https://www.intensivregister.de/api/public/reporting/laendertabelle
1616905152,26618,22098,4520,3424,1865,https://www.intensivregister.de/api/public/reporting/laendertabelle
1616908747,26593,21960,4633,3446,1886,https://www.intensivregister.de/api/public/reporting/laendertabelle
1616912352,26572,21843,4729,3454,1876,https://www.intensivregister.de/api/public/reporting/laendertabelle
1616915946,26565,21816,4749,3458,1873,https://www.intensivregister.de/api/public/reporting/laendertabelle
1616919551,26558,21809,4749,3459,1872,https://www.intensivregister.de/api/public/reporting/laendertabelle
1616923146,26541,21793,4748,3458,1873,https://www.intensivregister.de/api/public/reporting/laendertabelle
1616926752,26538,21791,4747,3459,1874,https://www.intensivregister.de/api/public/reporting/laendertabelle
1616930347,26538,21790,4748,3459,1875,https://www.intensivregister.de/api/public/reporting/laendertabelle
1616933952,26534,21786,4748,3459,1875,https://www.intensivregister.de/api/public/reporting/laendertabelle
1616941152,26533,21786,4747,3459,1872,https://www.intensivregister.de/api/public/reporting/laendertabelle
1616944747,26527,21772,4755,3458,1872,https://www.intensivregister.de/api/public/reporting/laendertabelle
1616948352,26527,21771,4756,3458,1872,https://www.intensivregister.de/api/public/reporting/laendertabelle
1616951946,26527,21771,4756,3456,1871,https://www.intensivregister.de/api/public/reporting/laendertabelle
1616955551,26527,21770,4757,3459,1871,https://www.intensivregister.de/api/public/reporting/laendertabelle
1616959146,26529,21770,4759,3459,1871,https://www.intensivregister.de/api/public/reporting/laendertabelle
1616962751,26538,21792,4746,3455,1871,https://www.intensivregister.de/api/public/reporting/laendertabelle
1616966346,26538,21793,4745,3455,1872,https://www.intensivregister.de/api/public/reporting/laendertabelle
1616973546,26538,21794,4744,3455,1872,https://www.intensivregister.de/api/public/reporting/laendertabelle
1616977151,26532,21795,4737,3460,1874,https://www.intensivregister.de/api/public/reporting/laendertabelle
1616984351,26557,21776,4781,3462,1872,https://www.intensivregister.de/api/public/reporting/laendertabelle
1616987946,26614,21842,4772,3490,1921,https://www.intensivregister.de/api/public/reporting/laendertabelle
1616991552,26659,21879,4780,3527,1936,https://www.intensivregister.de/api/public/reporting/laendertabelle
1616995147,26690,21938,4752,3550,1937,https://www.intensivregister.de/api/public/reporting/laendertabelle
1616998752,26693,21963,4730,3569,1941,https://www.intensivregister.de/api/public/reporting/laendertabelle
1617002348,26715,21979,4736,3574,1961,https://www.intensivregister.de/api/public/reporting/laendertabelle
1617005943,26722,21983,4739,3573,1961,https://www.intensivregister.de/api/public/reporting/laendertabelle
1617009548,26722,21992,4730,3575,1962,https://www.intensivregister.de/api/public/reporting/laendertabelle
1617013143,26721,21995,4726,3576,1963,https://www.intensivregister.de/api/public/reporting/laendertabelle
1617016748,26723,21998,4725,3575,1963,https://www.intensivregister.de/api/public/reporting/laendertabelle
1617020344,26723,21995,4728,3575,1963,https://www.intensivregister.de/api/public/reporting/laendertabelle
1617023949,26723,21995,4728,3577,1963,https://www.intensivregister.de/api/public/reporting/laendertabelle
1617027544,26724,21997,4727,3578,1963,https://www.intensivregister.de/api/public/reporting/laendertabelle
1617031150,26725,22002,4723,3578,1963,https://www.intensivregister.de/api/public/reporting/laendertabelle
1617034745,26726,22002,4724,3578,1963,https://www.intensivregister.de/api/public/reporting/laendertabelle
1617038350,26724,22004,4720,3581,1964,https://www.intensivregister.de/api/public/reporting/laendertabelle
1617041946,26724,22005,4719,3581,1964,https://www.intensivregister.de/api/public/reporting/laendertabelle
1617049146,26724,22002,4722,3580,1962,https://www.intensivregister.de/api/public/reporting/laendertabelle
1617052751,26724,21999,4725,3580,1962,https://www.intensivregister.de/api/public/reporting/laendertabelle
1617056347,26722,22007,4715,3580,1962,https://www.intensivregister.de/api/public/reporting/laendertabelle
1617059952,26722,22008,4714,3581,1962,https://www.intensivregister.de/api/public/reporting/laendertabelle
1617063547,26722,22005,4717,3581,1962,https://www.intensivregister.de/api/public/reporting/laendertabelle
1617067153,26726,22017,4709,3586,1968,https://www.intensivregister.de/api/public/reporting/laendertabelle
1617070748,26745,22091,4654,3588,1953,https://www.intensivregister.de/api/public/reporting/laendertabelle
1617074343,26779,22210,4569,3590,1953,https://www.intensivregister.de/api/public/reporting/laendertabelle
1617077948,26785,22302,4483,3602,1975,https://www.intensivregister.de/api/public/reporting/laendertabelle
1617081544,26819,22392,4427,3608,1981,https://www.intensivregister.de/api/public/reporting/laendertabelle
1617085149,26810,22426,4384,3599,1985,https://www.intensivregister.de/api/public/reporting/laendertabelle
1617088745,26818,22435,4383,3594,1980,https://www.intensivregister.de/api/public/reporting/laendertabelle
1617092350,26836,22431,4405,3598,1980,https://www.intensivregister.de/api/public/reporting/laendertabelle
1617095945,26834,22434,4400,3597,1980,https://www.intensivregister.de/api/public/reporting/laendertabelle
1617099550,26838,22434,4404,3598,1983,https://www.intensivregister.de/api/public/reporting/laendertabelle
1617103146,26835,22431,4404,3598,1983,https://www.intensivregister.de/api/public/reporting/laendertabelle
1617106751,26840,22435,4405,3599,1983,https://www.intensivregister.de/api/public/reporting/laendertabelle
1617110346,26840,22443,4397,3606,1991,https://www.intensivregister.de/api/public/reporting/laendertabelle
1617113951,26840,22443,4397,3607,1991,https://www.intensivregister.de/api/public/reporting/laendertabelle
1617117546,26840,22442,4398,3606,1991,https://www.intensivregister.de/api/public/reporting/laendertabelle
1617121152,26842,22446,4396,3606,1991,https://www.intensivregister.de/api/public/reporting/laendertabelle
1617124747,26843,22450,4393,3607,1988,https://www.intensivregister.de/api/public/reporting/laendertabelle
1617128352,26843,22449,4394,3607,1987,https://www.intensivregister.de/api/public/reporting/laendertabelle
1617131947,26843,22450,4393,3606,1986,https://www.intensivregister.de/api/public/reporting/laendertabelle
1617135552,26849,22453,4396,3605,1986,https://www.intensivregister.de/api/public/reporting/laendertabelle
1617139148,26849,22457,4392,3603,1986,https://www.intensivregister.de/api/public/reporting/laendertabelle
1617142743,26847,22457,4390,3603,1986,https://www.intensivregister.de/api/public/reporting/laendertabelle
1617146348,26849,22457,4392,3603,1985,https://www.intensivregister.de/api/public/reporting/laendertabelle
1617149943,26847,22456,4391,3605,1988,https://www.intensivregister.de/api/public/reporting/laendertabelle
1617153548,26851,22456,4395,3605,1988,https://www.intensivregister.de/api/public/reporting/laendertabelle
1617157144,26846,22507,4339,3618,1990,https://www.intensivregister.de/api/public/reporting/laendertabelle
1617160749,26847,22510,4337,3637,1998,https://www.intensivregister.de/api/public/reporting/laendertabelle
1617164344,26843,22547,4296,3654,1987,https://www.intensivregister.de/api/public/reporting/laendertabelle
1617167950,26808,22615,4193,3674,2013,https://www.intensivregister.de/api/public/reporting/laendertabelle
1617171545,26815,22648,4167,3680,2019,https://www.intensivregister.de/api/public/reporting/laendertabelle
1617175151,26808,22653,4155,3680,2026,https://www.intensivregister.de/api/public/reporting/laendertabelle
1617178746,26806,22640,4166,3671,2028,https://www.intensivregister.de/api/public/reporting/laendertabelle
1617182351,26805,22639,4166,3672,2027,https://www.intensivregister.de/api/public/reporting/laendertabelle
1617185947,26806,22640,4166,3674,2029,https://www.intensivregister.de/api/public/reporting/laendertabelle
1617189552,26804,22640,4164,3667,2027,https://www.intensivregister.de/api/public/reporting/laendertabelle
1617193147,26803,22636,4167,3668,2029,https://www.intensivregister.de/api/public/reporting/laendertabelle
1617196752,26803,22640,4163,3670,2031,https://www.intensivregister.de/api/public/reporting/laendertabelle
1617200348,26803,22642,4161,3670,2032,https://www.intensivregister.de/api/public/reporting/laendertabelle
1617203945,26803,22645,4158,3670,2032,https://www.intensivregister.de/api/public/reporting/laendertabelle
1617207548,26803,22644,4159,3670,2032,https://www.intensivregister.de/api/public/reporting/laendertabelle
1617211144,26793,22637,4156,3670,2032,https://www.intensivregister.de/api/public/reporting/laendertabelle
1617218344,26793,22635,4158,3670,2032,https://www.intensivregister.de/api/public/reporting/laendertabelle
1617221949,26756,22601,4155,3670,2031,https://www.intensivregister.de/api/public/reporting/laendertabelle
1617225545,26756,22601,4155,3669,2030,https://www.intensivregister.de/api/public/reporting/laendertabelle
1617229150,26753,22598,4155,3670,2030,https://www.intensivregister.de/api/public/reporting/laendertabelle
1617232745,26753,22590,4163,3670,2030,https://www.intensivregister.de/api/public/reporting/laendertabelle
1617236350,26752,22581,4171,3673,2030,https://www.intensivregister.de/api/public/reporting/laendertabelle
1617239945,26750,22575,4175,3675,2028,https://www.intensivregister.de/api/public/reporting/laendertabelle
1617243551,26738,22567,4171,3681,2031,https://www.intensivregister.de/api/public/reporting/laendertabelle
1617247146,26713,22519,4194,3700,2034,https://www.intensivregister.de/api/public/reporting/laendertabelle
1617250752,26735,22523,4212,3710,2054,https://www.intensivregister.de/api/public/reporting/laendertabelle
1617254347,26713,22499,4214,3721,2058,https://www.intensivregister.de/api/public/reporting/laendertabelle
1617257953,26692,22509,4183,3724,2062,https://www.intensivregister.de/api/public/reporting/laendertabelle
1617261548,26685,22508,4177,3727,2070,https://www.intensivregister.de/api/public/reporting/laendertabelle
1617265143,26688,22518,4170,3731,2074,https://www.intensivregister.de/api/public/reporting/laendertabelle
1617272344,26686,22517,4169,3736,2077,https://www.intensivregister.de/api/public/reporting/laendertabelle
1617275949,26686,22516,4170,3737,2079,https://www.intensivregister.de/api/public/reporting/laendertabelle
1617279544,26686,22515,4171,3738,2079,https://www.intensivregister.de/api/public/reporting/laendertabelle
1617283149,26682,22512,4170,3746,2082,https://www.intensivregister.de/api/public/reporting/laendertabelle
1617286783,26682,22503,4179,3747,2085,https://www.intensivregister.de/api/public/reporting/laendertabelle
1617293945,26682,22503,4179,3748,2086,https://www.intensivregister.de/api/public/reporting/laendertabelle
1617304750,26683,22502,4181,3747,2086,https://www.intensivregister.de/api/public/reporting/laendertabelle
1617308345,26684,22500,4184,3746,2085,https://www.intensivregister.de/api/public/reporting/laendertabelle
1617311950,26684,22501,4183,3746,2085,https://www.intensivregister.de/api/public/reporting/laendertabelle
1617315545,26684,22495,4189,3747,2085,https://www.intensivregister.de/api/public/reporting/laendertabelle
1617319150,26683,22494,4189,3746,2085,https://www.intensivregister.de/api/public/reporting/laendertabelle
1617322745,26685,22491,4194,3748,2089,https://www.intensivregister.de/api/public/reporting/laendertabelle
1617326350,26686,22498,4188,3748,2092,https://www.intensivregister.de/api/public/reporting/laendertabelle
1617329945,26711,22516,4195,3755,2097,https://www.intensivregister.de/api/public/reporting/laendertabelle
1617333550,26709,22509,4200,3771,2099,https://www.intensivregister.de/api/public/reporting/laendertabelle
1617337145,26658,22368,4290,3798,2109,https://www.intensivregister.de/api/public/reporting/laendertabelle
1617340751,26622,22300,4322,3818,2123,https://www.intensivregister.de/api/public/reporting/laendertabelle
1617344346,26591,22237,4354,3838,2140,https://www.intensivregister.de/api/public/reporting/laendertabelle
1617347951,26597,22202,4395,3850,2151,https://www.intensivregister.de/api/public/reporting/laendertabelle
1617351546,26595,22185,4410,3847,2150,https://www.intensivregister.de/api/public/reporting/laendertabelle
1617355151,26595,22183,4412,3850,2150,https://www.intensivregister.de/api/public/reporting/laendertabelle
1617358747,26593,22182,4411,3854,2150,https://www.intensivregister.de/api/public/reporting/laendertabelle
1617362352,26593,22181,4412,3853,2149,https://www.intensivregister.de/api/public/reporting/laendertabelle
1617365947,26594,22176,4418,3852,2148,https://www.intensivregister.de/api/public/reporting/laendertabelle
1617369552,26594,22176,4418,3851,2147,https://www.intensivregister.de/api/public/reporting/laendertabelle
1617373147,26594,22176,4418,3852,2147,https://www.intensivregister.de/api/public/reporting/laendertabelle
1617376752,26594,22180,4414,3853,2147,https://www.intensivregister.de/api/public/reporting/laendertabelle
1617380347,26593,22176,4417,3855,2148,https://www.intensivregister.de/api/public/reporting/laendertabelle
1617383952,26593,22175,4418,3854,2147,https://www.intensivregister.de/api/public/reporting/laendertabelle
1617387546,26593,22176,4417,3854,2147,https://www.intensivregister.de/api/public/reporting/laendertabelle
1617394747,26592,22170,4422,3852,2147,https://www.intensivregister.de/api/public/reporting/laendertabelle
1617398352,26590,22170,4420,3855,2147,https://www.intensivregister.de/api/public/reporting/laendertabelle
1617401947,26590,22169,4421,3856,2146,https://www.intensivregister.de/api/public/reporting/laendertabelle
1617405553,26589,22165,4424,3857,2146,https://www.intensivregister.de/api/public/reporting/laendertabelle
1617412752,26589,22158,4431,3860,2147,https://www.intensivregister.de/api/public/reporting/laendertabelle
1617416347,26587,22139,4448,3864,2148,https://www.intensivregister.de/api/public/reporting/laendertabelle
1617419952,26585,22099,4486,3868,2142,https://www.intensivregister.de/api/public/reporting/laendertabelle
1617423547,26561,22013,4548,3885,2155,https://www.intensivregister.de/api/public/reporting/laendertabelle
1617427153,26540,21917,4623,3920,2160,https://www.intensivregister.de/api/public/reporting/laendertabelle
1617430748,26511,21809,4702,3921,2168,https://www.intensivregister.de/api/public/reporting/laendertabelle
1617434343,26503,21731,4772,3917,2170,https://www.intensivregister.de/api/public/reporting/laendertabelle
1617437948,26511,21733,4778,3920,2175,https://www.intensivregister.de/api/public/reporting/laendertabelle
1617441543,26511,21733,4778,3922,2174,https://www.intensivregister.de/api/public/reporting/laendertabelle
1617445148,26512,21734,4778,3923,2173,https://www.intensivregister.de/api/public/reporting/laendertabelle
1617448761,26510,21723,4787,3924,2174,https://www.intensivregister.de/api/public/reporting/laendertabelle
1617452348,26509,21720,4789,3925,2176,https://www.intensivregister.de/api/public/reporting/laendertabelle
1617455943,26509,21719,4790,3925,2176,https://www.intensivregister.de/api/public/reporting/laendertabelle
1617459548,26509,21719,4790,3927,2177,https://www.intensivregister.de/api/public/reporting/laendertabelle
1617463144,26509,21714,4795,3926,2176,https://www.intensivregister.de/api/public/reporting/laendertabelle
1617466749,26509,21711,4798,3928,2179,https://www.intensivregister.de/api/public/reporting/laendertabelle
1617470344,26507,21709,4798,3927,2179,https://www.intensivregister.de/api/public/reporting/laendertabelle
1617473952,26507,21705,4802,3927,2179,https://www.intensivregister.de/api/public/reporting/laendertabelle
1617477543,26507,21703,4804,3924,2180,https://www.intensivregister.de/api/public/reporting/laendertabelle
1617481165,26508,21700,4808,3924,2179,https://www.intensivregister.de/api/public/reporting/laendertabelle
1617484743,26507,21700,4807,3924,2179,https://www.intensivregister.de/api/public/reporting/laendertabelle
1617488348,26505,21700,4805,3923,2178,https://www.intensivregister.de/api/public/reporting/laendertabelle
1617491943,26505,21705,4800,3927,2178,https://www.intensivregister.de/api/public/reporting/laendertabelle
1617495548,26504,21709,4795,3924,2177,https://www.intensivregister.de/api/public/reporting/laendertabelle
1617499143,26503,21706,4797,3922,2175,https://www.intensivregister.de/api/public/reporting/laendertabelle
1617502748,26505,21699,4806,3930,2179,https://www.intensivregister.de/api/public/reporting/laendertabelle
1617506343,26494,21658,4836,3939,2188,https://www.intensivregister.de/api/public/reporting/laendertabelle
1617509948,26497,21663,4834,3982,2203,https://www.intensivregister.de/api/public/reporting/laendertabelle
1617513543,26494,21643,4851,4008,2205,https://www.intensivregister.de/api/public/reporting/laendertabelle
1617517148,26474,21649,4825,4045,2210,https://www.intensivregister.de/api/public/reporting/laendertabelle
1617520743,26468,21672,4796,4052,2220,https://www.intensivregister.de/api/public/reporting/laendertabelle
1617524348,26467,21675,4792,4058,2220,https://www.intensivregister.de/api/public/reporting/laendertabelle
1617527943,26467,21674,4793,4058,2219,https://www.intensivregister.de/api/public/reporting/laendertabelle
1617531548,26467,21675,4792,4059,2219,https://www.intensivregister.de/api/public/reporting/laendertabelle
1617538749,26467,21675,4792,4061,2220,https://www.intensivregister.de/api/public/reporting/laendertabelle
1617542344,26467,21674,4793,4061,2220,https://www.intensivregister.de/api/public/reporting/laendertabelle
1617545949,26467,21673,4794,4060,2219,https://www.intensivregister.de/api/public/reporting/laendertabelle
1617549544,26468,21674,4794,4061,2222,https://www.intensivregister.de/api/public/reporting/laendertabelle
1617553149,26468,21673,4795,4061,2222,https://www.intensivregister.de/api/public/reporting/laendertabelle
1617556744,26468,21675,4793,4062,2223,https://www.intensivregister.de/api/public/reporting/laendertabelle
1617560352,26462,21679,4783,4065,2222,https://www.intensivregister.de/api/public/reporting/laendertabelle
1617567549,26463,21682,4781,4066,2226,https://www.intensivregister.de/api/public/reporting/laendertabelle
1617571144,26447,21667,4780,4065,2226,https://www.intensivregister.de/api/public/reporting/laendertabelle
1617574749,26447,21668,4779,4065,2226,https://www.intensivregister.de/api/public/reporting/laendertabelle
1617578344,26445,21671,4774,4065,2226,https://www.intensivregister.de/api/public/reporting/laendertabelle
1617581950,26445,21669,4776,4065,2226,https://www.intensivregister.de/api/public/reporting/laendertabelle
1617585544,26445,21677,4768,4066,2225,https://www.intensivregister.de/api/public/reporting/laendertabelle
1617589150,26440,21690,4750,4072,2232,https://www.intensivregister.de/api/public/reporting/laendertabelle
1617592745,26425,21691,4734,4090,2241,https://www.intensivregister.de/api/public/reporting/laendertabelle
1617596351,26410,21711,4699,4132,2271,https://www.intensivregister.de/api/public/reporting/laendertabelle
1617599946,26388,21685,4703,4128,2289,https://www.intensivregister.de/api/public/reporting/laendertabelle
1617603552,26377,21716,4661,4141,2299,https://www.intensivregister.de/api/public/reporting/laendertabelle
1617607147,26358,21701,4657,4145,2307,https://www.intensivregister.de/api/public/reporting/laendertabelle
1617610743,26361,21700,4661,4143,2309,https://www.intensivregister.de/api/public/reporting/laendertabelle
1617614348,26365,21707,4658,4149,2313,https://www.intensivregister.de/api/public/reporting/laendertabelle
1617617944,26362,21708,4654,4149,2313,https://www.intensivregister.de/api/public/reporting/laendertabelle
1617621549,26386,21726,4660,4155,2315,https://www.intensivregister.de/api/public/reporting/laendertabelle
1617628749,26389,21726,4663,4158,2319,https://www.intensivregister.de/api/public/reporting/laendertabelle
1617632344,26389,21727,4662,4157,2320,https://www.intensivregister.de/api/public/reporting/laendertabelle
1617635949,26389,21728,4661,4157,2320,https://www.intensivregister.de/api/public/reporting/laendertabelle
1617639545,26393,21732,4661,4157,2317,https://www.intensivregister.de/api/public/reporting/laendertabelle
1617643150,26393,21732,4661,4158,2318,https://www.intensivregister.de/api/public/reporting/laendertabelle
1617650350,26393,21732,4661,4160,2320,https://www.intensivregister.de/api/public/reporting/laendertabelle
1617653945,26390,21731,4659,4160,2320,https://www.intensivregister.de/api/public/reporting/laendertabelle
1617657551,26391,21728,4663,4160,2320,https://www.intensivregister.de/api/public/reporting/laendertabelle
1617661146,26392,21728,4664,4160,2320,https://www.intensivregister.de/api/public/reporting/laendertabelle
1617664751,26392,21730,4662,4161,2319,https://www.intensivregister.de/api/public/reporting/laendertabelle
1617668347,26392,21730,4662,4162,2321,https://www.intensivregister.de/api/public/reporting/laendertabelle
1617671945,26391,21741,4650,4165,2324,https://www.intensivregister.de/api/public/reporting/laendertabelle
1617675551,26394,21745,4649,4171,2326,https://www.intensivregister.de/api/public/reporting/laendertabelle
1617679148,26443,21820,4623,4214,2339,https://www.intensivregister.de/api/public/reporting/laendertabelle
1617682745,26466,21926,4540,4268,2353,https://www.intensivregister.de/api/public/reporting/laendertabelle
1617686352,26496,22128,4368,4295,2371,https://www.intensivregister.de/api/public/reporting/laendertabelle
1617689950,26547,22209,4338,4336,2397,https://www.intensivregister.de/api/public/reporting/laendertabelle
1617693547,26549,22217,4332,4354,2395,https://www.intensivregister.de/api/public/reporting/laendertabelle
1617697144,26555,22237,4318,4355,2398,https://www.intensivregister.de/api/public/reporting/laendertabelle
1617700744,26561,22236,4325,4356,2397,https://www.intensivregister.de/api/public/reporting/laendertabelle
1617704352,26593,22255,4338,4360,2399,https://www.intensivregister.de/api/public/reporting/laendertabelle
1617707948,26591,22259,4332,4363,2401,https://www.intensivregister.de/api/public/reporting/laendertabelle
1617711545,26591,22261,4330,4363,2401,https://www.intensivregister.de/api/public/reporting/laendertabelle
1617715151,26590,22260,4330,4366,2403,https://www.intensivregister.de/api/public/reporting/laendertabelle
1617718748,26590,22263,4327,4369,2404,https://www.intensivregister.de/api/public/reporting/laendertabelle
1617722344,26590,22264,4326,4371,2406,https://www.intensivregister.de/api/public/reporting/laendertabelle
1617729546,26590,22268,4322,4371,2409,https://www.intensivregister.de/api/public/reporting/laendertabelle
1617740345,26594,22276,4318,4368,2409,https://www.intensivregister.de/api/public/reporting/laendertabelle
1617743951,26594,22287,4307,4369,2409,https://www.intensivregister.de/api/public/reporting/laendertabelle
1617747547,26596,22290,4306,4370,2410,https://www.intensivregister.de/api/public/reporting/laendertabelle
1617751143,26596,22291,4305,4370,2410,https://www.intensivregister.de/api/public/reporting/laendertabelle
1617754749,26596,22289,4307,4373,2410,https://www.intensivregister.de/api/public/reporting/laendertabelle
1617758345,26594,22281,4313,4370,2408,https://www.intensivregister.de/api/public/reporting/laendertabelle
1617761951,26609,22310,4299,4363,2410,https://www.intensivregister.de/api/public/reporting/laendertabelle
1617765547,26638,22398,4240,4371,2423,https://www.intensivregister.de/api/public/reporting/laendertabelle
1617769144,26648,22493,4155,4402,2459,https://www.intensivregister.de/api/public/reporting/laendertabelle
1617772752,26649,22561,4088,4426,2471,https://www.intensivregister.de/api/public/reporting/laendertabelle
1617776348,26652,22607,4045,4442,2481,https://www.intensivregister.de/api/public/reporting/laendertabelle
1617779944,26662,22632,4030,4440,2478,https://www.intensivregister.de/api/public/reporting/laendertabelle
1617783551,26664,22636,4028,4437,2476,https://www.intensivregister.de/api/public/reporting/laendertabelle
1617787148,26662,22636,4026,4440,2477,https://www.intensivregister.de/api/public/reporting/laendertabelle
1617790744,26662,22641,4021,4436,2478,https://www.intensivregister.de/api/public/reporting/laendertabelle
1617794350,26661,22648,4013,4434,2475,https://www.intensivregister.de/api/public/reporting/laendertabelle
1617797947,26661,22644,4017,4433,2474,https://www.intensivregister.de/api/public/reporting/laendertabelle
1617797947,26660,22643,4017,4430,2471,https://www.intensivregister.de/api/public/reporting/laendertabelle
1617805151,26660,22643,4017,4431,2471,https://www.intensivregister.de/api/public/reporting/laendertabelle
1617808747,26660,22643,4017,4427,2466,https://www.intensivregister.de/api/public/reporting/laendertabelle
1617812344,26661,22648,4013,4429,2466,https://www.intensivregister.de/api/public/reporting/laendertabelle
1617815952,26662,22651,4011,4429,2466,https://www.intensivregister.de/api/public/reporting/laendertabelle
1617826751,26665,22644,4021,4428,2466,https://www.intensivregister.de/api/public/reporting/laendertabelle
1617830347,26664,22649,4015,4429,2466,https://www.intensivregister.de/api/public/reporting/laendertabelle
1617833943,26668,22657,4011,4427,2467,https://www.intensivregister.de/api/public/reporting/laendertabelle
1617837549,26668,22653,4015,4426,2466,https://www.intensivregister.de/api/public/reporting/laendertabelle
1617841145,26668,22651,4017,4423,2468,https://www.intensivregister.de/api/public/reporting/laendertabelle
1617844751,26666,22636,4030,4417,2472,https://www.intensivregister.de/api/public/reporting/laendertabelle
1617848349,26661,22641,4020,4415,2475,https://www.intensivregister.de/api/public/reporting/laendertabelle
1617851943,26670,22681,3989,4416,2477,https://www.intensivregister.de/api/public/reporting/laendertabelle
1617855549,26677,22724,3953,4437,2488,https://www.intensivregister.de/api/public/reporting/laendertabelle
1617859145,26672,22786,3886,4457,2511,https://www.intensivregister.de/api/public/reporting/laendertabelle
1617862752,26641,22749,3892,4473,2521,https://www.intensivregister.de/api/public/reporting/laendertabelle
1617866348,26635,22745,3890,4474,2529,https://www.intensivregister.de/api/public/reporting/laendertabelle
1617869944,26634,22743,3891,4473,2530,https://www.intensivregister.de/api/public/reporting/laendertabelle
1617873551,26638,22748,3890,4473,2530,https://www.intensivregister.de/api/public/reporting/laendertabelle
1617877147,26623,22747,3876,4475,2536,https://www.intensivregister.de/api/public/reporting/laendertabelle
1617880743,26621,22744,3877,4475,2536,https://www.intensivregister.de/api/public/reporting/laendertabelle
1617884350,26624,22742,3882,4471,2534,https://www.intensivregister.de/api/public/reporting/laendertabelle
1617887946,26624,22736,3888,4471,2531,https://www.intensivregister.de/api/public/reporting/laendertabelle
1617891552,26624,22735,3889,4471,2531,https://www.intensivregister.de/api/public/reporting/laendertabelle
1617895148,26621,22733,3888,4472,2532,https://www.intensivregister.de/api/public/reporting/laendertabelle
1617898744,26622,22731,3891,4471,2532,https://www.intensivregister.de/api/public/reporting/laendertabelle
1617902351,26619,22737,3882,4471,2532,https://www.intensivregister.de/api/public/reporting/laendertabelle
1617905946,26621,22739,3882,4472,2532,https://www.intensivregister.de/api/public/reporting/laendertabelle
1617913149,26620,22735,3885,4473,2532,https://www.intensivregister.de/api/public/reporting/laendertabelle
1617916745,26619,22729,3890,4472,2532,https://www.intensivregister.de/api/public/reporting/laendertabelle
1617920350,26619,22726,3893,4473,2532,https://www.intensivregister.de/api/public/reporting/laendertabelle
1617923947,26620,22722,3898,4473,2532,https://www.intensivregister.de/api/public/reporting/laendertabelle
1617927553,26620,22723,3897,4473,2532,https://www.intensivregister.de/api/public/reporting/laendertabelle
1617931149,26625,22723,3902,4472,2532,https://www.intensivregister.de/api/public/reporting/laendertabelle
1617934745,26620,22699,3921,4473,2536,https://www.intensivregister.de/api/public/reporting/laendertabelle
1617938351,26603,22719,3884,4486,2547,https://www.intensivregister.de/api/public/reporting/laendertabelle
1617941946,26614,22746,3868,4486,2537,https://www.intensivregister.de/api/public/reporting/laendertabelle
1617945543,26606,22729,3877,4476,2532,https://www.intensivregister.de/api/public/reporting/laendertabelle
1617945543,26604,22743,3861,4491,2538,https://www.intensivregister.de/api/public/reporting/laendertabelle
1617949149,26596,22747,3849,4507,2546,https://www.intensivregister.de/api/public/reporting/laendertabelle
1617952746,26591,22772,3819,4515,2550,https://www.intensivregister.de/api/public/reporting/laendertabelle
1617956352,26585,22771,3814,4520,2551,https://www.intensivregister.de/api/public/reporting/laendertabelle
1617959948,26580,22762,3818,4518,2550,https://www.intensivregister.de/api/public/reporting/laendertabelle
1617963545,26578,22758,3820,4521,2550,https://www.intensivregister.de/api/public/reporting/laendertabelle
1617967151,26568,22759,3809,4524,2550,https://www.intensivregister.de/api/public/reporting/laendertabelle
1617970748,26564,22756,3808,4525,2549,https://www.intensivregister.de/api/public/reporting/laendertabelle
1617974344,26563,22756,3807,4526,2549,https://www.intensivregister.de/api/public/reporting/laendertabelle
1617977950,26563,22754,3809,4526,2549,https://www.intensivregister.de/api/public/reporting/laendertabelle
1617985152,26562,22755,3807,4524,2549,https://www.intensivregister.de/api/public/reporting/laendertabelle
1617988748,26563,22756,3807,4524,2550,https://www.intensivregister.de/api/public/reporting/laendertabelle
1617992344,26565,22758,3807,4524,2550,https://www.intensivregister.de/api/public/reporting/laendertabelle
1617999546,26564,22748,3816,4524,2549,https://www.intensivregister.de/api/public/reporting/laendertabelle
1618003151,26563,22744,3819,4526,2550,https://www.intensivregister.de/api/public/reporting/laendertabelle
1618006747,26563,22746,3817,4529,2551,https://www.intensivregister.de/api/public/reporting/laendertabelle
1618010343,26563,22745,3818,4530,2553,https://www.intensivregister.de/api/public/reporting/laendertabelle
1618013949,26563,22746,3817,4531,2553,https://www.intensivregister.de/api/public/reporting/laendertabelle
1618017545,26563,22745,3818,4530,2554,https://www.intensivregister.de/api/public/reporting/laendertabelle
1618021151,26568,22723,3845,4527,2549,https://www.intensivregister.de/api/public/reporting/laendertabelle
1618024746,26542,22677,3865,4519,2549,https://www.intensivregister.de/api/public/reporting/laendertabelle
1618028352,26495,22508,3987,4514,2538,https://www.intensivregister.de/api/public/reporting/laendertabelle
1618031948,26506,22450,4056,4530,2532,https://www.intensivregister.de/api/public/reporting/laendertabelle
1618035544,26511,22460,4051,4531,2530,https://www.intensivregister.de/api/public/reporting/laendertabelle
1618039149,26495,22436,4059,4532,2532,https://www.intensivregister.de/api/public/reporting/laendertabelle
1618042745,26492,22426,4066,4538,2538,https://www.intensivregister.de/api/public/reporting/laendertabelle
1618046352,26492,22418,4074,4542,2542,https://www.intensivregister.de/api/public/reporting/laendertabelle
1618049947,26497,22418,4079,4542,2545,https://www.intensivregister.de/api/public/reporting/laendertabelle
1618053543,26495,22412,4083,4543,2545,https://www.intensivregister.de/api/public/reporting/laendertabelle
1618057149,26493,22408,4085,4543,2545,https://www.intensivregister.de/api/public/reporting/laendertabelle
1618060745,26493,22403,4090,4542,2544,https://www.intensivregister.de/api/public/reporting/laendertabelle
1618064352,26493,22399,4094,4543,2545,https://www.intensivregister.de/api/public/reporting/laendertabelle
1618067948,26493,22397,4096,4543,2545,https://www.intensivregister.de/api/public/reporting/laendertabelle
1618071546,26493,22397,4096,4545,2546,https://www.intensivregister.de/api/public/reporting/laendertabelle
1618078751,26492,22396,4096,4546,2546,https://www.intensivregister.de/api/public/reporting/laendertabelle
1618082347,26492,22396,4096,4552,2545,https://www.intensivregister.de/api/public/reporting/laendertabelle
1618085943,26493,22388,4105,4553,2546,https://www.intensivregister.de/api/public/reporting/laendertabelle
1618089549,26493,22387,4106,4552,2546,https://www.intensivregister.de/api/public/reporting/laendertabelle
1618093144,26493,22387,4106,4553,2547,https://www.intensivregister.de/api/public/reporting/laendertabelle
1618096750,26495,22388,4107,4553,2547,https://www.intensivregister.de/api/public/reporting/laendertabelle
1618100346,26491,22391,4100,4553,2547,https://www.intensivregister.de/api/public/reporting/laendertabelle
1618103952,26489,22388,4101,4560,2551,https://www.intensivregister.de/api/public/reporting/laendertabelle
1618107548,26483,22348,4135,4560,2547,https://www.intensivregister.de/api/public/reporting/laendertabelle
1618111143,26486,22302,4184,4553,2549,https://www.intensivregister.de/api/public/reporting/laendertabelle
1618114749,26489,22258,4231,4572,2589,https://www.intensivregister.de/api/public/reporting/laendertabelle
1618118345,26457,22174,4283,4586,2604,https://www.intensivregister.de/api/public/reporting/laendertabelle
1618121951,26435,22080,4355,4577,2598,https://www.intensivregister.de/api/public/reporting/laendertabelle
1618125547,26431,22069,4362,4585,2604,https://www.intensivregister.de/api/public/reporting/laendertabelle
1618129143,26431,22061,4370,4585,2604,https://www.intensivregister.de/api/public/reporting/laendertabelle
1618132749,26430,22061,4369,4589,2605,https://www.intensivregister.de/api/public/reporting/laendertabelle
1618136345,26432,22057,4375,4592,2605,https://www.intensivregister.de/api/public/reporting/laendertabelle
1618139950,26433,22057,4376,4592,2605,https://www.intensivregister.de/api/public/reporting/laendertabelle
1618143547,26433,22059,4374,4592,2603,https://www.intensivregister.de/api/public/reporting/laendertabelle
1618147152,26433,22053,4380,4591,2603,https://www.intensivregister.de/api/public/reporting/laendertabelle
1618150748,26433,22053,4380,4595,2604,https://www.intensivregister.de/api/public/reporting/laendertabelle
1618154344,26433,22057,4376,4595,2604,https://www.intensivregister.de/api/public/reporting/laendertabelle
1618157950,26435,22055,4380,4599,2607,https://www.intensivregister.de/api/public/reporting/laendertabelle
1618161546,26434,22050,4384,4599,2608,https://www.intensivregister.de/api/public/reporting/laendertabelle
1618165152,26434,22051,4383,4599,2608,https://www.intensivregister.de/api/public/reporting/laendertabelle
1618172344,26433,22051,4382,4600,2609,https://www.intensivregister.de/api/public/reporting/laendertabelle
1618175950,26430,22053,4377,4602,2608,https://www.intensivregister.de/api/public/reporting/laendertabelle
1618183151,26426,22048,4378,4602,2606,https://www.intensivregister.de/api/public/reporting/laendertabelle
1618186747,26428,22052,4376,4600,2606,https://www.intensivregister.de/api/public/reporting/laendertabelle
1618190343,26429,22061,4368,4599,2609,https://www.intensivregister.de/api/public/reporting/laendertabelle
1618193949,26451,22064,4387,4598,2601,https://www.intensivregister.de/api/public/reporting/laendertabelle
1618197545,26496,22157,4339,4617,2618,https://www.intensivregister.de/api/public/reporting/laendertabelle
1618201152,26531,22265,4266,4638,2637,https://www.intensivregister.de/api/public/reporting/laendertabelle
1618204748,26568,22314,4254,4639,2639,https://www.intensivregister.de/api/public/reporting/laendertabelle
1618208344,26596,22360,4236,4655,2649,https://www.intensivregister.de/api/public/reporting/laendertabelle
1618211951,26603,22366,4237,4661,2662,https://www.intensivregister.de/api/public/reporting/laendertabelle
1618215547,26604,22375,4229,4666,2662,https://www.intensivregister.de/api/public/reporting/laendertabelle
1618219144,26606,22383,4223,4667,2662,https://www.intensivregister.de/api/public/reporting/laendertabelle
1618222750,26606,22376,4230,4666,2664,https://www.intensivregister.de/api/public/reporting/laendertabelle
1618226346,26608,22378,4230,4665,2660,https://www.intensivregister.de/api/public/reporting/laendertabelle
1618229952,26608,22377,4231,4670,2660,https://www.intensivregister.de/api/public/reporting/laendertabelle
1618233549,26608,22378,4230,4671,2661,https://www.intensivregister.de/api/public/reporting/laendertabelle
1618237145,26608,22380,4228,4670,2660,https://www.intensivregister.de/api/public/reporting/laendertabelle
1618240751,26608,22383,4225,4673,2663,https://www.intensivregister.de/api/public/reporting/laendertabelle
1618244350,26609,22384,4225,4674,2662,https://www.intensivregister.de/api/public/reporting/laendertabelle
1618247944,26608,22382,4226,4674,2663,https://www.intensivregister.de/api/public/reporting/laendertabelle
1618258752,26610,22394,4216,4673,2664,https://www.intensivregister.de/api/public/reporting/laendertabelle
1618262348,26614,22397,4217,4673,2664,https://www.intensivregister.de/api/public/reporting/laendertabelle
1618265944,26616,22397,4219,4672,2666,https://www.intensivregister.de/api/public/reporting/laendertabelle
1618269550,26614,22399,4215,4673,2666,https://www.intensivregister.de/api/public/reporting/laendertabelle
1618273146,26607,22397,4210,4674,2668,https://www.intensivregister.de/api/public/reporting/laendertabelle
1618276753,26614,22409,4205,4673,2669,https://www.intensivregister.de/api/public/reporting/laendertabelle
1618280348,26636,22526,4110,4676,2677,https://www.intensivregister.de/api/public/reporting/laendertabelle
1618283944,26676,22638,4038,4686,2690,https://www.intensivregister.de/api/public/reporting/laendertabelle
1618287550,26680,22707,3973,4680,2686,https://www.intensivregister.de/api/public/reporting/laendertabelle
1618291147,26713,22822,3891,4683,2675,https://www.intensivregister.de/api/public/reporting/laendertabelle
1618294743,26710,22869,3841,4690,2675,https://www.intensivregister.de/api/public/reporting/laendertabelle
1618298350,26727,22913,3814,4688,2666,https://www.intensivregister.de/api/public/reporting/laendertabelle
1618301947,26723,22915,3808,4688,2670,https://www.intensivregister.de/api/public/reporting/laendertabelle
1618306688,26721,22920,3801,4688,2670,https://www.intensivregister.de/api/public/reporting/laendertabelle
1618309150,26696,22910,3786,4688,2671,https://www.intensivregister.de/api/public/reporting/laendertabelle
1618312746,26699,22914,3785,4691,2672,https://www.intensivregister.de/api/public/reporting/laendertabelle
1618316353,26699,22911,3788,4690,2672,https://www.intensivregister.de/api/public/reporting/laendertabelle
1618319949,26699,22912,3787,4690,2672,https://www.intensivregister.de/api/public/reporting/laendertabelle
1618323546,26699,22916,3783,4694,2674,https://www.intensivregister.de/api/public/reporting/laendertabelle
1618327152,26699,22917,3782,4693,2672,https://www.intensivregister.de/api/public/reporting/laendertabelle
1618330748,26701,22917,3784,4695,2672,https://www.intensivregister.de/api/public/reporting/laendertabelle
1618337950,26701,22916,3785,4696,2673,https://www.intensivregister.de/api/public/reporting/laendertabelle
1618375735,26697,22935,3762,4692,2624,https://www.intensivregister.de/api/public/reporting/laendertabelle
1618377547,26688,22934,3754,4682,2635,https://www.intensivregister.de/api/public/reporting/laendertabelle
1618381144,26712,22943,3769,4678,2639,https://www.intensivregister.de/api/public/reporting/laendertabelle
1618384750,26736,22971,3765,4679,2653,https://www.intensivregister.de/api/public/reporting/laendertabelle
1618388346,26736,22967,3769,4677,2649,https://www.intensivregister.de/api/public/reporting/laendertabelle
1618391943,26737,22969,3768,4679,2651,https://www.intensivregister.de/api/public/reporting/laendertabelle
1618395549,26738,22974,3764,4680,2650,https://www.intensivregister.de/api/public/reporting/laendertabelle
1618399146,26738,22979,3759,4679,2649,https://www.intensivregister.de/api/public/reporting/laendertabelle
1618402752,26741,22989,3752,4680,2649,https://www.intensivregister.de/api/public/reporting/laendertabelle
1618406349,26742,22992,3750,4680,2650,https://www.intensivregister.de/api/public/reporting/laendertabelle
1618413551,26742,22992,3750,4681,2651,https://www.intensivregister.de/api/public/reporting/laendertabelle
1618417147,26743,22995,3748,4683,2649,https://www.intensivregister.de/api/public/reporting/laendertabelle
1618424352,26743,22996,3747,4683,2649,https://www.intensivregister.de/api/public/reporting/laendertabelle
1618431552,26742,23007,3735,4684,2650,https://www.intensivregister.de/api/public/reporting/laendertabelle
1618435148,26743,22998,3745,4684,2650,https://www.intensivregister.de/api/public/reporting/laendertabelle
1618438744,26742,23000,3742,4685,2650,https://www.intensivregister.de/api/public/reporting/laendertabelle
1618442350,26739,22997,3742,4684,2650,https://www.intensivregister.de/api/public/reporting/laendertabelle
1618445946,26741,22999,3742,4686,2650,https://www.intensivregister.de/api/public/reporting/laendertabelle
1618449551,26737,23010,3727,4687,2650,https://www.intensivregister.de/api/public/reporting/laendertabelle
1618453148,26731,23009,3722,4686,2651,https://www.intensivregister.de/api/public/reporting/laendertabelle
1618456744,26709,22987,3722,4659,2649,https://www.intensivregister.de/api/public/reporting/laendertabelle
1618460350,26700,22962,3738,4668,2655,https://www.intensivregister.de/api/public/reporting/laendertabelle
1618463947,26719,22936,3783,4685,2666,https://www.intensivregister.de/api/public/reporting/laendertabelle
1618467544,26721,22923,3798,4681,2662,https://www.intensivregister.de/api/public/reporting/laendertabelle
1618471150,26726,22890,3836,4678,2660,https://www.intensivregister.de/api/public/reporting/laendertabelle
1618474747,26724,22889,3835,4685,2667,https://www.intensivregister.de/api/public/reporting/laendertabelle
1618478343,26723,22891,3832,4683,2667,https://www.intensivregister.de/api/public/reporting/laendertabelle
1618481950,26732,22882,3850,4685,2670,https://www.intensivregister.de/api/public/reporting/laendertabelle
1618485546,26735,22886,3849,4687,2672,https://www.intensivregister.de/api/public/reporting/laendertabelle
1618489152,26735,22888,3847,4692,2676,https://www.intensivregister.de/api/public/reporting/laendertabelle
1618492749,26736,22887,3849,4695,2679,https://www.intensivregister.de/api/public/reporting/laendertabelle
1618496345,26736,22889,3847,4695,2679,https://www.intensivregister.de/api/public/reporting/laendertabelle
1618499951,26736,22886,3850,4694,2679,https://www.intensivregister.de/api/public/reporting/laendertabelle
1618503547,26736,22885,3851,4693,2679,https://www.intensivregister.de/api/public/reporting/laendertabelle
1618521548,26736,22889,3847,4696,2680,https://www.intensivregister.de/api/public/reporting/laendertabelle
1618525144,26737,22888,3849,4695,2680,https://www.intensivregister.de/api/public/reporting/laendertabelle
1618528750,26736,22886,3850,4694,2678,https://www.intensivregister.de/api/public/reporting/laendertabelle
1618532346,26734,22885,3849,4695,2680,https://www.intensivregister.de/api/public/reporting/laendertabelle
1618535953,26741,22886,3855,4693,2677,https://www.intensivregister.de/api/public/reporting/laendertabelle
1618539548,26743,22882,3861,4698,2679,https://www.intensivregister.de/api/public/reporting/laendertabelle
1618543144,26734,22872,3862,4695,2694,https://www.intensivregister.de/api/public/reporting/laendertabelle
1618546750,26728,22851,3877,4703,2695,https://www.intensivregister.de/api/public/reporting/laendertabelle
1618550346,26729,22941,3788,4738,2702,https://www.intensivregister.de/api/public/reporting/laendertabelle
1618553943,26712,22927,3785,4748,2703,https://www.intensivregister.de/api/public/reporting/laendertabelle
1618557550,26707,22904,3803,4738,2707,https://www.intensivregister.de/api/public/reporting/laendertabelle
1618561146,26704,22900,3804,4742,2705,https://www.intensivregister.de/api/public/reporting/laendertabelle
1618564753,26702,22879,3823,4742,2702,https://www.intensivregister.de/api/public/reporting/laendertabelle
1618568349,26700,22875,3825,4747,2704,https://www.intensivregister.de/api/public/reporting/laendertabelle
1618571945,26698,22882,3816,4752,2707,https://www.intensivregister.de/api/public/reporting/laendertabelle
1618575551,26698,22885,3813,4749,2706,https://www.intensivregister.de/api/public/reporting/laendertabelle
1618579148,26703,22891,3812,4753,2703,https://www.intensivregister.de/api/public/reporting/laendertabelle
1618582744,26703,22893,3810,4754,2703,https://www.intensivregister.de/api/public/reporting/laendertabelle
1618586350,26704,22895,3809,4754,2705,https://www.intensivregister.de/api/public/reporting/laendertabelle
1618589946,26704,22896,3808,4756,2704,https://www.intensivregister.de/api/public/reporting/laendertabelle
1618604349,26706,22899,3807,4760,2704,https://www.intensivregister.de/api/public/reporting/laendertabelle
1618607945,26706,22895,3811,4759,2703,https://www.intensivregister.de/api/public/reporting/laendertabelle
1618611551,26708,22896,3812,4760,2702,https://www.intensivregister.de/api/public/reporting/laendertabelle
1618615146,26707,22900,3807,4761,2701,https://www.intensivregister.de/api/public/reporting/laendertabelle
1618618753,26704,22898,3806,4761,2701,https://www.intensivregister.de/api/public/reporting/laendertabelle
1618622348,26705,22898,3807,4762,2704,https://www.intensivregister.de/api/public/reporting/laendertabelle
1618625943,26689,22899,3790,4766,2705,https://www.intensivregister.de/api/public/reporting/laendertabelle
1618629549,26667,22819,3848,4762,2706,https://www.intensivregister.de/api/public/reporting/laendertabelle
1618633145,26627,22693,3934,4770,2702,https://www.intensivregister.de/api/public/reporting/laendertabelle
1618636751,26588,22582,4006,4762,2691,https://www.intensivregister.de/api/public/reporting/laendertabelle
1618640346,26570,22550,4020,4764,2689,https://www.intensivregister.de/api/public/reporting/laendertabelle
1618643952,26563,22539,4024,4786,2690,https://www.intensivregister.de/api/public/reporting/laendertabelle
1618647548,26557,22543,4014,4793,2693,https://www.intensivregister.de/api/public/reporting/laendertabelle
1618651143,26549,22542,4007,4794,2692,https://www.intensivregister.de/api/public/reporting/laendertabelle
1618654749,26551,22539,4012,4793,2690,https://www.intensivregister.de/api/public/reporting/laendertabelle
1618658345,26549,22541,4008,4793,2691,https://www.intensivregister.de/api/public/reporting/laendertabelle
1618661951,26547,22536,4011,4801,2698,https://www.intensivregister.de/api/public/reporting/laendertabelle
1618665546,26547,22537,4010,4804,2698,https://www.intensivregister.de/api/public/reporting/laendertabelle
1618669152,26547,22535,4012,4805,2698,https://www.intensivregister.de/api/public/reporting/laendertabelle
1618676344,26548,22533,4015,4803,2698,https://www.intensivregister.de/api/public/reporting/laendertabelle
1618679950,26548,22532,4016,4803,2698,https://www.intensivregister.de/api/public/reporting/laendertabelle
1618690747,26547,22519,4028,4801,2697,https://www.intensivregister.de/api/public/reporting/laendertabelle
1618694352,26547,22517,4030,4801,2697,https://www.intensivregister.de/api/public/reporting/laendertabelle
1618697948,26547,22518,4029,4801,2697,https://www.intensivregister.de/api/public/reporting/laendertabelle
1618701543,26547,22521,4026,4801,2697,https://www.intensivregister.de/api/public/reporting/laendertabelle
1618705151,26544,22512,4032,4799,2697,https://www.intensivregister.de/api/public/reporting/laendertabelle
1618708748,26544,22520,4024,4799,2698,https://www.intensivregister.de/api/public/reporting/laendertabelle
1618712346,26542,22522,4020,4798,2700,https://www.intensivregister.de/api/public/reporting/laendertabelle
1618715943,26521,22448,4073,4799,2691,https://www.intensivregister.de/api/public/reporting/laendertabelle
1618719550,26503,22313,4190,4789,2705,https://www.intensivregister.de/api/public/reporting/laendertabelle
1618723149,26458,22252,4206,4807,2715,https://www.intensivregister.de/api/public/reporting/laendertabelle
1618726744,26421,22181,4240,4835,2722,https://www.intensivregister.de/api/public/reporting/laendertabelle
1618730349,26418,22114,4304,4842,2724,https://www.intensivregister.de/api/public/reporting/laendertabelle
1618733951,26418,22115,4303,4845,2724,https://www.intensivregister.de/api/public/reporting/laendertabelle
1618737550,26418,22115,4303,4846,2723,https://www.intensivregister.de/api/public/reporting/laendertabelle
1618741150,26418,22115,4303,4847,2724,https://www.intensivregister.de/api/public/reporting/laendertabelle
1618744749,26418,22111,4307,4848,2724,https://www.intensivregister.de/api/public/reporting/laendertabelle
1618748348,26418,22113,4305,4849,2724,https://www.intensivregister.de/api/public/reporting/laendertabelle
1618751947,26417,22112,4305,4850,2725,https://www.intensivregister.de/api/public/reporting/laendertabelle
1618755546,26415,22112,4303,4850,2725,https://www.intensivregister.de/api/public/reporting/laendertabelle
1618759145,26415,22116,4299,4852,2728,https://www.intensivregister.de/api/public/reporting/laendertabelle
1618762744,26415,22118,4297,4854,2727,https://www.intensivregister.de/api/public/reporting/laendertabelle
1618766343,26415,22119,4296,4855,2726,https://www.intensivregister.de/api/public/reporting/laendertabelle
1618769952,26415,22120,4295,4856,2726,https://www.intensivregister.de/api/public/reporting/laendertabelle
1618773551,26415,22120,4295,4858,2727,https://www.intensivregister.de/api/public/reporting/laendertabelle
1618777151,26417,22127,4290,4859,2727,https://www.intensivregister.de/api/public/reporting/laendertabelle
1618780749,26417,22118,4299,4860,2727,https://www.intensivregister.de/api/public/reporting/laendertabelle
1618784349,26417,22119,4298,4861,2727,https://www.intensivregister.de/api/public/reporting/laendertabelle
1618787947,26420,22122,4298,4861,2727,https://www.intensivregister.de/api/public/reporting/laendertabelle
1618791546,26413,22114,4299,4862,2726,https://www.intensivregister.de/api/public/reporting/laendertabelle
1618795145,26412,22110,4302,4863,2726,https://www.intensivregister.de/api/public/reporting/laendertabelle
1618798744,26433,22088,4345,4868,2720,https://www.intensivregister.de/api/public/reporting/laendertabelle
1618802343,26471,22183,4288,4901,2740,https://www.intensivregister.de/api/public/reporting/laendertabelle
1618805952,26565,22247,4318,4915,2746,https://www.intensivregister.de/api/public/reporting/laendertabelle
1618809551,26589,22288,4301,4923,2741,https://www.intensivregister.de/api/public/reporting/laendertabelle
1618813151,26603,22340,4263,4930,2736,https://www.intensivregister.de/api/public/reporting/laendertabelle
1618816750,26622,22363,4259,4933,2748,https://www.intensivregister.de/api/public/reporting/laendertabelle
1618820348,26640,22375,4265,4933,2749,https://www.intensivregister.de/api/public/reporting/laendertabelle
1618823948,26640,22371,4269,4931,2749,https://www.intensivregister.de/api/public/reporting/laendertabelle
1618827547,26639,22365,4274,4934,2750,https://www.intensivregister.de/api/public/reporting/laendertabelle
1618831146,26639,22365,4274,4937,2750,https://www.intensivregister.de/api/public/reporting/laendertabelle
1618834745,26647,22374,4273,4934,2750,https://www.intensivregister.de/api/public/reporting/laendertabelle
1618838344,26647,22374,4273,4932,2748,https://www.intensivregister.de/api/public/reporting/laendertabelle
1618841952,26647,22378,4269,4931,2748,https://www.intensivregister.de/api/public/reporting/laendertabelle
1618845551,26647,22374,4273,4929,2747,https://www.intensivregister.de/api/public/reporting/laendertabelle
1618849149,26647,22373,4274,4929,2747,https://www.intensivregister.de/api/public/reporting/laendertabelle
1618856346,26647,22374,4273,4929,2746,https://www.intensivregister.de/api/public/reporting/laendertabelle
1618863543,26646,22377,4269,4934,2746,https://www.intensivregister.de/api/public/reporting/laendertabelle
1618867152,26649,22379,4270,4935,2747,https://www.intensivregister.de/api/public/reporting/laendertabelle
1618870751,26649,22380,4269,4933,2748,https://www.intensivregister.de/api/public/reporting/laendertabelle
1618874349,26649,22377,4272,4937,2750,https://www.intensivregister.de/api/public/reporting/laendertabelle
1618877949,26649,22366,4283,4935,2751,https://www.intensivregister.de/api/public/reporting/laendertabelle
1618881552,26651,22371,4280,4937,2753,https://www.intensivregister.de/api/public/reporting/laendertabelle
1618885147,26666,22472,4194,4931,2768,https://www.intensivregister.de/api/public/reporting/laendertabelle
1618888751,26695,22566,4129,4911,2752,https://www.intensivregister.de/api/public/reporting/laendertabelle
1618892346,26710,22686,4024,4932,2746,https://www.intensivregister.de/api/public/reporting/laendertabelle
1618895950,26711,22798,3913,4932,2736,https://www.intensivregister.de/api/public/reporting/laendertabelle
1618899545,26730,22854,3876,4957,2746,https://www.intensivregister.de/api/public/reporting/laendertabelle
1618903150,26738,22882,3856,4968,2751,https://www.intensivregister.de/api/public/reporting/laendertabelle
1618906745,26735,22885,3850,4966,2748,https://www.intensivregister.de/api/public/reporting/laendertabelle
1618910349,26735,22884,3851,4970,2748,https://www.intensivregister.de/api/public/reporting/laendertabelle
1618913943,26735,22884,3851,4971,2750,https://www.intensivregister.de/api/public/reporting/laendertabelle
1618917548,26734,22881,3853,4974,2753,https://www.intensivregister.de/api/public/reporting/laendertabelle
1618921154,26732,22887,3845,4975,2752,https://www.intensivregister.de/api/public/reporting/laendertabelle
1618924747,26732,22891,3841,4974,2752,https://www.intensivregister.de/api/public/reporting/laendertabelle
1618928351,26732,22892,3840,4973,2751,https://www.intensivregister.de/api/public/reporting/laendertabelle
1618931946,26732,22891,3841,4973,2751,https://www.intensivregister.de/api/public/reporting/laendertabelle
1618949949,26734,22888,3846,4973,2751,https://www.intensivregister.de/api/public/reporting/laendertabelle
1618953543,26735,22885,3850,4972,2749,https://www.intensivregister.de/api/public/reporting/laendertabelle
1618957147,26734,22888,3846,4971,2748,https://www.intensivregister.de/api/public/reporting/laendertabelle
1618960752,26740,22897,3843,4974,2748,https://www.intensivregister.de/api/public/reporting/laendertabelle
1618964346,26740,22900,3840,4976,2749,https://www.intensivregister.de/api/public/reporting/laendertabelle
1618967950,26739,22913,3826,4977,2751,https://www.intensivregister.de/api/public/reporting/laendertabelle
1618971544,26731,22905,3826,4974,2755,https://www.intensivregister.de/api/public/reporting/laendertabelle
1618975148,26714,22925,3789,4960,2744,https://www.intensivregister.de/api/public/reporting/laendertabelle
1618978743,26724,22980,3744,4978,2760,https://www.intensivregister.de/api/public/reporting/laendertabelle
1618982347,26736,22993,3743,4984,2766,https://www.intensivregister.de/api/public/reporting/laendertabelle
1618985952,26735,23009,3726,4983,2769,https://www.intensivregister.de/api/public/reporting/laendertabelle
1618989547,26735,23004,3731,4987,2772,https://www.intensivregister.de/api/public/reporting/laendertabelle
1618993152,26737,23003,3734,4991,2778,https://www.intensivregister.de/api/public/reporting/laendertabelle
1618996746,26737,23000,3737,4997,2780,https://www.intensivregister.de/api/public/reporting/laendertabelle
1619000350,26738,23000,3738,4996,2782,https://www.intensivregister.de/api/public/reporting/laendertabelle
1619003944,26736,22994,3742,4991,2778,https://www.intensivregister.de/api/public/reporting/laendertabelle
1619007548,26737,22999,3738,4995,2781,https://www.intensivregister.de/api/public/reporting/laendertabelle
1619011152,26735,22997,3738,4994,2781,https://www.intensivregister.de/api/public/reporting/laendertabelle
1619014747,26735,23000,3735,4995,2779,https://www.intensivregister.de/api/public/reporting/laendertabelle
1619018350,26735,22997,3738,4996,2779,https://www.intensivregister.de/api/public/reporting/laendertabelle
1619021944,26735,22996,3739,4998,2780,https://www.intensivregister.de/api/public/reporting/laendertabelle
1619025548,26735,22995,3740,4997,2778,https://www.intensivregister.de/api/public/reporting/laendertabelle
1619029152,26735,22995,3740,4998,2779,https://www.intensivregister.de/api/public/reporting/laendertabelle
1619032745,26735,22994,3741,4997,2778,https://www.intensivregister.de/api/public/reporting/laendertabelle
1619036349,26733,22996,3737,4998,2777,https://www.intensivregister.de/api/public/reporting/laendertabelle
1619039943,26733,22990,3743,4999,2778,https://www.intensivregister.de/api/public/reporting/laendertabelle
1619043548,26732,22991,3741,4999,2778,https://www.intensivregister.de/api/public/reporting/laendertabelle
1619047153,26733,22995,3738,5001,2780,https://www.intensivregister.de/api/public/reporting/laendertabelle
1619050747,26733,22988,3745,5002,2780,https://www.intensivregister.de/api/public/reporting/laendertabelle
1619054351,26734,22984,3750,4999,2778,https://www.intensivregister.de/api/public/reporting/laendertabelle
1619057946,26731,22971,3760,4991,2789,https://www.intensivregister.de/api/public/reporting/laendertabelle
1619061551,26738,22976,3762,4990,2799,https://www.intensivregister.de/api/public/reporting/laendertabelle
1619065145,26745,22969,3776,5003,2813,https://www.intensivregister.de/api/public/reporting/laendertabelle
1619068750,26745,22996,3749,5037,2833,https://www.intensivregister.de/api/public/reporting/laendertabelle
1619072344,26750,22999,3751,5044,2849,https://www.intensivregister.de/api/public/reporting/laendertabelle
1619075948,26759,23021,3738,5049,2842,https://www.intensivregister.de/api/public/reporting/laendertabelle
1619079552,26758,23024,3734,5051,2842,https://www.intensivregister.de/api/public/reporting/laendertabelle
1619083146,26760,23026,3734,5053,2842,https://www.intensivregister.de/api/public/reporting/laendertabelle
1619086750,26762,23016,3746,5054,2843,https://www.intensivregister.de/api/public/reporting/laendertabelle
1619090345,26760,23018,3742,5056,2844,https://www.intensivregister.de/api/public/reporting/laendertabelle
1619093949,26757,23009,3748,5049,2844,https://www.intensivregister.de/api/public/reporting/laendertabelle
1619101147,26757,23014,3743,5050,2844,https://www.intensivregister.de/api/public/reporting/laendertabelle
1619104752,26757,23017,3740,5049,2843,https://www.intensivregister.de/api/public/reporting/laendertabelle
1619108346,26757,23019,3738,5050,2843,https://www.intensivregister.de/api/public/reporting/laendertabelle
1619111950,26757,23023,3734,5050,2844,https://www.intensivregister.de/api/public/reporting/laendertabelle
1619122746,26753,23019,3734,5050,2842,https://www.intensivregister.de/api/public/reporting/laendertabelle
1619126352,26753,23015,3738,5050,2842,https://www.intensivregister.de/api/public/reporting/laendertabelle
1619129948,26755,23014,3741,5050,2843,https://www.intensivregister.de/api/public/reporting/laendertabelle
1619133544,26754,23019,3735,5051,2844,https://www.intensivregister.de/api/public/reporting/laendertabelle
1619137150,26751,23016,3735,5054,2844,https://www.intensivregister.de/api/public/reporting/laendertabelle
1619140746,26751,23018,3733,5055,2843,https://www.intensivregister.de/api/public/reporting/laendertabelle
1619144352,26744,23032,3712,5052,2839,https://www.intensivregister.de/api/public/reporting/laendertabelle
1619147947,26752,23058,3694,5057,2851,https://www.intensivregister.de/api/public/reporting/laendertabelle
1619151551,26743,23078,3665,5044,2848,https://www.intensivregister.de/api/public/reporting/laendertabelle
1619155147,26713,23045,3668,5043,2854,https://www.intensivregister.de/api/public/reporting/laendertabelle
1619158752,26719,23018,3701,5052,2846,https://www.intensivregister.de/api/public/reporting/laendertabelle
1619162346,26718,23007,3711,5056,2851,https://www.intensivregister.de/api/public/reporting/laendertabelle
1619165951,26714,23005,3709,5057,2852,https://www.intensivregister.de/api/public/reporting/laendertabelle
1619169546,26712,23007,3705,5054,2853,https://www.intensivregister.de/api/public/reporting/laendertabelle
1619173151,26707,23006,3701,5055,2853,https://www.intensivregister.de/api/public/reporting/laendertabelle
1619176746,26705,22996,3709,5056,2852,https://www.intensivregister.de/api/public/reporting/laendertabelle
1619180351,26704,22985,3719,5057,2855,https://www.intensivregister.de/api/public/reporting/laendertabelle
1619183946,26703,22983,3720,5060,2857,https://www.intensivregister.de/api/public/reporting/laendertabelle
1619187550,26703,22980,3723,5059,2858,https://www.intensivregister.de/api/public/reporting/laendertabelle
1619191145,26703,22983,3720,5062,2860,https://www.intensivregister.de/api/public/reporting/laendertabelle
1619194749,26704,22985,3719,5061,2859,https://www.intensivregister.de/api/public/reporting/laendertabelle
1619198343,26706,22985,3721,5061,2857,https://www.intensivregister.de/api/public/reporting/laendertabelle
1619209146,26706,22983,3723,5062,2856,https://www.intensivregister.de/api/public/reporting/laendertabelle
1619212750,26706,22982,3724,5062,2857,https://www.intensivregister.de/api/public/reporting/laendertabelle
1619216344,26701,22984,3717,5062,2857,https://www.intensivregister.de/api/public/reporting/laendertabelle
1619219949,26701,22977,3724,5062,2857,https://www.intensivregister.de/api/public/reporting/laendertabelle
1619223543,26704,22986,3718,5061,2857,https://www.intensivregister.de/api/public/reporting/laendertabelle
1619227147,26704,22981,3723,5051,2851,https://www.intensivregister.de/api/public/reporting/laendertabelle
1619230752,26705,22991,3714,5043,2842,https://www.intensivregister.de/api/public/reporting/laendertabelle
1619234347,26671,22932,3739,5036,2842,https://www.intensivregister.de/api/public/reporting/laendertabelle
1619237952,26620,22817,3803,5022,2854,https://www.intensivregister.de/api/public/reporting/laendertabelle
1619241547,26584,22771,3813,5019,2878,https://www.intensivregister.de/api/public/reporting/laendertabelle
1619245151,26585,22758,3827,5024,2867,https://www.intensivregister.de/api/public/reporting/laendertabelle
1619248745,26569,22719,3850,5019,2871,https://www.intensivregister.de/api/public/reporting/laendertabelle
1619252349,26570,22708,3862,5017,2868,https://www.intensivregister.de/api/public/reporting/laendertabelle
1619255943,26570,22715,3855,5015,2867,https://www.intensivregister.de/api/public/reporting/laendertabelle
1619259548,26570,22718,3852,5018,2870,https://www.intensivregister.de/api/public/reporting/laendertabelle
1619263152,26567,22714,3853,5017,2870,https://www.intensivregister.de/api/public/reporting/laendertabelle
1619266746,26567,22713,3854,5017,2869,https://www.intensivregister.de/api/public/reporting/laendertabelle
1619277548,26567,22716,3851,5016,2869,https://www.intensivregister.de/api/public/reporting/laendertabelle
1619281152,26567,22716,3851,5017,2870,https://www.intensivregister.de/api/public/reporting/laendertabelle
1619284746,26567,22714,3853,5017,2870,https://www.intensivregister.de/api/public/reporting/laendertabelle
1619291944,26567,22717,3850,5018,2870,https://www.intensivregister.de/api/public/reporting/laendertabelle
1619295549,26570,22719,3851,5021,2871,https://www.intensivregister.de/api/public/reporting/laendertabelle
1619299143,26569,22717,3852,5021,2873,https://www.intensivregister.de/api/public/reporting/laendertabelle
1619302748,26569,22715,3854,5021,2873,https://www.intensivregister.de/api/public/reporting/laendertabelle
1619306343,26569,22717,3852,5025,2877,https://www.intensivregister.de/api/public/reporting/laendertabelle
1619309947,26569,22714,3855,5025,2877,https://www.intensivregister.de/api/public/reporting/laendertabelle
1619313551,26568,22708,3860,5023,2876,https://www.intensivregister.de/api/public/reporting/laendertabelle
1619317145,26558,22680,3878,5032,2882,https://www.intensivregister.de/api/public/reporting/laendertabelle
1619320750,26558,22613,3945,5028,2885,https://www.intensivregister.de/api/public/reporting/laendertabelle
1619324344,26554,22521,4033,5049,2888,https://www.intensivregister.de/api/public/reporting/laendertabelle
1619327949,26534,22468,4066,5048,2887,https://www.intensivregister.de/api/public/reporting/laendertabelle
1619331543,26518,22441,4077,5057,2877,https://www.intensivregister.de/api/public/reporting/laendertabelle
1619335147,26514,22417,4097,5052,2874,https://www.intensivregister.de/api/public/reporting/laendertabelle
1619338751,26515,22420,4095,5052,2872,https://www.intensivregister.de/api/public/reporting/laendertabelle
1619342345,26511,22413,4098,5053,2870,https://www.intensivregister.de/api/public/reporting/laendertabelle
1619345949,26511,22411,4100,5052,2869,https://www.intensivregister.de/api/public/reporting/laendertabelle
1619349543,26511,22414,4097,5052,2869,https://www.intensivregister.de/api/public/reporting/laendertabelle
1619353147,26511,22415,4096,5053,2869,https://www.intensivregister.de/api/public/reporting/laendertabelle
1619356752,26511,22413,4098,5053,2869,https://www.intensivregister.de/api/public/reporting/laendertabelle
1619360345,26511,22416,4095,5054,2869,https://www.intensivregister.de/api/public/reporting/laendertabelle
1619363949,26515,22419,4096,5054,2874,https://www.intensivregister.de/api/public/reporting/laendertabelle
1619367543,26515,22416,4099,5055,2875,https://www.intensivregister.de/api/public/reporting/laendertabelle
1619371148,26515,22417,4098,5056,2876,https://www.intensivregister.de/api/public/reporting/laendertabelle
1619374743,26514,22416,4098,5058,2876,https://www.intensivregister.de/api/public/reporting/laendertabelle
1619381944,26513,22412,4101,5063,2877,https://www.intensivregister.de/api/public/reporting/laendertabelle
1619385553,26513,22408,4105,5063,2879,https://www.intensivregister.de/api/public/reporting/laendertabelle
1619389146,26513,22405,4108,5063,2878,https://www.intensivregister.de/api/public/reporting/laendertabelle
1619392752,26513,22406,4107,5063,2878,https://www.intensivregister.de/api/public/reporting/laendertabelle
1619396348,26514,22407,4107,5063,2879,https://www.intensivregister.de/api/public/reporting/laendertabelle
1619399943,26516,22407,4109,5064,2877,https://www.intensivregister.de/api/public/reporting/laendertabelle
1619403549,26537,22456,4081,5081,2886,https://www.intensivregister.de/api/public/reporting/laendertabelle
1619407145,26579,22513,4066,5086,2893,https://www.intensivregister.de/api/public/reporting/laendertabelle
1619410750,26632,22561,4071,5091,2896,https://www.intensivregister.de/api/public/reporting/laendertabelle
1619414345,26636,22595,4041,5117,2892,https://www.intensivregister.de/api/public/reporting/laendertabelle
1619417950,26665,22604,4061,5115,2896,https://www.intensivregister.de/api/public/reporting/laendertabelle
1619421546,26670,22633,4037,5121,2904,https://www.intensivregister.de/api/public/reporting/laendertabelle
1619425151,26676,22634,4042,5123,2906,https://www.intensivregister.de/api/public/reporting/laendertabelle
1619428747,26684,22639,4045,5126,2909,https://www.intensivregister.de/api/public/reporting/laendertabelle
1619432352,26680,22640,4040,5127,2909,https://www.intensivregister.de/api/public/reporting/laendertabelle
1619435947,26679,22640,4039,5128,2909,https://www.intensivregister.de/api/public/reporting/laendertabelle
1619439543,26679,22635,4044,5128,2908,https://www.intensivregister.de/api/public/reporting/laendertabelle
1619443148,26679,22634,4045,5127,2907,https://www.intensivregister.de/api/public/reporting/laendertabelle
1619446743,26679,22637,4042,5127,2908,https://www.intensivregister.de/api/public/reporting/laendertabelle
1619450348,26679,22637,4042,5128,2909,https://www.intensivregister.de/api/public/reporting/laendertabelle
1619453952,26680,22637,4043,5129,2910,https://www.intensivregister.de/api/public/reporting/laendertabelle
1619457547,26680,22636,4044,5130,2910,https://www.intensivregister.de/api/public/reporting/laendertabelle
1619464747,26680,22636,4044,5129,2909,https://www.intensivregister.de/api/public/reporting/laendertabelle
1619468343,26681,22638,4043,5129,2909,https://www.intensivregister.de/api/public/reporting/laendertabelle
1619471948,26682,22644,4038,5134,2911,https://www.intensivregister.de/api/public/reporting/laendertabelle
1619475543,26682,22648,4034,5133,2911,https://www.intensivregister.de/api/public/reporting/laendertabelle
1619479149,26682,22651,4031,5131,2910,https://www.intensivregister.de/api/public/reporting/laendertabelle
1619482744,26682,22650,4032,5129,2911,https://www.intensivregister.de/api/public/reporting/laendertabelle
1619486349,26687,22666,4021,5131,2907,https://www.intensivregister.de/api/public/reporting/laendertabelle
1619489945,26687,22675,4012,5113,2894,https://www.intensivregister.de/api/public/reporting/laendertabelle
1619493550,26698,22743,3955,5100,2893,https://www.intensivregister.de/api/public/reporting/laendertabelle
1619497145,26735,22822,3913,5085,2891,https://www.intensivregister.de/api/public/reporting/laendertabelle
1619500750,26747,22944,3803,5065,2871,https://www.intensivregister.de/api/public/reporting/laendertabelle
1619504345,26722,22955,3767,5075,2879,https://www.intensivregister.de/api/public/reporting/laendertabelle
1619507950,26717,22959,3758,5062,2873,https://www.intensivregister.de/api/public/reporting/laendertabelle
1619511545,26720,22963,3757,5064,2874,https://www.intensivregister.de/api/public/reporting/laendertabelle
1619515150,26731,22964,3767,5063,2872,https://www.intensivregister.de/api/public/reporting/laendertabelle
1619518745,26729,22967,3762,5064,2872,https://www.intensivregister.de/api/public/reporting/laendertabelle
1619522350,26733,22971,3762,5063,2875,https://www.intensivregister.de/api/public/reporting/laendertabelle
1619525944,26733,22971,3762,5059,2873,https://www.intensivregister.de/api/public/reporting/laendertabelle
1619529550,26736,22967,3769,5056,2870,https://www.intensivregister.de/api/public/reporting/laendertabelle
1619533148,26738,22968,3770,5057,2872,https://www.intensivregister.de/api/public/reporting/laendertabelle
1619536755,26738,22966,3772,5057,2872,https://www.intensivregister.de/api/public/reporting/laendertabelle
1619540348,26738,22966,3772,5058,2872,https://www.intensivregister.de/api/public/reporting/laendertabelle
1619543953,26738,22974,3764,5059,2872,https://www.intensivregister.de/api/public/reporting/laendertabelle
1619547548,26738,22975,3763,5060,2870,https://www.intensivregister.de/api/public/reporting/laendertabelle
1619551143,26738,22975,3763,5061,2870,https://www.intensivregister.de/api/public/reporting/laendertabelle
1619554751,26738,22969,3769,5061,2870,https://www.intensivregister.de/api/public/reporting/laendertabelle
1619558345,26738,22975,3763,5061,2870,https://www.intensivregister.de/api/public/reporting/laendertabelle
1619561950,26738,22972,3766,5061,2870,https://www.intensivregister.de/api/public/reporting/laendertabelle
1619565545,26737,22975,3762,5062,2870,https://www.intensivregister.de/api/public/reporting/laendertabelle
1619569149,26739,22978,3761,5059,2873,https://www.intensivregister.de/api/public/reporting/laendertabelle
1619572744,26737,22983,3754,5060,2874,https://www.intensivregister.de/api/public/reporting/laendertabelle
1619576348,26726,22984,3742,5051,2877,https://www.intensivregister.de/api/public/reporting/laendertabelle
1619579953,26735,23075,3660,5038,2867,https://www.intensivregister.de/api/public/reporting/laendertabelle
1619583547,26729,23099,3630,5052,2877,https://www.intensivregister.de/api/public/reporting/laendertabelle
1619587152,26741,23147,3594,5056,2873,https://www.intensivregister.de/api/public/reporting/laendertabelle
1619590745,26742,23121,3621,5046,2874,https://www.intensivregister.de/api/public/reporting/laendertabelle
1619594350,26737,23120,3617,5049,2876,https://www.intensivregister.de/api/public/reporting/laendertabelle
1619597945,26737,23115,3622,5048,2876,https://www.intensivregister.de/api/public/reporting/laendertabelle
1619601550,26735,23124,3611,5052,2879,https://www.intensivregister.de/api/public/reporting/laendertabelle
1619605144,26736,23132,3604,5054,2882,https://www.intensivregister.de/api/public/reporting/laendertabelle
1619608748,26734,23138,3596,5055,2882,https://www.intensivregister.de/api/public/reporting/laendertabelle
1619612343,26735,23142,3593,5056,2883,https://www.intensivregister.de/api/public/reporting/laendertabelle
1619615950,26737,23142,3595,5056,2883,https://www.intensivregister.de/api/public/reporting/laendertabelle
1619619543,26737,23143,3594,5056,2883,https://www.intensivregister.de/api/public/reporting/laendertabelle
1619623148,26737,23144,3593,5057,2883,https://www.intensivregister.de/api/public/reporting/laendertabelle
1619626752,26737,23143,3594,5058,2886,https://www.intensivregister.de/api/public/reporting/laendertabelle
1619630347,26738,23141,3597,5056,2884,https://www.intensivregister.de/api/public/reporting/laendertabelle
1619641152,26738,23140,3598,5056,2884,https://www.intensivregister.de/api/public/reporting/laendertabelle
1619644747,26741,23143,3598,5055,2883,https://www.intensivregister.de/api/public/reporting/laendertabelle
1619648355,26741,23143,3598,5056,2884,https://www.intensivregister.de/api/public/reporting/laendertabelle
1619651946,26741,23143,3598,5058,2884,https://www.intensivregister.de/api/public/reporting/laendertabelle
1619655551,26747,23148,3599,5060,2882,https://www.intensivregister.de/api/public/reporting/laendertabelle
1619659146,26738,23138,3600,5056,2882,https://www.intensivregister.de/api/public/reporting/laendertabelle
1619662751,26745,23125,3620,5048,2880,https://www.intensivregister.de/api/public/reporting/laendertabelle
1619666345,26755,23120,3635,5037,2889,https://www.intensivregister.de/api/public/reporting/laendertabelle
1619669950,26784,23090,3694,5040,2900,https://www.intensivregister.de/api/public/reporting/laendertabelle
1619673544,26793,23112,3681,5040,2903,https://www.intensivregister.de/api/public/reporting/laendertabelle
1619677149,26793,23142,3651,5034,2917,https://www.intensivregister.de/api/public/reporting/laendertabelle
1619680744,26796,23134,3662,5027,2920,https://www.intensivregister.de/api/public/reporting/laendertabelle
1619684349,26795,23139,3656,5029,2918,https://www.intensivregister.de/api/public/reporting/laendertabelle
1619687943,26812,23151,3661,5032,2922,https://www.intensivregister.de/api/public/reporting/laendertabelle
1619691549,26808,23147,3661,5031,2922,https://www.intensivregister.de/api/public/reporting/laendertabelle
1619695143,26808,23155,3653,5035,2923,https://www.intensivregister.de/api/public/reporting/laendertabelle
1619698748,26808,23148,3660,5035,2923,https://www.intensivregister.de/api/public/reporting/laendertabelle
1619709552,26809,23148,3661,5037,2924,https://www.intensivregister.de/api/public/reporting/laendertabelle
1619713146,26809,23152,3657,5037,2924,https://www.intensivregister.de/api/public/reporting/laendertabelle
1619716750,26809,23148,3661,5037,2924,https://www.intensivregister.de/api/public/reporting/laendertabelle
1619720344,26806,23148,3658,5037,2924,https://www.intensivregister.de/api/public/reporting/laendertabelle
1619723949,26806,23150,3656,5037,2924,https://www.intensivregister.de/api/public/reporting/laendertabelle
1619727544,26802,23149,3653,5039,2923,https://www.intensivregister.de/api/public/reporting/laendertabelle
1619731149,26801,23141,3660,5039,2923,https://www.intensivregister.de/api/public/reporting/laendertabelle
1619734744,26801,23143,3658,5040,2924,https://www.intensivregister.de/api/public/reporting/laendertabelle
1619738348,26801,23146,3655,5041,2924,https://www.intensivregister.de/api/public/reporting/laendertabelle
1619741943,26802,23145,3657,5039,2924,https://www.intensivregister.de/api/public/reporting/laendertabelle
1619745547,26804,23151,3653,5043,2926,https://www.intensivregister.de/api/public/reporting/laendertabelle
1619749152,26803,23159,3644,5040,2923,https://www.intensivregister.de/api/public/reporting/laendertabelle
1619752747,26785,23154,3631,5032,2922,https://www.intensivregister.de/api/public/reporting/laendertabelle
1619756351,26798,23179,3619,5010,2914,https://www.intensivregister.de/api/public/reporting/laendertabelle
1619759945,26793,23198,3595,5038,2917,https://www.intensivregister.de/api/public/reporting/laendertabelle
1619763550,26800,23204,3596,5018,2919,https://www.intensivregister.de/api/public/reporting/laendertabelle
1619767144,26775,23186,3589,5017,2918,https://www.intensivregister.de/api/public/reporting/laendertabelle
1619770749,26776,23181,3595,5019,2920,https://www.intensivregister.de/api/public/reporting/laendertabelle
1619774343,26773,23183,3590,5021,2922,https://www.intensivregister.de/api/public/reporting/laendertabelle
1619777948,26768,23184,3584,5022,2923,https://www.intensivregister.de/api/public/reporting/laendertabelle
1619781553,26766,23184,3582,5021,2923,https://www.intensivregister.de/api/public/reporting/laendertabelle
1619785147,26777,23195,3582,5030,2922,https://www.intensivregister.de/api/public/reporting/laendertabelle
1619788752,26777,23193,3584,5027,2922,https://www.intensivregister.de/api/public/reporting/laendertabelle
1619792347,26777,23193,3584,5028,2924,https://www.intensivregister.de/api/public/reporting/laendertabelle
1619799545,26774,23194,3580,5027,2925,https://www.intensivregister.de/api/public/reporting/laendertabelle
1619806745,26773,23190,3583,5027,2926,https://www.intensivregister.de/api/public/reporting/laendertabelle
1619813945,26771,23178,3593,5022,2925,https://www.intensivregister.de/api/public/reporting/laendertabelle
1619817549,26771,23176,3595,5022,2925,https://www.intensivregister.de/api/public/reporting/laendertabelle
1619821145,26772,23176,3596,5022,2925,https://www.intensivregister.de/api/public/reporting/laendertabelle
1619824749,26767,23169,3598,5022,2926,https://www.intensivregister.de/api/public/reporting/laendertabelle
1619828344,26767,23170,3597,5023,2926,https://www.intensivregister.de/api/public/reporting/laendertabelle
1619831949,26762,23160,3602,5021,2922,https://www.intensivregister.de/api/public/reporting/laendertabelle
1619835544,26766,23179,3587,5019,2917,https://www.intensivregister.de/api/public/reporting/laendertabelle
1619839149,26714,23099,3615,5007,2909,https://www.intensivregister.de/api/public/reporting/laendertabelle
1619842744,26654,23006,3648,5001,2916,https://www.intensivregister.de/api/public/reporting/laendertabelle
1619846349,26601,22876,3725,5016,2912,https://www.intensivregister.de/api/public/reporting/laendertabelle
1619849943,26563,22793,3770,5006,2922,https://www.intensivregister.de/api/public/reporting/laendertabelle
1619853548,26547,22761,3786,5008,2923,https://www.intensivregister.de/api/public/reporting/laendertabelle
1619857154,26548,22765,3783,5005,2922,https://www.intensivregister.de/api/public/reporting/laendertabelle
1619860747,26551,22762,3789,5007,2922,https://www.intensivregister.de/api/public/reporting/laendertabelle
1619864351,26553,22756,3797,5007,2921,https://www.intensivregister.de/api/public/reporting/laendertabelle
1619867946,26553,22755,3798,5008,2923,https://www.intensivregister.de/api/public/reporting/laendertabelle
1619871550,26552,22754,3798,5008,2923,https://www.intensivregister.de/api/public/reporting/laendertabelle
1619875144,26552,22750,3802,5005,2923,https://www.intensivregister.de/api/public/reporting/laendertabelle
1619878748,26552,22749,3803,5005,2924,https://www.intensivregister.de/api/public/reporting/laendertabelle
1619882343,26553,22750,3803,5005,2923,https://www.intensivregister.de/api/public/reporting/laendertabelle
1619885948,26551,22751,3800,5007,2924,https://www.intensivregister.de/api/public/reporting/laendertabelle
1619889543,26550,22749,3801,5007,2926,https://www.intensivregister.de/api/public/reporting/laendertabelle
1619903952,26549,22748,3801,5006,2926,https://www.intensivregister.de/api/public/reporting/laendertabelle
1619907548,26552,22744,3808,5006,2926,https://www.intensivregister.de/api/public/reporting/laendertabelle
1619911143,26551,22749,3802,5007,2926,https://www.intensivregister.de/api/public/reporting/laendertabelle
1619914748,26551,22746,3805,5009,2925,https://www.intensivregister.de/api/public/reporting/laendertabelle
1619918352,26553,22746,3807,5011,2926,https://www.intensivregister.de/api/public/reporting/laendertabelle
1619921947,26546,22725,3821,5007,2924,https://www.intensivregister.de/api/public/reporting/laendertabelle
1619925552,26535,22681,3854,5023,2930,https://www.intensivregister.de/api/public/reporting/laendertabelle
1619929146,26520,22606,3914,5024,2929,https://www.intensivregister.de/api/public/reporting/laendertabelle
1619932750,26489,22515,3974,5021,2927,https://www.intensivregister.de/api/public/reporting/laendertabelle
1619936345,26469,22469,4000,5021,2944,https://www.intensivregister.de/api/public/reporting/laendertabelle
1619939950,26474,22433,4041,5032,2952,https://www.intensivregister.de/api/public/reporting/laendertabelle
1619943545,26472,22426,4046,5029,2949,https://www.intensivregister.de/api/public/reporting/laendertabelle
1619947149,26471,22434,4037,5032,2948,https://www.intensivregister.de/api/public/reporting/laendertabelle
1619950744,26471,22436,4035,5030,2947,https://www.intensivregister.de/api/public/reporting/laendertabelle
1619954348,26471,22435,4036,5030,2947,https://www.intensivregister.de/api/public/reporting/laendertabelle
1619957952,26471,22432,4039,5030,2947,https://www.intensivregister.de/api/public/reporting/laendertabelle
1619965151,26471,22431,4040,5030,2947,https://www.intensivregister.de/api/public/reporting/laendertabelle
1619968746,26470,22432,4038,5029,2946,https://www.intensivregister.de/api/public/reporting/laendertabelle
1619972351,26470,22429,4041,5029,2946,https://www.intensivregister.de/api/public/reporting/laendertabelle
1619975945,26470,22424,4046,5028,2946,https://www.intensivregister.de/api/public/reporting/laendertabelle
1619983145,26471,22423,4048,5030,2949,https://www.intensivregister.de/api/public/reporting/laendertabelle
1619986750,26472,22424,4048,5032,2949,https://www.intensivregister.de/api/public/reporting/laendertabelle
1619990345,26473,22425,4048,5033,2949,https://www.intensivregister.de/api/public/reporting/laendertabelle
1619993950,26473,22424,4049,5033,2949,https://www.intensivregister.de/api/public/reporting/laendertabelle
1619997544,26473,22426,4047,5033,2950,https://www.intensivregister.de/api/public/reporting/laendertabelle
1620001149,26469,22424,4045,5031,2949,https://www.intensivregister.de/api/public/reporting/laendertabelle
1620004743,26465,22420,4045,5034,2947,https://www.intensivregister.de/api/public/reporting/laendertabelle
1620008348,26485,22433,4052,5038,2955,https://www.intensivregister.de/api/public/reporting/laendertabelle
1620011952,26494,22427,4067,5042,2954,https://www.intensivregister.de/api/public/reporting/laendertabelle
1620015546,26529,22492,4037,5006,2958,https://www.intensivregister.de/api/public/reporting/laendertabelle
1620019151,26584,22524,4060,5024,2954,https://www.intensivregister.de/api/public/reporting/laendertabelle
1620022746,26600,22544,4056,5019,2945,https://www.intensivregister.de/api/public/reporting/laendertabelle
1620026350,26618,22531,4087,5011,2939,https://www.intensivregister.de/api/public/reporting/laendertabelle
1620029945,26618,22535,4083,5013,2939,https://www.intensivregister.de/api/public/reporting/laendertabelle
1620033550,26619,22531,4088,5013,2939,https://www.intensivregister.de/api/public/reporting/laendertabelle
1620037145,26620,22530,4090,5014,2939,https://www.intensivregister.de/api/public/reporting/laendertabelle
1620040750,26619,22528,4091,5013,2940,https://www.intensivregister.de/api/public/reporting/laendertabelle
1620044344,26620,22531,4089,5016,2939,https://www.intensivregister.de/api/public/reporting/laendertabelle
1620047949,26620,22534,4086,5020,2940,https://www.intensivregister.de/api/public/reporting/laendertabelle
1620051543,26617,22537,4080,5019,2941,https://www.intensivregister.de/api/public/reporting/laendertabelle
1620058743,26617,22543,4074,5020,2941,https://www.intensivregister.de/api/public/reporting/laendertabelle
1620062348,26622,22546,4076,5020,2939,https://www.intensivregister.de/api/public/reporting/laendertabelle
1620069547,26626,22551,4075,5020,2939,https://www.intensivregister.de/api/public/reporting/laendertabelle
1620073152,26624,22564,4060,5016,2938,https://www.intensivregister.de/api/public/reporting/laendertabelle
1620076747,26623,22563,4060,5017,2938,https://www.intensivregister.de/api/public/reporting/laendertabelle
1620080352,26627,22568,4059,5016,2937,https://www.intensivregister.de/api/public/reporting/laendertabelle
1620083947,26627,22572,4055,5016,2937,https://www.intensivregister.de/api/public/reporting/laendertabelle
1620087552,26629,22571,4058,5014,2935,https://www.intensivregister.de/api/public/reporting/laendertabelle
1620091146,26638,22582,4056,5018,2937,https://www.intensivregister.de/api/public/reporting/laendertabelle
1620094751,26647,22652,3995,5003,2923,https://www.intensivregister.de/api/public/reporting/laendertabelle
1620098345,26655,22705,3950,4984,2924,https://www.intensivregister.de/api/public/reporting/laendertabelle
1620101950,26675,22772,3903,4978,2914,https://www.intensivregister.de/api/public/reporting/laendertabelle
1620105545,26671,22835,3836,4964,2924,https://www.intensivregister.de/api/public/reporting/laendertabelle
1620109150,26683,22889,3794,4958,2927,https://www.intensivregister.de/api/public/reporting/laendertabelle
1620112746,26641,22874,3767,4954,2927,https://www.intensivregister.de/api/public/reporting/laendertabelle
1620116351,26642,22887,3755,4959,2926,https://www.intensivregister.de/api/public/reporting/laendertabelle
1620119946,26659,22894,3765,4956,2925,https://www.intensivregister.de/api/public/reporting/laendertabelle
1620123551,26659,22892,3767,4955,2924,https://www.intensivregister.de/api/public/reporting/laendertabelle
1620127146,26666,22903,3763,4958,2928,https://www.intensivregister.de/api/public/reporting/laendertabelle
1620130750,26663,22902,3761,4955,2929,https://www.intensivregister.de/api/public/reporting/laendertabelle
1620134345,26663,22903,3760,4954,2929,https://www.intensivregister.de/api/public/reporting/laendertabelle
1620137951,26662,22904,3758,4954,2929,https://www.intensivregister.de/api/public/reporting/laendertabelle
1620141546,26663,22905,3758,4954,2929,https://www.intensivregister.de/api/public/reporting/laendertabelle
1620145150,26663,22908,3755,4955,2928,https://www.intensivregister.de/api/public/reporting/laendertabelle
1620148746,26663,22908,3755,4954,2929,https://www.intensivregister.de/api/public/reporting/laendertabelle
1620152351,26663,22907,3756,4954,2929,https://www.intensivregister.de/api/public/reporting/laendertabelle
1620159550,26662,22907,3755,4952,2929,https://www.intensivregister.de/api/public/reporting/laendertabelle
1620163145,26659,22906,3753,4949,2928,https://www.intensivregister.de/api/public/reporting/laendertabelle
1620166750,26659,22903,3756,4950,2931,https://www.intensivregister.de/api/public/reporting/laendertabelle
1620170344,26656,22901,3755,4951,2932,https://www.intensivregister.de/api/public/reporting/laendertabelle
1620173950,26654,22895,3759,4950,2932,https://www.intensivregister.de/api/public/reporting/laendertabelle
1620177545,26654,22896,3758,4952,2932,https://www.intensivregister.de/api/public/reporting/laendertabelle
1620181150,26654,22917,3737,4953,2924,https://www.intensivregister.de/api/public/reporting/laendertabelle
1620184744,26676,22947,3729,4921,2902,https://www.intensivregister.de/api/public/reporting/laendertabelle
1620188349,26658,22970,3688,4880,2889,https://www.intensivregister.de/api/public/reporting/laendertabelle
1620191944,26655,22988,3667,4861,2884,https://www.intensivregister.de/api/public/reporting/laendertabelle
1620195549,26641,22985,3656,4849,2876,https://www.intensivregister.de/api/public/reporting/laendertabelle
1620199144,26642,23008,3634,4838,2879,https://www.intensivregister.de/api/public/reporting/laendertabelle
1620202749,26642,23025,3617,4838,2881,https://www.intensivregister.de/api/public/reporting/laendertabelle
1620206344,26640,23021,3619,4838,2881,https://www.intensivregister.de/api/public/reporting/laendertabelle
1620209948,26641,23037,3604,4841,2881,https://www.intensivregister.de/api/public/reporting/laendertabelle
1620213543,26641,23041,3600,4843,2882,https://www.intensivregister.de/api/public/reporting/laendertabelle
1620217148,26640,23036,3604,4842,2882,https://www.intensivregister.de/api/public/reporting/laendertabelle
1620224348,26640,23033,3607,4840,2882,https://www.intensivregister.de/api/public/reporting/laendertabelle
1620227943,26636,23028,3608,4839,2880,https://www.intensivregister.de/api/public/reporting/laendertabelle
1620231548,26636,23030,3606,4840,2880,https://www.intensivregister.de/api/public/reporting/laendertabelle
1620235153,26636,23029,3607,4839,2879,https://www.intensivregister.de/api/public/reporting/laendertabelle
1620245947,26638,23031,3607,4840,2881,https://www.intensivregister.de/api/public/reporting/laendertabelle
1620249552,26636,23032,3604,4840,2882,https://www.intensivregister.de/api/public/reporting/laendertabelle
1620256751,26634,23032,3602,4843,2884,https://www.intensivregister.de/api/public/reporting/laendertabelle
1620260346,26634,23032,3602,4844,2885,https://www.intensivregister.de/api/public/reporting/laendertabelle
1620263948,26633,23009,3624,4853,2890,https://www.intensivregister.de/api/public/reporting/laendertabelle
1620267552,26632,22961,3671,4826,2884,https://www.intensivregister.de/api/public/reporting/laendertabelle
1620271145,26612,22938,3674,4819,2873,https://www.intensivregister.de/api/public/reporting/laendertabelle
1620274747,26612,22903,3709,4778,2835,https://www.intensivregister.de/api/public/reporting/laendertabelle
1620278350,26610,22903,3707,4772,2829,https://www.intensivregister.de/api/public/reporting/laendertabelle
1620281943,26602,22905,3697,4770,2831,https://www.intensivregister.de/api/public/reporting/laendertabelle
1620285547,26597,22866,3731,4766,2835,https://www.intensivregister.de/api/public/reporting/laendertabelle
1620289150,26595,22866,3729,4763,2834,https://www.intensivregister.de/api/public/reporting/laendertabelle
1620292743,26596,22858,3738,4760,2834,https://www.intensivregister.de/api/public/reporting/laendertabelle
1620296346,26596,22862,3734,4762,2835,https://www.intensivregister.de/api/public/reporting/laendertabelle
1620299949,26595,22859,3736,4764,2837,https://www.intensivregister.de/api/public/reporting/laendertabelle
1620303552,26595,22857,3738,4762,2835,https://www.intensivregister.de/api/public/reporting/laendertabelle
1620307145,26595,22851,3744,4762,2836,https://www.intensivregister.de/api/public/reporting/laendertabelle
1620310748,26595,22855,3740,4761,2835,https://www.intensivregister.de/api/public/reporting/laendertabelle
1620314351,26595,22857,3738,4761,2835,https://www.intensivregister.de/api/public/reporting/laendertabelle
1620321547,26595,22860,3735,4763,2836,https://www.intensivregister.de/api/public/reporting/laendertabelle
1620332347,26596,22867,3729,4763,2836,https://www.intensivregister.de/api/public/reporting/laendertabelle
1620335949,26596,22863,3733,4761,2834,https://www.intensivregister.de/api/public/reporting/laendertabelle
1620339553,26596,22864,3732,4761,2834,https://www.intensivregister.de/api/public/reporting/laendertabelle
1620343146,26594,22862,3732,4761,2834,https://www.intensivregister.de/api/public/reporting/laendertabelle
1620346749,26594,22863,3731,4759,2835,https://www.intensivregister.de/api/public/reporting/laendertabelle
1620350352,26594,22860,3734,4756,2838,https://www.intensivregister.de/api/public/reporting/laendertabelle
1620353945,26586,22857,3729,4753,2832,https://www.intensivregister.de/api/public/reporting/laendertabelle
1620357549,26561,22851,3710,4733,2816,https://www.intensivregister.de/api/public/reporting/laendertabelle
1620361152,26537,22874,3663,4688,2797,https://www.intensivregister.de/api/public/reporting/laendertabelle
1620364745,26539,22883,3656,4689,2805,https://www.intensivregister.de/api/public/reporting/laendertabelle
1620368348,26522,22867,3655,4669,2806,https://www.intensivregister.de/api/public/reporting/laendertabelle
1620371951,26514,22860,3654,4673,2817,https://www.intensivregister.de/api/public/reporting/laendertabelle
1620375544,26515,22862,3653,4673,2822,https://www.intensivregister.de/api/public/reporting/laendertabelle
1620379147,26515,22858,3657,4673,2821,https://www.intensivregister.de/api/public/reporting/laendertabelle
1620382750,26510,22849,3661,4670,2821,https://www.intensivregister.de/api/public/reporting/laendertabelle
1620386343,26510,22853,3657,4671,2825,https://www.intensivregister.de/api/public/reporting/laendertabelle
1620389946,26510,22846,3664,4669,2825,https://www.intensivregister.de/api/public/reporting/laendertabelle
1620393549,26508,22849,3659,4669,2825,https://www.intensivregister.de/api/public/reporting/laendertabelle
1620397152,26507,22847,3660,4668,2824,https://www.intensivregister.de/api/public/reporting/laendertabelle
1620400745,26506,22850,3656,4669,2824,https://www.intensivregister.de/api/public/reporting/laendertabelle
1620404348,26506,22849,3657,4669,2824,https://www.intensivregister.de/api/public/reporting/laendertabelle
1620407951,26506,22848,3658,4669,2824,https://www.intensivregister.de/api/public/reporting/laendertabelle
1620418750,26514,22831,3683,4669,2825,https://www.intensivregister.de/api/public/reporting/laendertabelle
1620422344,26514,22833,3681,4669,2826,https://www.intensivregister.de/api/public/reporting/laendertabelle
1620425947,26513,22828,3685,4670,2826,https://www.intensivregister.de/api/public/reporting/laendertabelle
1620429551,26514,22822,3692,4669,2826,https://www.intensivregister.de/api/public/reporting/laendertabelle
1620433144,26512,22810,3702,4668,2825,https://www.intensivregister.de/api/public/reporting/laendertabelle
1620436748,26506,22795,3711,4666,2824,https://www.intensivregister.de/api/public/reporting/laendertabelle
1620440351,26502,22816,3686,4657,2825,https://www.intensivregister.de/api/public/reporting/laendertabelle
1620443944,26458,22766,3692,4649,2822,https://www.intensivregister.de/api/public/reporting/laendertabelle
1620447547,26412,22628,3784,4627,2797,https://www.intensivregister.de/api/public/reporting/laendertabelle
1620451151,26383,22496,3887,4620,2801,https://www.intensivregister.de/api/public/reporting/laendertabelle
1620454744,26366,22440,3926,4625,2793,https://www.intensivregister.de/api/public/reporting/laendertabelle
1620458347,26349,22394,3955,4610,2796,https://www.intensivregister.de/api/public/reporting/laendertabelle
1620461950,26346,22390,3956,4606,2796,https://www.intensivregister.de/api/public/reporting/laendertabelle
1620465543,26345,22386,3959,4608,2796,https://www.intensivregister.de/api/public/reporting/laendertabelle
1620469146,26343,22378,3965,4606,2796,https://www.intensivregister.de/api/public/reporting/laendertabelle
1620472749,26343,22373,3970,4605,2795,https://www.intensivregister.de/api/public/reporting/laendertabelle
1620476352,26343,22374,3969,4606,2795,https://www.intensivregister.de/api/public/reporting/laendertabelle
1620479945,26343,22375,3968,4606,2795,https://www.intensivregister.de/api/public/reporting/laendertabelle
1620483548,26344,22373,3971,4610,2796,https://www.intensivregister.de/api/public/reporting/laendertabelle
1620487151,26343,22368,3975,4613,2797,https://www.intensivregister.de/api/public/reporting/laendertabelle
1620490744,26342,22365,3977,4612,2798,https://www.intensivregister.de/api/public/reporting/laendertabelle
1620494347,26342,22365,3977,4611,2798,https://www.intensivregister.de/api/public/reporting/laendertabelle
1620505146,26340,22354,3986,4609,2796,https://www.intensivregister.de/api/public/reporting/laendertabelle
1620512352,26340,22349,3991,4609,2797,https://www.intensivregister.de/api/public/reporting/laendertabelle
1620515945,26340,22351,3989,4608,2797,https://www.intensivregister.de/api/public/reporting/laendertabelle
1620519549,26340,22347,3993,4606,2796,https://www.intensivregister.de/api/public/reporting/laendertabelle
1620523153,26333,22342,3991,4602,2795,https://www.intensivregister.de/api/public/reporting/laendertabelle
1620526746,26328,22311,4017,4602,2799,https://www.intensivregister.de/api/public/reporting/laendertabelle
1620530349,26322,22275,4047,4606,2807,https://www.intensivregister.de/api/public/reporting/laendertabelle
1620533952,26310,22190,4120,4593,2798,https://www.intensivregister.de/api/public/reporting/laendertabelle
1620537545,26279,22107,4172,4588,2805,https://www.intensivregister.de/api/public/reporting/laendertabelle
1620541148,26262,22082,4180,4584,2798,https://www.intensivregister.de/api/public/reporting/laendertabelle
1620544751,26265,22067,4198,4585,2797,https://www.intensivregister.de/api/public/reporting/laendertabelle
1620548344,26263,22062,4201,4587,2798,https://www.intensivregister.de/api/public/reporting/laendertabelle
1620555550,26255,22065,4190,4589,2796,https://www.intensivregister.de/api/public/reporting/laendertabelle
1620559143,26255,22061,4194,4590,2797,https://www.intensivregister.de/api/public/reporting/laendertabelle
1620562746,26255,22058,4197,4590,2797,https://www.intensivregister.de/api/public/reporting/laendertabelle
1620566349,26255,22060,4195,4591,2796,https://www.intensivregister.de/api/public/reporting/laendertabelle
1620569952,26255,22065,4190,4590,2795,https://www.intensivregister.de/api/public/reporting/laendertabelle
1620573545,26255,22066,4189,4590,2795,https://www.intensivregister.de/api/public/reporting/laendertabelle
1620577148,26255,22067,4188,4590,2795,https://www.intensivregister.de/api/public/reporting/laendertabelle
1620580751,26255,22070,4185,4590,2795,https://www.intensivregister.de/api/public/reporting/laendertabelle
1620587947,26255,22064,4191,4587,2793,https://www.intensivregister.de/api/public/reporting/laendertabelle
1620591550,26251,22061,4190,4585,2793,https://www.intensivregister.de/api/public/reporting/laendertabelle
1620595143,26251,22063,4188,4585,2793,https://www.intensivregister.de/api/public/reporting/laendertabelle
1620598746,26250,22063,4187,4585,2793,https://www.intensivregister.de/api/public/reporting/laendertabelle
1620602349,26251,22064,4187,4585,2793,https://www.intensivregister.de/api/public/reporting/laendertabelle
1620605952,26251,22073,4178,4584,2792,https://www.intensivregister.de/api/public/reporting/laendertabelle
1620609545,26264,22080,4184,4584,2791,https://www.intensivregister.de/api/public/reporting/laendertabelle
1620613148,26294,22076,4218,4570,2791,https://www.intensivregister.de/api/public/reporting/laendertabelle
1620616751,26305,22142,4163,4569,2777,https://www.intensivregister.de/api/public/reporting/laendertabelle
1620620344,26323,22237,4086,4597,2772,https://www.intensivregister.de/api/public/reporting/laendertabelle
1620623947,26359,22339,4020,4606,2757,https://www.intensivregister.de/api/public/reporting/laendertabelle
1620627550,26388,22396,3992,4594,2746,https://www.intensivregister.de/api/public/reporting/laendertabelle
1620631143,26389,22399,3990,4596,2748,https://www.intensivregister.de/api/public/reporting/laendertabelle
1620634746,26391,22402,3989,4598,2749,https://www.intensivregister.de/api/public/reporting/laendertabelle
1620638349,26400,22406,3994,4595,2748,https://www.intensivregister.de/api/public/reporting/laendertabelle
1620641952,26400,22411,3989,4595,2748,https://www.intensivregister.de/api/public/reporting/laendertabelle
1620645545,26401,22411,3990,4596,2748,https://www.intensivregister.de/api/public/reporting/laendertabelle
1620649148,26401,22409,3992,4594,2748,https://www.intensivregister.de/api/public/reporting/laendertabelle
1620652751,26401,22414,3987,4597,2751,https://www.intensivregister.de/api/public/reporting/laendertabelle
1620656344,26397,22414,3983,4597,2751,https://www.intensivregister.de/api/public/reporting/laendertabelle
1620663549,26397,22415,3982,4597,2751,https://www.intensivregister.de/api/public/reporting/laendertabelle
1620667152,26397,22415,3982,4596,2751,https://www.intensivregister.de/api/public/reporting/laendertabelle
1620670745,26397,22413,3984,4596,2752,https://www.intensivregister.de/api/public/reporting/laendertabelle
1620677951,26399,22421,3978,4595,2752,https://www.intensivregister.de/api/public/reporting/laendertabelle
1620681544,26392,22410,3982,4596,2751,https://www.intensivregister.de/api/public/reporting/laendertabelle
1620685146,26392,22407,3985,4596,2751,https://www.intensivregister.de/api/public/reporting/laendertabelle
1620688750,26392,22415,3977,4600,2753,https://www.intensivregister.de/api/public/reporting/laendertabelle
1620692352,26392,22415,3977,4599,2754,https://www.intensivregister.de/api/public/reporting/laendertabelle
1620695945,26388,22419,3969,4599,2754,https://www.intensivregister.de/api/public/reporting/laendertabelle
1620699548,26406,22498,3908,4589,2757,https://www.intensivregister.de/api/public/reporting/laendertabelle
1620703152,26415,22587,3828,4569,2739,https://www.intensivregister.de/api/public/reporting/laendertabelle
1620706745,26412,22610,3802,4536,2727,https://www.intensivregister.de/api/public/reporting/laendertabelle
1620710348,26416,22687,3729,4479,2726,https://www.intensivregister.de/api/public/reporting/laendertabelle
1620713951,26421,22725,3696,4476,2731,https://www.intensivregister.de/api/public/reporting/laendertabelle
1620717544,26445,22740,3705,4461,2716,https://www.intensivregister.de/api/public/reporting/laendertabelle
1620721148,26445,22740,3705,4460,2716,https://www.intensivregister.de/api/public/reporting/laendertabelle
1620724751,26445,22744,3701,4459,2715,https://www.intensivregister.de/api/public/reporting/laendertabelle
1620728344,26445,22748,3697,4458,2715,https://www.intensivregister.de/api/public/reporting/laendertabelle
1620731948,26443,22742,3701,4456,2713,https://www.intensivregister.de/api/public/reporting/laendertabelle
1620735551,26442,22738,3704,4454,2712,https://www.intensivregister.de/api/public/reporting/laendertabelle
1620739144,26439,22733,3706,4453,2712,https://www.intensivregister.de/api/public/reporting/laendertabelle
1620742747,26439,22734,3705,4450,2711,https://www.intensivregister.de/api/public/reporting/laendertabelle
1620749953,26439,22736,3703,4448,2713,https://www.intensivregister.de/api/public/reporting/laendertabelle
1620753545,26439,22735,3704,4448,2713,https://www.intensivregister.de/api/public/reporting/laendertabelle
1620764344,26436,22732,3704,4446,2711,https://www.intensivregister.de/api/public/reporting/laendertabelle
1620767949,26436,22730,3706,4445,2711,https://www.intensivregister.de/api/public/reporting/laendertabelle
1620771552,26436,22732,3704,4443,2711,https://www.intensivregister.de/api/public/reporting/laendertabelle
1620775145,26434,22731,3703,4443,2713,https://www.intensivregister.de/api/public/reporting/laendertabelle
1620778748,26435,22732,3703,4443,2711,https://www.intensivregister.de/api/public/reporting/laendertabelle
1620782352,26436,22735,3701,4441,2709,https://www.intensivregister.de/api/public/reporting/laendertabelle
1620785945,26437,22706,3731,4418,2700,https://www.intensivregister.de/api/public/reporting/laendertabelle
1620789548,26447,22763,3684,4400,2691,https://www.intensivregister.de/api/public/reporting/laendertabelle
1620793152,26467,22839,3628,4392,2690,https://www.intensivregister.de/api/public/reporting/laendertabelle
1620796746,26473,22835,3638,4370,2683,https://www.intensivregister.de/api/public/reporting/laendertabelle
1620800350,26475,22824,3651,4374,2684,https://www.intensivregister.de/api/public/reporting/laendertabelle
1620803945,26487,22817,3670,4373,2677,https://www.intensivregister.de/api/public/reporting/laendertabelle
1620807549,26491,22827,3664,4377,2678,https://www.intensivregister.de/api/public/reporting/laendertabelle
1620811143,26485,22821,3664,4377,2679,https://www.intensivregister.de/api/public/reporting/laendertabelle
1620814747,26485,22812,3673,4377,2680,https://www.intensivregister.de/api/public/reporting/laendertabelle
1620818350,26485,22814,3671,4377,2680,https://www.intensivregister.de/api/public/reporting/laendertabelle
1620821944,26483,22807,3676,4377,2680,https://www.intensivregister.de/api/public/reporting/laendertabelle
1620825548,26486,22808,3678,4377,2679,https://www.intensivregister.de/api/public/reporting/laendertabelle
1620829152,26484,22801,3683,4374,2679,https://www.intensivregister.de/api/public/reporting/laendertabelle
1620832745,26485,22793,3692,4371,2677,https://www.intensivregister.de/api/public/reporting/laendertabelle
1620836349,26485,22791,3694,4372,2677,https://www.intensivregister.de/api/public/reporting/laendertabelle
1620839953,26485,22791,3694,4373,2678,https://www.intensivregister.de/api/public/reporting/laendertabelle
1620850744,26483,22786,3697,4372,2676,https://www.intensivregister.de/api/public/reporting/laendertabelle
1620854347,26483,22788,3695,4370,2678,https://www.intensivregister.de/api/public/reporting/laendertabelle
1620857951,26483,22786,3697,4370,2678,https://www.intensivregister.de/api/public/reporting/laendertabelle
1620861544,26481,22791,3690,4368,2678,https://www.intensivregister.de/api/public/reporting/laendertabelle
1620865147,26478,22788,3690,4366,2678,https://www.intensivregister.de/api/public/reporting/laendertabelle
1620868751,26481,22787,3694,4368,2678,https://www.intensivregister.de/api/public/reporting/laendertabelle
1620872344,26468,22769,3699,4360,2672,https://www.intensivregister.de/api/public/reporting/laendertabelle
1620875948,26446,22748,3698,4354,2672,https://www.intensivregister.de/api/public/reporting/laendertabelle
1620879551,26392,22624,3768,4309,2662,https://www.intensivregister.de/api/public/reporting/laendertabelle
1620883144,26432,22548,3884,4287,2660,https://www.intensivregister.de/api/public/reporting/laendertabelle
1620886747,26411,22473,3938,4275,2666,https://www.intensivregister.de/api/public/reporting/laendertabelle
1620890351,26402,22433,3969,4258,2653,https://www.intensivregister.de/api/public/reporting/laendertabelle
1620893944,26403,22417,3986,4253,2652,https://www.intensivregister.de/api/public/reporting/laendertabelle
1620897547,26402,22415,3987,4252,2653,https://www.intensivregister.de/api/public/reporting/laendertabelle
1620901150,26402,22414,3988,4251,2652,https://www.intensivregister.de/api/public/reporting/laendertabelle
1620904743,26399,22414,3985,4252,2653,https://www.intensivregister.de/api/public/reporting/laendertabelle
1620908347,26399,22409,3990,4251,2653,https://www.intensivregister.de/api/public/reporting/laendertabelle
1620911950,26399,22414,3985,4251,2653,https://www.intensivregister.de/api/public/reporting/laendertabelle
1620915543,26399,22415,3984,4251,2653,https://www.intensivregister.de/api/public/reporting/laendertabelle
1620919146,26399,22416,3983,4251,2653,https://www.intensivregister.de/api/public/reporting/laendertabelle
1620922749,26399,22416,3983,4252,2653,https://www.intensivregister.de/api/public/reporting/laendertabelle
1620926352,26399,22415,3984,4252,2653,https://www.intensivregister.de/api/public/reporting/laendertabelle
1620937151,26406,22416,3990,4248,2652,https://www.intensivregister.de/api/public/reporting/laendertabelle
1620940745,26405,22408,3997,4250,2652,https://www.intensivregister.de/api/public/reporting/laendertabelle
1620944349,26404,22405,3999,4249,2651,https://www.intensivregister.de/api/public/reporting/laendertabelle
1620947952,26404,22404,4000,4247,2651,https://www.intensivregister.de/api/public/reporting/laendertabelle
1620951545,26402,22400,4002,4247,2651,https://www.intensivregister.de/api/public/reporting/laendertabelle
1620955149,26408,22406,4002,4248,2652,https://www.intensivregister.de/api/public/reporting/laendertabelle
1620958752,26407,22347,4060,4240,2647,https://www.intensivregister.de/api/public/reporting/laendertabelle
1620962346,26365,22223,4142,4223,2638,https://www.intensivregister.de/api/public/reporting/laendertabelle
1620965950,26356,22127,4229,4205,2637,https://www.intensivregister.de/api/public/reporting/laendertabelle
1620969543,26336,22029,4307,4180,2636,https://www.intensivregister.de/api/public/reporting/laendertabelle
1620973147,26321,21993,4328,4175,2634,https://www.intensivregister.de/api/public/reporting/laendertabelle
1620976751,26331,21982,4349,4186,2637,https://www.intensivregister.de/api/public/reporting/laendertabelle
1620980345,26324,21979,4345,4184,2636,https://www.intensivregister.de/api/public/reporting/laendertabelle
1620983949,26324,21975,4349,4181,2637,https://www.intensivregister.de/api/public/reporting/laendertabelle
1620987552,26324,21978,4346,4186,2635,https://www.intensivregister.de/api/public/reporting/laendertabelle
1620991147,26316,21973,4343,4188,2635,https://www.intensivregister.de/api/public/reporting/laendertabelle
1620994751,26315,21977,4338,4188,2635,https://www.intensivregister.de/api/public/reporting/laendertabelle
1620998345,26314,21976,4338,4185,2634,https://www.intensivregister.de/api/public/reporting/laendertabelle
1621001948,26313,21975,4338,4184,2634,https://www.intensivregister.de/api/public/reporting/laendertabelle
1621005552,26313,21977,4336,4183,2634,https://www.intensivregister.de/api/public/reporting/laendertabelle
1621009145,26313,21977,4336,4184,2634,https://www.intensivregister.de/api/public/reporting/laendertabelle
1621012750,26311,21985,4326,4188,2634,https://www.intensivregister.de/api/public/reporting/laendertabelle
1621016343,26311,21987,4324,4188,2634,https://www.intensivregister.de/api/public/reporting/laendertabelle
1621023550,26310,21980,4330,4187,2634,https://www.intensivregister.de/api/public/reporting/laendertabelle
1621027144,26306,21978,4328,4187,2634,https://www.intensivregister.de/api/public/reporting/laendertabelle
1621030747,26305,21982,4323,4188,2636,https://www.intensivregister.de/api/public/reporting/laendertabelle
1621034349,26304,21986,4318,4187,2636,https://www.intensivregister.de/api/public/reporting/laendertabelle
1621037952,26306,21995,4311,4186,2635,https://www.intensivregister.de/api/public/reporting/laendertabelle
1621041546,26306,21996,4310,4186,2634,https://www.intensivregister.de/api/public/reporting/laendertabelle
1621045152,26305,21997,4308,4185,2630,https://www.intensivregister.de/api/public/reporting/laendertabelle
1621048748,26292,22000,4292,4175,2631,https://www.intensivregister.de/api/public/reporting/laendertabelle
1621052344,26260,21944,4316,4149,2622,https://www.intensivregister.de/api/public/reporting/laendertabelle
1621055951,26247,21936,4311,4129,2607,https://www.intensivregister.de/api/public/reporting/laendertabelle
1621059546,26235,21934,4301,4111,2616,https://www.intensivregister.de/api/public/reporting/laendertabelle
1621063152,26231,21927,4304,4090,2592,https://www.intensivregister.de/api/public/reporting/laendertabelle
1621066748,26227,21929,4298,4090,2587,https://www.intensivregister.de/api/public/reporting/laendertabelle
1621070344,26227,21930,4297,4092,2587,https://www.intensivregister.de/api/public/reporting/laendertabelle
1621073950,26227,21929,4298,4091,2588,https://www.intensivregister.de/api/public/reporting/laendertabelle
1621077545,26227,21926,4301,4088,2587,https://www.intensivregister.de/api/public/reporting/laendertabelle
1621081151,26229,21917,4312,4090,2586,https://www.intensivregister.de/api/public/reporting/laendertabelle
1621088353,26229,21918,4311,4091,2586,https://www.intensivregister.de/api/public/reporting/laendertabelle
1621091948,26229,21916,4313,4091,2586,https://www.intensivregister.de/api/public/reporting/laendertabelle
1621095544,26229,21914,4315,4089,2587,https://www.intensivregister.de/api/public/reporting/laendertabelle
1621099150,26222,21910,4312,4089,2585,https://www.intensivregister.de/api/public/reporting/laendertabelle
1621102745,26224,21912,4312,4089,2585,https://www.intensivregister.de/api/public/reporting/laendertabelle
1621106351,26224,21915,4309,4089,2585,https://www.intensivregister.de/api/public/reporting/laendertabelle
1621109946,26221,21908,4313,4087,2584,https://www.intensivregister.de/api/public/reporting/laendertabelle
1621113552,26221,21902,4319,4086,2584,https://www.intensivregister.de/api/public/reporting/laendertabelle
1621117191,26225,21897,4328,4088,2586,https://www.intensivregister.de/api/public/reporting/laendertabelle
1621120743,26224,21896,4328,4088,2586,https://www.intensivregister.de/api/public/reporting/laendertabelle
1621124350,26236,21903,4333,4088,2586,https://www.intensivregister.de/api/public/reporting/laendertabelle
1621127947,26236,21902,4334,4088,2586,https://www.intensivregister.de/api/public/reporting/laendertabelle
1621131544,26230,21890,4340,4087,2582,https://www.intensivregister.de/api/public/reporting/laendertabelle
1621135150,26216,21858,4358,4076,2574,https://www.intensivregister.de/api/public/reporting/laendertabelle
1621138746,26196,21792,4404,4062,2547,https://www.intensivregister.de/api/public/reporting/laendertabelle
1621142352,26091,21732,4359,4059,2538,https://www.intensivregister.de/api/public/reporting/laendertabelle
1621145948,26078,21682,4396,4121,2534,https://www.intensivregister.de/api/public/reporting/laendertabelle
1621149544,26086,21667,4419,4125,2525,https://www.intensivregister.de/api/public/reporting/laendertabelle
1621153150,26089,21680,4409,4125,2528,https://www.intensivregister.de/api/public/reporting/laendertabelle
1621156745,26089,21676,4413,4125,2528,https://www.intensivregister.de/api/public/reporting/laendertabelle
1621160351,26089,21672,4417,4126,2528,https://www.intensivregister.de/api/public/reporting/laendertabelle
1621163947,26089,21671,4418,4126,2528,https://www.intensivregister.de/api/public/reporting/laendertabelle
1621167552,26089,21668,4421,4126,2528,https://www.intensivregister.de/api/public/reporting/laendertabelle
1621171147,26089,21664,4425,4125,2528,https://www.intensivregister.de/api/public/reporting/laendertabelle
1621174743,26089,21664,4425,4126,2528,https://www.intensivregister.de/api/public/reporting/laendertabelle
1621178348,26089,21665,4424,4126,2528,https://www.intensivregister.de/api/public/reporting/laendertabelle
1621181944,26089,21665,4424,4127,2528,https://www.intensivregister.de/api/public/reporting/laendertabelle
1621185549,26089,21668,4421,4127,2528,https://www.intensivregister.de/api/public/reporting/laendertabelle
1621189144,26089,21669,4420,4128,2529,https://www.intensivregister.de/api/public/reporting/laendertabelle
1621196345,26087,21668,4419,4126,2527,https://www.intensivregister.de/api/public/reporting/laendertabelle
1621199951,26081,21668,4413,4126,2527,https://www.intensivregister.de/api/public/reporting/laendertabelle
1621203547,26082,21674,4408,4127,2529,https://www.intensivregister.de/api/public/reporting/laendertabelle
1621207143,26084,21676,4408,4128,2530,https://www.intensivregister.de/api/public/reporting/laendertabelle
1621210748,26080,21668,4412,4126,2528,https://www.intensivregister.de/api/public/reporting/laendertabelle
1621214344,26081,21677,4404,4125,2526,https://www.intensivregister.de/api/public/reporting/laendertabelle
1621217950,26130,21687,4443,4050,2525,https://www.intensivregister.de/api/public/reporting/laendertabelle
1621221546,26140,21730,4410,4041,2519,https://www.intensivregister.de/api/public/reporting/laendertabelle
1621225152,26170,21776,4394,4028,2499,https://www.intensivregister.de/api/public/reporting/laendertabelle
1621228747,26198,21816,4382,4017,2497,https://www.intensivregister.de/api/public/reporting/laendertabelle
1621232343,26217,21900,4317,4014,2491,https://www.intensivregister.de/api/public/reporting/laendertabelle
1621235949,26233,21938,4295,4015,2492,https://www.intensivregister.de/api/public/reporting/laendertabelle
1621239544,26220,21932,4288,4016,2492,https://www.intensivregister.de/api/public/reporting/laendertabelle
1621243150,26220,21933,4287,4017,2493,https://www.intensivregister.de/api/public/reporting/laendertabelle
1621246745,26220,21928,4292,4018,2494,https://www.intensivregister.de/api/public/reporting/laendertabelle
1621250351,26220,21931,4289,4017,2494,https://www.intensivregister.de/api/public/reporting/laendertabelle
1621253946,26218,21929,4289,4017,2494,https://www.intensivregister.de/api/public/reporting/laendertabelle
1621257552,26218,21930,4288,4014,2494,https://www.intensivregister.de/api/public/reporting/laendertabelle
1621261147,26218,21933,4285,4015,2495,https://www.intensivregister.de/api/public/reporting/laendertabelle
1621264753,26218,21932,4286,4013,2493,https://www.intensivregister.de/api/public/reporting/laendertabelle
1621268348,26218,21931,4287,4012,2493,https://www.intensivregister.de/api/public/reporting/laendertabelle
1621282750,26228,21942,4286,4011,2490,https://www.intensivregister.de/api/public/reporting/laendertabelle
1621286346,26230,21946,4284,4011,2490,https://www.intensivregister.de/api/public/reporting/laendertabelle
1621289952,26230,21951,4279,4011,2489,https://www.intensivregister.de/api/public/reporting/laendertabelle
1621293547,26231,21949,4282,4011,2489,https://www.intensivregister.de/api/public/reporting/laendertabelle
1621297153,26236,21957,4279,4012,2489,https://www.intensivregister.de/api/public/reporting/laendertabelle
1621300749,26240,21971,4269,4005,2488,https://www.intensivregister.de/api/public/reporting/laendertabelle
1621304345,26239,22040,4199,3988,2479,https://www.intensivregister.de/api/public/reporting/laendertabelle
1621307951,26267,22130,4137,3939,2460,https://www.intensivregister.de/api/public/reporting/laendertabelle
1621311547,26309,22260,4049,3921,2450,https://www.intensivregister.de/api/public/reporting/laendertabelle
1621315153,26319,22333,3986,3894,2429,https://www.intensivregister.de/api/public/reporting/laendertabelle
1621318749,26332,22368,3964,3888,2433,https://www.intensivregister.de/api/public/reporting/laendertabelle
1621322344,26308,22347,3961,3879,2434,https://www.intensivregister.de/api/public/reporting/laendertabelle
1621325950,26308,22348,3960,3878,2433,https://www.intensivregister.de/api/public/reporting/laendertabelle
1621329545,26308,22349,3959,3880,2433,https://www.intensivregister.de/api/public/reporting/laendertabelle
1621333151,26306,22352,3954,3881,2433,https://www.intensivregister.de/api/public/reporting/laendertabelle
1621336746,26307,22350,3957,3879,2431,https://www.intensivregister.de/api/public/reporting/laendertabelle
1621340352,26311,22356,3955,3879,2431,https://www.intensivregister.de/api/public/reporting/laendertabelle
1621343948,26309,22354,3955,3877,2428,https://www.intensivregister.de/api/public/reporting/laendertabelle
1621347543,26309,22351,3958,3877,2427,https://www.intensivregister.de/api/public/reporting/laendertabelle
1621354744,26311,22351,3960,3877,2427,https://www.intensivregister.de/api/public/reporting/laendertabelle
1621358349,26299,22340,3959,3872,2425,https://www.intensivregister.de/api/public/reporting/laendertabelle
1621361945,26299,22342,3957,3872,2425,https://www.intensivregister.de/api/public/reporting/laendertabelle
1621369146,26296,22348,3948,3873,2425,https://www.intensivregister.de/api/public/reporting/laendertabelle
1621372752,26297,22347,3950,3871,2428,https://www.intensivregister.de/api/public/reporting/laendertabelle
1621376348,26297,22354,3943,3872,2429,https://www.intensivregister.de/api/public/reporting/laendertabelle
1621379944,26295,22354,3941,3872,2429,https://www.intensivregister.de/api/public/reporting/laendertabelle
1621383549,26293,22358,3935,3874,2431,https://www.intensivregister.de/api/public/reporting/laendertabelle
1621387145,26296,22364,3932,3877,2430,https://www.intensivregister.de/api/public/reporting/laendertabelle
1621390751,26285,22370,3915,3864,2421,https://www.intensivregister.de/api/public/reporting/laendertabelle
1621394348,26288,22369,3919,3825,2403,https://www.intensivregister.de/api/public/reporting/laendertabelle
1621397943,26282,22429,3853,3783,2388,https://www.intensivregister.de/api/public/reporting/laendertabelle
1621401549,26300,22488,3812,3751,2368,https://www.intensivregister.de/api/public/reporting/laendertabelle
1621405145,26311,22503,3808,3733,2368,https://www.intensivregister.de/api/public/reporting/laendertabelle
1621408751,26297,22476,3821,3708,2353,https://www.intensivregister.de/api/public/reporting/laendertabelle
1621412346,26297,22474,3823,3708,2353,https://www.intensivregister.de/api/public/reporting/laendertabelle
1621415952,26297,22479,3818,3708,2353,https://www.intensivregister.de/api/public/reporting/laendertabelle
1621419548,26296,22473,3823,3705,2353,https://www.intensivregister.de/api/public/reporting/laendertabelle
1621423143,26296,22482,3814,3706,2353,https://www.intensivregister.de/api/public/reporting/laendertabelle
1621426749,26295,22483,3812,3706,2353,https://www.intensivregister.de/api/public/reporting/laendertabelle
1621430344,26307,22498,3809,3707,2353,https://www.intensivregister.de/api/public/reporting/laendertabelle
1621433950,26307,22497,3810,3706,2353,https://www.intensivregister.de/api/public/reporting/laendertabelle
1621437545,26307,22494,3813,3705,2352,https://www.intensivregister.de/api/public/reporting/laendertabelle
1621441151,26307,22493,3814,3705,2352,https://www.intensivregister.de/api/public/reporting/laendertabelle
1621448352,26307,22493,3814,3706,2352,https://www.intensivregister.de/api/public/reporting/laendertabelle
1621455543,26307,22492,3815,3706,2352,https://www.intensivregister.de/api/public/reporting/laendertabelle
1621459150,26308,22493,3815,3706,2353,https://www.intensivregister.de/api/public/reporting/laendertabelle
1621462743,26308,22483,3825,3706,2352,https://www.intensivregister.de/api/public/reporting/laendertabelle
1621466349,26308,22482,3826,3706,2352,https://www.intensivregister.de/api/public/reporting/laendertabelle
1621469944,26310,22486,3824,3706,2352,https://www.intensivregister.de/api/public/reporting/laendertabelle
1621473550,26308,22490,3818,3707,2354,https://www.intensivregister.de/api/public/reporting/laendertabelle
1621477145,26298,22472,3826,3685,2348,https://www.intensivregister.de/api/public/reporting/laendertabelle
1621480750,26304,22456,3848,3676,2335,https://www.intensivregister.de/api/public/reporting/laendertabelle
1621484347,26286,22451,3835,3613,2296,https://www.intensivregister.de/api/public/reporting/laendertabelle
1621487952,26288,22442,3846,3598,2288,https://www.intensivregister.de/api/public/reporting/laendertabelle
1621491548,26276,22437,3839,3606,2285,https://www.intensivregister.de/api/public/reporting/laendertabelle
1621495144,26277,22417,3860,3595,2279,https://www.intensivregister.de/api/public/reporting/laendertabelle
1621498750,26276,22419,3857,3588,2278,https://www.intensivregister.de/api/public/reporting/laendertabelle
1621502345,26271,22408,3863,3585,2279,https://www.intensivregister.de/api/public/reporting/laendertabelle
1621505951,26269,22402,3867,3586,2279,https://www.intensivregister.de/api/public/reporting/laendertabelle
1621509547,26270,22403,3867,3585,2279,https://www.intensivregister.de/api/public/reporting/laendertabelle
1621513152,26269,22401,3868,3585,2278,https://www.intensivregister.de/api/public/reporting/laendertabelle
1621516748,26269,22401,3868,3586,2279,https://www.intensivregister.de/api/public/reporting/laendertabelle
1621520344,26269,22397,3872,3583,2276,https://www.intensivregister.de/api/public/reporting/laendertabelle
1621523949,26269,22394,3875,3583,2276,https://www.intensivregister.de/api/public/reporting/laendertabelle
1621527545,26269,22394,3875,3582,2276,https://www.intensivregister.de/api/public/reporting/laendertabelle
1621531150,26269,22396,3873,3583,2275,https://www.intensivregister.de/api/public/reporting/laendertabelle
1621541948,26265,22395,3870,3583,2275,https://www.intensivregister.de/api/public/reporting/laendertabelle
1621545544,26265,22397,3868,3584,2275,https://www.intensivregister.de/api/public/reporting/laendertabelle
1621549148,26265,22398,3867,3584,2275,https://www.intensivregister.de/api/public/reporting/laendertabelle
1621552743,26266,22396,3870,3583,2274,https://www.intensivregister.de/api/public/reporting/laendertabelle
1621556349,26268,22401,3867,3585,2275,https://www.intensivregister.de/api/public/reporting/laendertabelle
1621559945,26268,22388,3880,3585,2273,https://www.intensivregister.de/api/public/reporting/laendertabelle
1621563550,26269,22369,3900,3571,2251,https://www.intensivregister.de/api/public/reporting/laendertabelle
1621567146,26257,22360,3897,3543,2237,https://www.intensivregister.de/api/public/reporting/laendertabelle
1621570752,26237,22358,3879,3513,2212,https://www.intensivregister.de/api/public/reporting/laendertabelle
1621574347,26207,22306,3901,3494,2204,https://www.intensivregister.de/api/public/reporting/laendertabelle
1621577943,26220,22337,3883,3488,2202,https://www.intensivregister.de/api/public/reporting/laendertabelle
1621581549,26228,22325,3903,3480,2197,https://www.intensivregister.de/api/public/reporting/laendertabelle
1621585145,26231,22324,3907,3477,2197,https://www.intensivregister.de/api/public/reporting/laendertabelle
1621588750,26234,22323,3911,3473,2196,https://www.intensivregister.de/api/public/reporting/laendertabelle
1621592346,26233,22319,3914,3470,2196,https://www.intensivregister.de/api/public/reporting/laendertabelle
1621595951,26234,22323,3911,3470,2198,https://www.intensivregister.de/api/public/reporting/laendertabelle
1621599546,26237,22329,3908,3471,2198,https://www.intensivregister.de/api/public/reporting/laendertabelle
1621603152,26240,22326,3914,3471,2198,https://www.intensivregister.de/api/public/reporting/laendertabelle
1621613949,26240,22324,3916,3469,2197,https://www.intensivregister.de/api/public/reporting/laendertabelle
1621617544,26240,22325,3915,3470,2198,https://www.intensivregister.de/api/public/reporting/laendertabelle
1621621150,26240,22324,3916,3470,2198,https://www.intensivregister.de/api/public/reporting/laendertabelle
1621624745,26240,22323,3917,3470,2198,https://www.intensivregister.de/api/public/reporting/laendertabelle
1621628351,26238,22319,3919,3469,2197,https://www.intensivregister.de/api/public/reporting/laendertabelle
1621631947,26239,22322,3917,3466,2198,https://www.intensivregister.de/api/public/reporting/laendertabelle
1621635554,26239,22320,3919,3466,2197,https://www.intensivregister.de/api/public/reporting/laendertabelle
1621639148,26237,22319,3918,3466,2197,https://www.intensivregister.de/api/public/reporting/laendertabelle
1621642743,26237,22316,3921,3466,2197,https://www.intensivregister.de/api/public/reporting/laendertabelle
1621646345,26233,22313,3920,3464,2195,https://www.intensivregister.de/api/public/reporting/laendertabelle
1621649952,26231,22318,3913,3454,2189,https://www.intensivregister.de/api/public/reporting/laendertabelle
1621653549,26229,22257,3972,3447,2181,https://www.intensivregister.de/api/public/reporting/laendertabelle
1621657147,26172,22137,4035,3386,2156,https://www.intensivregister.de/api/public/reporting/laendertabelle
1621660744,26146,22068,4078,3370,2134,https://www.intensivregister.de/api/public/reporting/laendertabelle
1621664351,26116,22004,4112,3374,2131,https://www.intensivregister.de/api/public/reporting/laendertabelle
1621667948,26096,21979,4117,3364,2117,https://www.intensivregister.de/api/public/reporting/laendertabelle
1621671545,26093,21970,4123,3356,2113,https://www.intensivregister.de/api/public/reporting/laendertabelle
1621675152,26094,21967,4127,3355,2113,https://www.intensivregister.de/api/public/reporting/laendertabelle
1621678749,26092,21969,4123,3357,2114,https://www.intensivregister.de/api/public/reporting/laendertabelle
1621682346,26092,21966,4126,3357,2114,https://www.intensivregister.de/api/public/reporting/laendertabelle
1621685943,26093,21962,4131,3355,2115,https://www.intensivregister.de/api/public/reporting/laendertabelle
1621693148,26091,21960,4131,3355,2116,https://www.intensivregister.de/api/public/reporting/laendertabelle
1621696744,26091,21961,4130,3355,2116,https://www.intensivregister.de/api/public/reporting/laendertabelle
1621700351,26092,21959,4133,3354,2116,https://www.intensivregister.de/api/public/reporting/laendertabelle
1621703949,26091,21958,4133,3355,2117,https://www.intensivregister.de/api/public/reporting/laendertabelle
1621711152,26091,21960,4131,3355,2117,https://www.intensivregister.de/api/public/reporting/laendertabelle
1621714749,26091,21946,4145,3356,2117,https://www.intensivregister.de/api/public/reporting/laendertabelle
1621718347,26091,21943,4148,3358,2118,https://www.intensivregister.de/api/public/reporting/laendertabelle
1621721944,26091,21942,4149,3358,2118,https://www.intensivregister.de/api/public/reporting/laendertabelle
1621725552,26091,21941,4150,3357,2118,https://www.intensivregister.de/api/public/reporting/laendertabelle
1621729150,26091,21940,4151,3357,2117,https://www.intensivregister.de/api/public/reporting/laendertabelle
1621732748,26091,21933,4158,3359,2120,https://www.intensivregister.de/api/public/reporting/laendertabelle
1621736347,26091,21912,4179,3360,2121,https://www.intensivregister.de/api/public/reporting/laendertabelle
1621739944,26083,21855,4228,3366,2123,https://www.intensivregister.de/api/public/reporting/laendertabelle
1621743552,26038,21699,4339,3338,2113,https://www.intensivregister.de/api/public/reporting/laendertabelle
1621747149,26031,21558,4473,3330,2104,https://www.intensivregister.de/api/public/reporting/laendertabelle
1621750747,26004,21486,4518,3316,2092,https://www.intensivregister.de/api/public/reporting/laendertabelle
1621754344,25998,21420,4578,3303,2079,https://www.intensivregister.de/api/public/reporting/laendertabelle
1621757951,26000,21420,4580,3305,2080,https://www.intensivregister.de/api/public/reporting/laendertabelle
1621761549,26000,21413,4587,3304,2078,https://www.intensivregister.de/api/public/reporting/laendertabelle
1621765146,25999,21407,4592,3304,2078,https://www.intensivregister.de/api/public/reporting/laendertabelle
1621768743,25999,21405,4594,3304,2078,https://www.intensivregister.de/api/public/reporting/laendertabelle
1621772350,26000,21400,4600,3301,2078,https://www.intensivregister.de/api/public/reporting/laendertabelle
1621775948,26000,21401,4599,3299,2077,https://www.intensivregister.de/api/public/reporting/laendertabelle
1621779545,26000,21405,4595,3301,2078,https://www.intensivregister.de/api/public/reporting/laendertabelle
1621783152,26000,21406,4594,3301,2078,https://www.intensivregister.de/api/public/reporting/laendertabelle
1621786749,26000,21407,4593,3302,2078,https://www.intensivregister.de/api/public/reporting/laendertabelle
1621793943,26000,21405,4595,3300,2078,https://www.intensivregister.de/api/public/reporting/laendertabelle
1621801147,25990,21393,4597,3299,2078,https://www.intensivregister.de/api/public/reporting/laendertabelle
1621804744,25989,21393,4596,3299,2078,https://www.intensivregister.de/api/public/reporting/laendertabelle
1621808351,25988,21390,4598,3300,2078,https://www.intensivregister.de/api/public/reporting/laendertabelle
1621811949,25989,21393,4596,3300,2078,https://www.intensivregister.de/api/public/reporting/laendertabelle
1621815546,25989,21391,4598,3300,2078,https://www.intensivregister.de/api/public/reporting/laendertabelle
1621819143,25990,21397,4593,3299,2077,https://www.intensivregister.de/api/public/reporting/laendertabelle
1621822750,25985,21384,4601,3295,2077,https://www.intensivregister.de/api/public/reporting/laendertabelle
1621826348,25984,21381,4603,3283,2068,https://www.intensivregister.de/api/public/reporting/laendertabelle
1621829945,25971,21355,4616,3262,2057,https://www.intensivregister.de/api/public/reporting/laendertabelle
1621833552,25979,21285,4694,3243,2038,https://www.intensivregister.de/api/public/reporting/laendertabelle
1621837150,25976,21283,4693,3240,2030,https://www.intensivregister.de/api/public/reporting/laendertabelle
1621840747,25980,21260,4720,3237,2036,https://www.intensivregister.de/api/public/reporting/laendertabelle
1621844344,25977,21251,4726,3239,2036,https://www.intensivregister.de/api/public/reporting/laendertabelle
1621847951,25976,21256,4720,3235,2034,https://www.intensivregister.de/api/public/reporting/laendertabelle
1621851548,25976,21251,4725,3234,2034,https://www.intensivregister.de/api/public/reporting/laendertabelle
1621855145,25974,21249,4725,3234,2034,https://www.intensivregister.de/api/public/reporting/laendertabelle
1621858752,25975,21251,4724,3236,2034,https://www.intensivregister.de/api/public/reporting/laendertabelle
1621865946,25975,21251,4724,3237,2034,https://www.intensivregister.de/api/public/reporting/laendertabelle
1621869543,25975,21253,4722,3239,2035,https://www.intensivregister.de/api/public/reporting/laendertabelle
1621873151,25975,21254,4721,3238,2035,https://www.intensivregister.de/api/public/reporting/laendertabelle
1621887549,25973,21247,4726,3238,2035,https://www.intensivregister.de/api/public/reporting/laendertabelle
1621887549,25973,21245,4728,3238,2035,https://www.intensivregister.de/api/public/reporting/laendertabelle
1621894744,25974,21243,4731,3238,2035,https://www.intensivregister.de/api/public/reporting/laendertabelle
1621898352,25971,21240,4731,3238,2035,https://www.intensivregister.de/api/public/reporting/laendertabelle
1621901949,25972,21243,4729,3238,2035,https://www.intensivregister.de/api/public/reporting/laendertabelle
1621905546,25972,21243,4729,3236,2032,https://www.intensivregister.de/api/public/reporting/laendertabelle
1621909143,26007,21234,4773,3230,2034,https://www.intensivregister.de/api/public/reporting/laendertabelle
1621912750,26027,21296,4731,3228,2022,https://www.intensivregister.de/api/public/reporting/laendertabelle
1621916348,26053,21357,4696,3192,1987,https://www.intensivregister.de/api/public/reporting/laendertabelle
1621919946,26076,21369,4707,3194,1991,https://www.intensivregister.de/api/public/reporting/laendertabelle
1621923544,26103,21451,4652,3191,1990,https://www.intensivregister.de/api/public/reporting/laendertabelle
1621927151,26111,21478,4633,3180,1983,https://www.intensivregister.de/api/public/reporting/laendertabelle
1621930749,26110,21475,4635,3181,1982,https://www.intensivregister.de/api/public/reporting/laendertabelle
1621934347,26107,21477,4630,3182,1981,https://www.intensivregister.de/api/public/reporting/laendertabelle
1621937944,26110,21476,4634,3181,1981,https://www.intensivregister.de/api/public/reporting/laendertabelle
1621941551,26110,21476,4634,3179,1980,https://www.intensivregister.de/api/public/reporting/laendertabelle
1621945149,26109,21478,4631,3179,1980,https://www.intensivregister.de/api/public/reporting/laendertabelle
1621948746,26109,21477,4632,3179,1980,https://www.intensivregister.de/api/public/reporting/laendertabelle
1621955951,26108,21480,4628,3179,1980,https://www.intensivregister.de/api/public/reporting/laendertabelle
1621959544,26108,21482,4626,3178,1979,https://www.intensivregister.de/api/public/reporting/laendertabelle
1621963152,26108,21481,4627,3177,1980,https://www.intensivregister.de/api/public/reporting/laendertabelle
1621970347,26108,21484,4624,3177,1980,https://www.intensivregister.de/api/public/reporting/laendertabelle
1621973945,26120,21493,4627,3175,1979,https://www.intensivregister.de/api/public/reporting/laendertabelle
1621977552,26122,21494,4628,3177,1980,https://www.intensivregister.de/api/public/reporting/laendertabelle
1621981150,26122,21492,4630,3177,1980,https://www.intensivregister.de/api/public/reporting/laendertabelle
1621984748,26122,21498,4624,3178,1981,https://www.intensivregister.de/api/public/reporting/laendertabelle
1621988345,26124,21499,4625,3177,1980,https://www.intensivregister.de/api/public/reporting/laendertabelle
1621991945,26119,21505,4614,3171,1978,https://www.intensivregister.de/api/public/reporting/laendertabelle
1621995551,26119,21533,4586,3153,1957,https://www.intensivregister.de/api/public/reporting/laendertabelle
1621999149,26141,21645,4496,3113,1950,https://www.intensivregister.de/api/public/reporting/laendertabelle
1622002747,26162,21774,4388,3052,1922,https://www.intensivregister.de/api/public/reporting/laendertabelle
1622006349,26179,21869,4310,3014,1901,https://www.intensivregister.de/api/public/reporting/laendertabelle
1622009944,26185,21923,4262,3001,1895,https://www.intensivregister.de/api/public/reporting/laendertabelle
1622013550,26199,21957,4242,3001,1893,https://www.intensivregister.de/api/public/reporting/laendertabelle
1622017144,26200,21960,4240,3000,1894,https://www.intensivregister.de/api/public/reporting/laendertabelle
1622020750,26202,21961,4241,2996,1894,https://www.intensivregister.de/api/public/reporting/laendertabelle
1622024344,26203,21963,4240,2997,1895,https://www.intensivregister.de/api/public/reporting/laendertabelle
1622027949,26201,21957,4244,2999,1896,https://www.intensivregister.de/api/public/reporting/laendertabelle
1622031544,26199,21952,4247,2998,1895,https://www.intensivregister.de/api/public/reporting/laendertabelle
1622035149,26200,21954,4246,2997,1895,https://www.intensivregister.de/api/public/reporting/laendertabelle
1622038744,26204,21956,4248,2997,1895,https://www.intensivregister.de/api/public/reporting/laendertabelle
1622042349,26204,21957,4247,2997,1895,https://www.intensivregister.de/api/public/reporting/laendertabelle
1622049549,26204,21956,4248,2997,1895,https://www.intensivregister.de/api/public/reporting/laendertabelle
1622056749,26204,21959,4245,2997,1895,https://www.intensivregister.de/api/public/reporting/laendertabelle
1622060344,26203,21961,4242,2995,1894,https://www.intensivregister.de/api/public/reporting/laendertabelle
1622063949,26202,21962,4240,2996,1894,https://www.intensivregister.de/api/public/reporting/laendertabelle
1622067544,26203,21960,4243,2996,1895,https://www.intensivregister.de/api/public/reporting/laendertabelle
1622071148,26204,21958,4246,2995,1896,https://www.intensivregister.de/api/public/reporting/laendertabelle
1622078348,26202,21957,4245,2994,1893,https://www.intensivregister.de/api/public/reporting/laendertabelle
1622081943,26209,21972,4237,2974,1880,https://www.intensivregister.de/api/public/reporting/laendertabelle
1622085548,26217,21949,4268,2944,1867,https://www.intensivregister.de/api/public/reporting/laendertabelle
1622089143,26194,21908,4286,2895,1849,https://www.intensivregister.de/api/public/reporting/laendertabelle
1622092749,26183,21910,4273,2860,1835,https://www.intensivregister.de/api/public/reporting/laendertabelle
1622096351,26149,21891,4258,2843,1829,https://www.intensivregister.de/api/public/reporting/laendertabelle
1622099952,26133,21891,4242,2837,1832,https://www.intensivregister.de/api/public/reporting/laendertabelle
1622103545,26134,21900,4234,2834,1827,https://www.intensivregister.de/api/public/reporting/laendertabelle
1622107147,26133,21896,4237,2833,1827,https://www.intensivregister.de/api/public/reporting/laendertabelle
1622110749,26133,21896,4237,2831,1825,https://www.intensivregister.de/api/public/reporting/laendertabelle
1622114350,26132,21896,4236,2830,1825,https://www.intensivregister.de/api/public/reporting/laendertabelle
1622117952,26132,21900,4232,2830,1825,https://www.intensivregister.de/api/public/reporting/laendertabelle
1622125146,26132,21898,4234,2829,1825,https://www.intensivregister.de/api/public/reporting/laendertabelle
1622128748,26130,21901,4229,2827,1823,https://www.intensivregister.de/api/public/reporting/laendertabelle
1622135952,26130,21900,4230,2827,1823,https://www.intensivregister.de/api/public/reporting/laendertabelle
1622139545,26130,21894,4236,2825,1823,https://www.intensivregister.de/api/public/reporting/laendertabelle
1622146744,26130,21895,4235,2824,1823,https://www.intensivregister.de/api/public/reporting/laendertabelle
1622150348,26133,21894,4239,2822,1822,https://www.intensivregister.de/api/public/reporting/laendertabelle
1622153952,26133,21899,4234,2822,1822,https://www.intensivregister.de/api/public/reporting/laendertabelle
1622157546,26133,21896,4237,2821,1822,https://www.intensivregister.de/api/public/reporting/laendertabelle
1622161150,26134,21906,4228,2821,1822,https://www.intensivregister.de/api/public/reporting/laendertabelle
1622164744,26132,21909,4223,2817,1820,https://www.intensivregister.de/api/public/reporting/laendertabelle
1622168348,26128,21864,4264,2798,1810,https://www.intensivregister.de/api/public/reporting/laendertabelle
1622171952,26127,21793,4334,2767,1776,https://www.intensivregister.de/api/public/reporting/laendertabelle
1622175547,26070,21752,4318,2741,1755,https://www.intensivregister.de/api/public/reporting/laendertabelle
1622179150,26081,21784,4297,2739,1760,https://www.intensivregister.de/api/public/reporting/laendertabelle
1622182743,26067,21752,4315,2710,1744,https://www.intensivregister.de/api/public/reporting/laendertabelle
1622186345,26070,21745,4325,2701,1737,https://www.intensivregister.de/api/public/reporting/laendertabelle
1622189946,26068,21749,4319,2698,1736,https://www.intensivregister.de/api/public/reporting/laendertabelle
1622193548,26066,21750,4316,2697,1730,https://www.intensivregister.de/api/public/reporting/laendertabelle
1622197149,26068,21745,4323,2696,1731,https://www.intensivregister.de/api/public/reporting/laendertabelle
1622200750,26068,21749,4319,2695,1730,https://www.intensivregister.de/api/public/reporting/laendertabelle
1622204352,26068,21746,4322,2697,1731,https://www.intensivregister.de/api/public/reporting/laendertabelle
1622207943,26069,21743,4326,2698,1731,https://www.intensivregister.de/api/public/reporting/laendertabelle
1622215146,26069,21743,4326,2700,1732,https://www.intensivregister.de/api/public/reporting/laendertabelle
1622218747,26069,21744,4325,2701,1732,https://www.intensivregister.de/api/public/reporting/laendertabelle
1622222349,26069,21743,4326,2702,1732,https://www.intensivregister.de/api/public/reporting/laendertabelle
1622225950,26069,21743,4326,2703,1732,https://www.intensivregister.de/api/public/reporting/laendertabelle
1622233143,26068,21720,4348,2698,1730,https://www.intensivregister.de/api/public/reporting/laendertabelle
1622236745,26063,21715,4348,2699,1731,https://www.intensivregister.de/api/public/reporting/laendertabelle
1622240346,26063,21718,4345,2698,1731,https://www.intensivregister.de/api/public/reporting/laendertabelle
1622243948,26063,21720,4343,2698,1731,https://www.intensivregister.de/api/public/reporting/laendertabelle
1622247550,26061,21718,4343,2698,1731,https://www.intensivregister.de/api/public/reporting/laendertabelle
1622251152,26063,21717,4346,2698,1731,https://www.intensivregister.de/api/public/reporting/laendertabelle
1622254751,26061,21701,4360,2695,1729,https://www.intensivregister.de/api/public/reporting/laendertabelle
1622258350,26043,21679,4364,2671,1719,https://www.intensivregister.de/api/public/reporting/laendertabelle
1622261950,26024,21622,4402,2637,1707,https://www.intensivregister.de/api/public/reporting/laendertabelle
1622265549,25968,21433,4535,2613,1694,https://www.intensivregister.de/api/public/reporting/laendertabelle
1622269148,25949,21388,4561,2602,1699,https://www.intensivregister.de/api/public/reporting/laendertabelle
1622272748,25924,21358,4566,2591,1691,https://www.intensivregister.de/api/public/reporting/laendertabelle
1622276350,25924,21358,4566,2590,1690,https://www.intensivregister.de/api/public/reporting/laendertabelle
1622279947,25922,21356,4566,2590,1691,https://www.intensivregister.de/api/public/reporting/laendertabelle
1622283546,25921,21347,4574,2590,1692,https://www.intensivregister.de/api/public/reporting/laendertabelle
1622287145,25921,21348,4573,2590,1692,https://www.intensivregister.de/api/public/reporting/laendertabelle
1622290745,25921,21350,4571,2588,1692,https://www.intensivregister.de/api/public/reporting/laendertabelle
1622294344,25919,21352,4567,2589,1692,https://www.intensivregister.de/api/public/reporting/laendertabelle
1622305151,25919,21350,4569,2590,1694,https://www.intensivregister.de/api/public/reporting/laendertabelle
1622308751,25919,21350,4569,2591,1695,https://www.intensivregister.de/api/public/reporting/laendertabelle
1622312350,25919,21348,4571,2591,1695,https://www.intensivregister.de/api/public/reporting/laendertabelle
1622315949,25918,21343,4575,2591,1695,https://www.intensivregister.de/api/public/reporting/laendertabelle
1622319549,25917,21337,4580,2591,1695,https://www.intensivregister.de/api/public/reporting/laendertabelle
1622323148,25917,21339,4578,2591,1695,https://www.intensivregister.de/api/public/reporting/laendertabelle
1622326747,25910,21337,4573,2591,1695,https://www.intensivregister.de/api/public/reporting/laendertabelle
1622330347,25910,21338,4572,2592,1695,https://www.intensivregister.de/api/public/reporting/laendertabelle
1622333946,25910,21336,4574,2592,1695,https://www.intensivregister.de/api/public/reporting/laendertabelle
1622337545,25904,21319,4585,2592,1695,https://www.intensivregister.de/api/public/reporting/laendertabelle
1622341144,25900,21328,4572,2589,1692,https://www.intensivregister.de/api/public/reporting/laendertabelle
1622344743,25890,21265,4625,2569,1678,https://www.intensivregister.de/api/public/reporting/laendertabelle
1622348353,25855,21129,4726,2554,1675,https://www.intensivregister.de/api/public/reporting/laendertabelle
1622351953,25841,21073,4768,2528,1666,https://www.intensivregister.de/api/public/reporting/laendertabelle
1622355552,25849,21059,4790,2525,1662,https://www.intensivregister.de/api/public/reporting/laendertabelle
1622359152,25830,21024,4806,2517,1658,https://www.intensivregister.de/api/public/reporting/laendertabelle
1622362751,25827,21019,4808,2516,1659,https://www.intensivregister.de/api/public/reporting/laendertabelle
1622366351,25832,21022,4810,2517,1659,https://www.intensivregister.de/api/public/reporting/laendertabelle
1622369950,25832,21020,4812,2517,1659,https://www.intensivregister.de/api/public/reporting/laendertabelle
1622373553,25832,21015,4817,2517,1659,https://www.intensivregister.de/api/public/reporting/laendertabelle
1622391545,25832,21012,4820,2518,1660,https://www.intensivregister.de/api/public/reporting/laendertabelle
1622395144,25832,21011,4821,2518,1660,https://www.intensivregister.de/api/public/reporting/laendertabelle
1622405952,25837,21019,4818,2518,1660,https://www.intensivregister.de/api/public/reporting/laendertabelle
1622409553,25837,21019,4818,2515,1660,https://www.intensivregister.de/api/public/reporting/laendertabelle
1622413151,25837,21017,4820,2515,1659,https://www.intensivregister.de/api/public/reporting/laendertabelle
1622420350,25837,21019,4818,2514,1659,https://www.intensivregister.de/api/public/reporting/laendertabelle
1622423950,25835,21024,4811,2515,1660,https://www.intensivregister.de/api/public/reporting/laendertabelle
1622427549,25852,21085,4767,2516,1656,https://www.intensivregister.de/api/public/reporting/laendertabelle
1622431148,25885,21112,4773,2508,1642,https://www.intensivregister.de/api/public/reporting/laendertabelle
1622434749,25936,21170,4766,2487,1620,https://www.intensivregister.de/api/public/reporting/laendertabelle
1622438348,25985,21197,4788,2468,1606,https://www.intensivregister.de/api/public/reporting/laendertabelle
1622441948,26003,21291,4712,2458,1580,https://www.intensivregister.de/api/public/reporting/laendertabelle
1622445548,25999,21287,4712,2451,1577,https://www.intensivregister.de/api/public/reporting/laendertabelle
1622449148,25996,21285,4711,2446,1571,https://www.intensivregister.de/api/public/reporting/laendertabelle
1622452747,25996,21286,4710,2448,1569,https://www.intensivregister.de/api/public/reporting/laendertabelle
1622456347,25996,21287,4709,2448,1569,https://www.intensivregister.de/api/public/reporting/laendertabelle
1622459947,25994,21289,4705,2448,1569,https://www.intensivregister.de/api/public/reporting/laendertabelle
1622463547,25994,21298,4696,2447,1569,https://www.intensivregister.de/api/public/reporting/laendertabelle
1622470745,25994,21301,4693,2447,1568,https://www.intensivregister.de/api/public/reporting/laendertabelle
1622474344,25994,21302,4692,2447,1568,https://www.intensivregister.de/api/public/reporting/laendertabelle
1622477943,25997,21302,4695,2447,1568,https://www.intensivregister.de/api/public/reporting/laendertabelle
1622485153,25997,21301,4696,2447,1568,https://www.intensivregister.de/api/public/reporting/laendertabelle
1622488751,25997,21301,4696,2446,1567,https://www.intensivregister.de/api/public/reporting/laendertabelle
1622492351,25996,21307,4689,2445,1567,https://www.intensivregister.de/api/public/reporting/laendertabelle
1622495950,25996,21307,4689,2443,1565,https://www.intensivregister.de/api/public/reporting/laendertabelle
1622499550,25995,21311,4684,2442,1565,https://www.intensivregister.de/api/public/reporting/laendertabelle
1622503149,25996,21309,4687,2440,1563,https://www.intensivregister.de/api/public/reporting/laendertabelle
1622506748,25996,21312,4684,2440,1563,https://www.intensivregister.de/api/public/reporting/laendertabelle
1622510348,25998,21321,4677,2438,1563,https://www.intensivregister.de/api/public/reporting/laendertabelle
1622513947,26008,21403,4605,2416,1547,https://www.intensivregister.de/api/public/reporting/laendertabelle
1622517546,26035,21541,4494,2384,1528,https://www.intensivregister.de/api/public/reporting/laendertabelle
1622521146,26078,21707,4371,2344,1502,https://www.intensivregister.de/api/public/reporting/laendertabelle
1622524745,26117,21764,4353,2307,1479,https://www.intensivregister.de/api/public/reporting/laendertabelle
1622528345,26238,21805,4433,2292,1477,https://www.intensivregister.de/api/public/reporting/laendertabelle
1622531945,26245,21807,4438,2290,1476,https://www.intensivregister.de/api/public/reporting/laendertabelle
1622535543,26245,21809,4436,2289,1476,https://www.intensivregister.de/api/public/reporting/laendertabelle
1622539151,26243,21814,4429,2289,1476,https://www.intensivregister.de/api/public/reporting/laendertabelle
1622542748,26243,21809,4434,2286,1476,https://www.intensivregister.de/api/public/reporting/laendertabelle
1622546346,26243,21808,4435,2285,1475,https://www.intensivregister.de/api/public/reporting/laendertabelle
1622549944,26243,21806,4437,2283,1474,https://www.intensivregister.de/api/public/reporting/laendertabelle
1622553552,26244,21803,4441,2282,1474,https://www.intensivregister.de/api/public/reporting/laendertabelle
1622557149,26244,21802,4442,2282,1474,https://www.intensivregister.de/api/public/reporting/laendertabelle
1622560747,26244,21799,4445,2282,1474,https://www.intensivregister.de/api/public/reporting/laendertabelle
1622564345,26244,21800,4444,2282,1474,https://www.intensivregister.de/api/public/reporting/laendertabelle
1622567952,26244,21805,4439,2281,1474,https://www.intensivregister.de/api/public/reporting/laendertabelle
1622578746,26244,21810,4434,2280,1474,https://www.intensivregister.de/api/public/reporting/laendertabelle
1622582343,26245,21801,4444,2279,1472,https://www.intensivregister.de/api/public/reporting/laendertabelle
1622585951,26243,21797,4446,2279,1471,https://www.intensivregister.de/api/public/reporting/laendertabelle
1622589549,26238,21791,4447,2279,1471,https://www.intensivregister.de/api/public/reporting/laendertabelle
1622593147,26240,21784,4456,2277,1470,https://www.intensivregister.de/api/public/reporting/laendertabelle
1622596744,26240,21790,4450,2272,1466,https://www.intensivregister.de/api/public/reporting/laendertabelle
1622600352,26221,21764,4457,2259,1467,https://www.intensivregister.de/api/public/reporting/laendertabelle
1622603950,26207,21700,4507,2235,1460,https://www.intensivregister.de/api/public/reporting/laendertabelle
1622607550,26226,21791,4435,2190,1421,https://www.intensivregister.de/api/public/reporting/laendertabelle
1622611149,26115,21791,4324,2151,1397,https://www.intensivregister.de/api/public/reporting/laendertabelle
1622614748,26109,21815,4294,2150,1390,https://www.intensivregister.de/api/public/reporting/laendertabelle
1622618347,26112,21805,4307,2147,1388,https://www.intensivregister.de/api/public/reporting/laendertabelle
1622621945,26114,21800,4314,2143,1387,https://www.intensivregister.de/api/public/reporting/laendertabelle
1622625544,26111,21797,4314,2140,1384,https://www.intensivregister.de/api/public/reporting/laendertabelle
1622629143,26111,21800,4311,2140,1384,https://www.intensivregister.de/api/public/reporting/laendertabelle
1622632752,26111,21801,4310,2139,1384,https://www.intensivregister.de/api/public/reporting/laendertabelle
1622636351,26114,21798,4316,2140,1385,https://www.intensivregister.de/api/public/reporting/laendertabelle
1622639950,26115,21799,4316,2140,1385,https://www.intensivregister.de/api/public/reporting/laendertabelle
1622643550,26115,21802,4313,2140,1385,https://www.intensivregister.de/api/public/reporting/laendertabelle
1622647148,26115,21803,4312,2140,1385,https://www.intensivregister.de/api/public/reporting/laendertabelle
1622650747,26115,21804,4311,2139,1385,https://www.intensivregister.de/api/public/reporting/laendertabelle
1622654346,26113,21806,4307,2139,1385,https://www.intensivregister.de/api/public/reporting/laendertabelle
1622657946,26113,21807,4306,2139,1385,https://www.intensivregister.de/api/public/reporting/laendertabelle
1622665143,26110,21803,4307,2138,1385,https://www.intensivregister.de/api/public/reporting/laendertabelle
1622668752,26109,21802,4307,2138,1385,https://www.intensivregister.de/api/public/reporting/laendertabelle
1622672350,26106,21802,4304,2138,1385,https://www.intensivregister.de/api/public/reporting/laendertabelle
1622675950,26109,21800,4309,2138,1384,https://www.intensivregister.de/api/public/reporting/laendertabelle
1622683147,26109,21802,4307,2139,1384,https://www.intensivregister.de/api/public/reporting/laendertabelle
1622686746,26112,21809,4303,2131,1374,https://www.intensivregister.de/api/public/reporting/laendertabelle
1622690345,26113,21805,4308,2118,1372,https://www.intensivregister.de/api/public/reporting/laendertabelle
1622693944,26075,21682,4393,2092,1362,https://www.intensivregister.de/api/public/reporting/laendertabelle
1622697543,26083,21667,4416,2068,1336,https://www.intensivregister.de/api/public/reporting/laendertabelle
1622701150,26077,21631,4446,2053,1335,https://www.intensivregister.de/api/public/reporting/laendertabelle
1622704744,26056,21634,4422,2035,1325,https://www.intensivregister.de/api/public/reporting/laendertabelle
1622708346,26053,21635,4418,2035,1326,https://www.intensivregister.de/api/public/reporting/laendertabelle
1622711949,26053,21619,4434,2030,1323,https://www.intensivregister.de/api/public/reporting/laendertabelle
1622715552,26054,21620,4434,2030,1323,https://www.intensivregister.de/api/public/reporting/laendertabelle
1622719145,26054,21619,4435,2030,1323,https://www.intensivregister.de/api/public/reporting/laendertabelle
1622722747,26054,21620,4434,2030,1323,https://www.intensivregister.de/api/public/reporting/laendertabelle
1622726351,26054,21622,4432,2028,1325,https://www.intensivregister.de/api/public/reporting/laendertabelle
1622733547,26054,21621,4433,2027,1325,https://www.intensivregister.de/api/public/reporting/laendertabelle
1622737150,26051,21620,4431,2026,1325,https://www.intensivregister.de/api/public/reporting/laendertabelle
1622740743,26049,21618,4431,2026,1325,https://www.intensivregister.de/api/public/reporting/laendertabelle
1622744345,26049,21620,4429,2026,1325,https://www.intensivregister.de/api/public/reporting/laendertabelle
1622747983,26049,21621,4428,2026,1325,https://www.intensivregister.de/api/public/reporting/laendertabelle
1622751548,26052,21624,4428,2026,1324,https://www.intensivregister.de/api/public/reporting/laendertabelle
1622755143,26051,21624,4427,2026,1324,https://www.intensivregister.de/api/public/reporting/laendertabelle
1622758748,26047,21623,4424,2026,1324,https://www.intensivregister.de/api/public/reporting/laendertabelle
1622762343,26046,21619,4427,2026,1324,https://www.intensivregister.de/api/public/reporting/laendertabelle
1622765948,26047,21614,4433,2027,1324,https://www.intensivregister.de/api/public/reporting/laendertabelle
1622769543,26047,21606,4441,2024,1324,https://www.intensivregister.de/api/public/reporting/laendertabelle
1622773148,26038,21596,4442,2014,1319,https://www.intensivregister.de/api/public/reporting/laendertabelle
1622776743,26035,21563,4472,2002,1310,https://www.intensivregister.de/api/public/reporting/laendertabelle
1622780348,26035,21548,4487,1984,1299,https://www.intensivregister.de/api/public/reporting/laendertabelle
1622783944,26034,21483,4551,1973,1299,https://www.intensivregister.de/api/public/reporting/laendertabelle
1622787549,26028,21470,4558,1972,1297,https://www.intensivregister.de/api/public/reporting/laendertabelle
1622791144,26013,21443,4570,1971,1296,https://www.intensivregister.de/api/public/reporting/laendertabelle
1622794750,26012,21442,4570,1970,1295,https://www.intensivregister.de/api/public/reporting/laendertabelle
1622798346,26013,21442,4571,1969,1295,https://www.intensivregister.de/api/public/reporting/laendertabelle
1622801951,26013,21439,4574,1966,1295,https://www.intensivregister.de/api/public/reporting/laendertabelle
1622805547,26013,21443,4570,1966,1295,https://www.intensivregister.de/api/public/reporting/laendertabelle
1622809152,26015,21438,4577,1964,1294,https://www.intensivregister.de/api/public/reporting/laendertabelle
1622816345,26015,21434,4581,1963,1294,https://www.intensivregister.de/api/public/reporting/laendertabelle
1622823545,26019,21437,4582,1964,1294,https://www.intensivregister.de/api/public/reporting/laendertabelle
1622827150,26019,21435,4584,1963,1293,https://www.intensivregister.de/api/public/reporting/laendertabelle
1622834347,26020,21436,4584,1961,1292,https://www.intensivregister.de/api/public/reporting/laendertabelle
1622837944,26020,21424,4596,1961,1291,https://www.intensivregister.de/api/public/reporting/laendertabelle
1622841550,26017,21417,4600,1961,1290,https://www.intensivregister.de/api/public/reporting/laendertabelle
1622845147,26015,21423,4592,1962,1291,https://www.intensivregister.de/api/public/reporting/laendertabelle
1622848745,26011,21427,4584,1963,1290,https://www.intensivregister.de/api/public/reporting/laendertabelle
1622852352,26015,21425,4590,1964,1290,https://www.intensivregister.de/api/public/reporting/laendertabelle
1622855949,26013,21436,4577,1963,1289,https://www.intensivregister.de/api/public/reporting/laendertabelle
1622859546,26011,21442,4569,1961,1287,https://www.intensivregister.de/api/public/reporting/laendertabelle
1622863143,25993,21435,4558,1956,1285,https://www.intensivregister.de/api/public/reporting/laendertabelle
1622866750,25970,21373,4597,1936,1269,https://www.intensivregister.de/api/public/reporting/laendertabelle
1622870347,25958,21347,4611,1915,1261,https://www.intensivregister.de/api/public/reporting/laendertabelle
1622873944,25931,21325,4606,1903,1251,https://www.intensivregister.de/api/public/reporting/laendertabelle
1622877548,25919,21277,4642,1896,1236,https://www.intensivregister.de/api/public/reporting/laendertabelle
1622881143,26001,21269,4732,1892,1237,https://www.intensivregister.de/api/public/reporting/laendertabelle
1622884748,25999,21267,4732,1891,1235,https://www.intensivregister.de/api/public/reporting/laendertabelle
1622888343,25999,21268,4731,1890,1236,https://www.intensivregister.de/api/public/reporting/laendertabelle
1622891948,26003,21273,4730,1890,1236,https://www.intensivregister.de/api/public/reporting/laendertabelle
1622895552,25996,21274,4722,1889,1236,https://www.intensivregister.de/api/public/reporting/laendertabelle
1622899147,25996,21272,4724,1889,1236,https://www.intensivregister.de/api/public/reporting/laendertabelle
1622902752,25995,21270,4725,1889,1235,https://www.intensivregister.de/api/public/reporting/laendertabelle
1622906346,25995,21276,4719,1889,1235,https://www.intensivregister.de/api/public/reporting/laendertabelle
1622909951,25995,21275,4720,1890,1235,https://www.intensivregister.de/api/public/reporting/laendertabelle
1622913549,25995,21276,4719,1891,1235,https://www.intensivregister.de/api/public/reporting/laendertabelle
1622917150,25995,21275,4720,1891,1235,https://www.intensivregister.de/api/public/reporting/laendertabelle
1622924343,25991,21273,4718,1891,1235,https://www.intensivregister.de/api/public/reporting/laendertabelle
1622927949,25989,21272,4717,1891,1235,https://www.intensivregister.de/api/public/reporting/laendertabelle
1622931544,25989,21278,4711,1891,1235,https://www.intensivregister.de/api/public/reporting/laendertabelle
1622935148,25989,21282,4707,1891,1234,https://www.intensivregister.de/api/public/reporting/laendertabelle
1622938743,25989,21281,4708,1891,1234,https://www.intensivregister.de/api/public/reporting/laendertabelle
1622942348,25990,21283,4707,1891,1234,https://www.intensivregister.de/api/public/reporting/laendertabelle
1622945944,25987,21242,4745,1891,1230,https://www.intensivregister.de/api/public/reporting/laendertabelle
1622949549,25956,21157,4799,1883,1228,https://www.intensivregister.de/api/public/reporting/laendertabelle
1622953145,25942,21027,4915,1886,1227,https://www.intensivregister.de/api/public/reporting/laendertabelle
1622956750,25924,20982,4942,1871,1204,https://www.intensivregister.de/api/public/reporting/laendertabelle
1622960346,25826,20947,4879,1861,1200,https://www.intensivregister.de/api/public/reporting/laendertabelle
1622963944,25818,20948,4870,1853,1193,https://www.intensivregister.de/api/public/reporting/laendertabelle
1622967550,25819,20940,4879,1857,1194,https://www.intensivregister.de/api/public/reporting/laendertabelle
1622971147,25819,20938,4881,1856,1194,https://www.intensivregister.de/api/public/reporting/laendertabelle
1622981946,25819,20941,4878,1857,1195,https://www.intensivregister.de/api/public/reporting/laendertabelle
1622985552,25820,20940,4880,1857,1194,https://www.intensivregister.de/api/public/reporting/laendertabelle
1622989148,25820,20939,4881,1856,1194,https://www.intensivregister.de/api/public/reporting/laendertabelle
1622992744,25820,20937,4883,1856,1194,https://www.intensivregister.de/api/public/reporting/laendertabelle
1622996350,25820,20940,4880,1856,1194,https://www.intensivregister.de/api/public/reporting/laendertabelle
1622999947,25821,20942,4879,1856,1194,https://www.intensivregister.de/api/public/reporting/laendertabelle
1623010747,25823,20945,4878,1855,1195,https://www.intensivregister.de/api/public/reporting/laendertabelle
1623014344,25823,20944,4879,1856,1195,https://www.intensivregister.de/api/public/reporting/laendertabelle
1623017951,25823,20941,4882,1856,1195,https://www.intensivregister.de/api/public/reporting/laendertabelle
1623021548,25826,20943,4883,1855,1195,https://www.intensivregister.de/api/public/reporting/laendertabelle
1623025144,25826,20947,4879,1855,1195,https://www.intensivregister.de/api/public/reporting/laendertabelle
1623028749,25826,20953,4873,1855,1196,https://www.intensivregister.de/api/public/reporting/laendertabelle
1623032344,25834,20953,4881,1855,1192,https://www.intensivregister.de/api/public/reporting/laendertabelle
1623035949,25840,20924,4916,1839,1174,https://www.intensivregister.de/api/public/reporting/laendertabelle
1623039545,25921,20997,4924,1821,1167,https://www.intensivregister.de/api/public/reporting/laendertabelle
1623043150,25964,21050,4914,1815,1158,https://www.intensivregister.de/api/public/reporting/laendertabelle
1623046745,25966,21069,4897,1810,1150,https://www.intensivregister.de/api/public/reporting/laendertabelle
1623050351,25971,21093,4878,1797,1147,https://www.intensivregister.de/api/public/reporting/laendertabelle
1623053946,25971,21097,4874,1796,1147,https://www.intensivregister.de/api/public/reporting/laendertabelle
1623057551,25973,21104,4869,1796,1147,https://www.intensivregister.de/api/public/reporting/laendertabelle
1623061147,25969,21101,4868,1796,1147,https://www.intensivregister.de/api/public/reporting/laendertabelle
1623064752,25972,21101,4871,1795,1148,https://www.intensivregister.de/api/public/reporting/laendertabelle
1623068347,25968,21094,4874,1795,1148,https://www.intensivregister.de/api/public/reporting/laendertabelle
1623071952,25968,21093,4875,1795,1148,https://www.intensivregister.de/api/public/reporting/laendertabelle
1623075548,25968,21091,4877,1795,1148,https://www.intensivregister.de/api/public/reporting/laendertabelle
1623082750,25974,21099,4875,1795,1148,https://www.intensivregister.de/api/public/reporting/laendertabelle
1623086345,25974,21096,4878,1795,1148,https://www.intensivregister.de/api/public/reporting/laendertabelle
1623089950,25975,21098,4877,1795,1148,https://www.intensivregister.de/api/public/reporting/laendertabelle
1623097151,25975,21106,4869,1795,1148,https://www.intensivregister.de/api/public/reporting/laendertabelle
1623100747,25978,21109,4869,1795,1148,https://www.intensivregister.de/api/public/reporting/laendertabelle
1623104352,25978,21111,4867,1795,1148,https://www.intensivregister.de/api/public/reporting/laendertabelle
1623107948,25978,21109,4869,1795,1148,https://www.intensivregister.de/api/public/reporting/laendertabelle
1623111543,25981,21116,4865,1795,1149,https://www.intensivregister.de/api/public/reporting/laendertabelle
1623115148,25986,21115,4871,1796,1150,https://www.intensivregister.de/api/public/reporting/laendertabelle
1623118743,25999,21166,4833,1785,1146,https://www.intensivregister.de/api/public/reporting/laendertabelle
1623122349,26023,21304,4719,1763,1135,https://www.intensivregister.de/api/public/reporting/laendertabelle
1623125944,26033,21476,4557,1735,1113,https://www.intensivregister.de/api/public/reporting/laendertabelle
1623129550,26071,21609,4462,1716,1101,https://www.intensivregister.de/api/public/reporting/laendertabelle
1623133145,26079,21637,4442,1702,1099,https://www.intensivregister.de/api/public/reporting/laendertabelle
1623136751,26079,21642,4437,1700,1097,https://www.intensivregister.de/api/public/reporting/laendertabelle
1623140347,26081,21638,4443,1699,1097,https://www.intensivregister.de/api/public/reporting/laendertabelle
1623143952,26081,21649,4432,1698,1096,https://www.intensivregister.de/api/public/reporting/laendertabelle
1623147548,26081,21651,4430,1695,1097,https://www.intensivregister.de/api/public/reporting/laendertabelle
1623151144,26082,21654,4428,1695,1097,https://www.intensivregister.de/api/public/reporting/laendertabelle
1623161944,26082,21655,4427,1695,1097,https://www.intensivregister.de/api/public/reporting/laendertabelle
1623169147,26082,21652,4430,1695,1097,https://www.intensivregister.de/api/public/reporting/laendertabelle
1623172743,26082,21651,4431,1695,1097,https://www.intensivregister.de/api/public/reporting/laendertabelle
1623176350,26082,21650,4432,1694,1097,https://www.intensivregister.de/api/public/reporting/laendertabelle
1623183553,26078,21647,4431,1692,1097,https://www.intensivregister.de/api/public/reporting/laendertabelle
1623187149,26079,21643,4436,1691,1097,https://www.intensivregister.de/api/public/reporting/laendertabelle
1623190745,26080,21641,4439,1691,1097,https://www.intensivregister.de/api/public/reporting/laendertabelle
1623194352,26081,21648,4433,1691,1097,https://www.intensivregister.de/api/public/reporting/laendertabelle
1623197943,26083,21649,4434,1690,1097,https://www.intensivregister.de/api/public/reporting/laendertabelle
1623201551,26060,21630,4430,1686,1093,https://www.intensivregister.de/api/public/reporting/laendertabelle
1623205144,26069,21660,4409,1677,1086,https://www.intensivregister.de/api/public/reporting/laendertabelle
1623208748,26114,21722,4392,1658,1070,https://www.intensivregister.de/api/public/reporting/laendertabelle
1623212352,26137,21739,4398,1629,1054,https://www.intensivregister.de/api/public/reporting/laendertabelle
1623215946,26148,21733,4415,1616,1052,https://www.intensivregister.de/api/public/reporting/laendertabelle
1623219549,26147,21775,4372,1604,1045,https://www.intensivregister.de/api/public/reporting/laendertabelle
1623223152,26166,21810,4356,1598,1042,https://www.intensivregister.de/api/public/reporting/laendertabelle
1623226745,26163,21806,4357,1593,1041,https://www.intensivregister.de/api/public/reporting/laendertabelle
1623230352,26159,21801,4358,1592,1040,https://www.intensivregister.de/api/public/reporting/laendertabelle
1623233944,26159,21804,4355,1592,1035,https://www.intensivregister.de/api/public/reporting/laendertabelle
1623237546,26155,21807,4348,1592,1035,https://www.intensivregister.de/api/public/reporting/laendertabelle
1623241148,26154,21808,4346,1592,1035,https://www.intensivregister.de/api/public/reporting/laendertabelle
1623244750,26154,21809,4345,1592,1036,https://www.intensivregister.de/api/public/reporting/laendertabelle
1623248352,26154,21808,4346,1592,1036,https://www.intensivregister.de/api/public/reporting/laendertabelle
1623251944,26154,21809,4345,1592,1036,https://www.intensivregister.de/api/public/reporting/laendertabelle
1623255546,26154,21809,4345,1593,1036,https://www.intensivregister.de/api/public/reporting/laendertabelle
1623266343,26154,21810,4344,1592,1036,https://www.intensivregister.de/api/public/reporting/laendertabelle
1623269947,26154,21804,4350,1593,1036,https://www.intensivregister.de/api/public/reporting/laendertabelle
1623273552,26158,21796,4362,1593,1036,https://www.intensivregister.de/api/public/reporting/laendertabelle
1623277147,26157,21796,4361,1593,1036,https://www.intensivregister.de/api/public/reporting/laendertabelle
1623284347,26158,21793,4365,1593,1036,https://www.intensivregister.de/api/public/reporting/laendertabelle
1623287945,26159,21792,4367,1592,1033,https://www.intensivregister.de/api/public/reporting/laendertabelle
1623291544,26170,21795,4375,1583,1033,https://www.intensivregister.de/api/public/reporting/laendertabelle
1623295152,26177,21829,4348,1566,1027,https://www.intensivregister.de/api/public/reporting/laendertabelle
1623298751,26183,21851,4332,1552,1021,https://www.intensivregister.de/api/public/reporting/laendertabelle
1623302350,26174,21836,4338,1531,1009,https://www.intensivregister.de/api/public/reporting/laendertabelle
1623305952,26177,21840,4337,1522,1003,https://www.intensivregister.de/api/public/reporting/laendertabelle
1623309549,26164,21821,4343,1511,1001,https://www.intensivregister.de/api/public/reporting/laendertabelle
1623313146,26163,21807,4356,1508,998,https://www.intensivregister.de/api/public/reporting/laendertabelle
1623316753,26163,21803,4360,1507,998,https://www.intensivregister.de/api/public/reporting/laendertabelle
1623320349,26163,21802,4361,1506,998,https://www.intensivregister.de/api/public/reporting/laendertabelle
1623323946,26165,21801,4364,1505,997,https://www.intensivregister.de/api/public/reporting/laendertabelle
1623327552,26166,21809,4357,1505,997,https://www.intensivregister.de/api/public/reporting/laendertabelle
1623331149,26165,21811,4354,1506,997,https://www.intensivregister.de/api/public/reporting/laendertabelle
1623338352,26165,21809,4356,1506,997,https://www.intensivregister.de/api/public/reporting/laendertabelle
1623341948,26165,21809,4356,1508,999,https://www.intensivregister.de/api/public/reporting/laendertabelle
1623345545,26165,21807,4358,1509,999,https://www.intensivregister.de/api/public/reporting/laendertabelle
1623356346,26165,21811,4354,1507,998,https://www.intensivregister.de/api/public/reporting/laendertabelle
1623359943,26166,21808,4358,1507,998,https://www.intensivregister.de/api/public/reporting/laendertabelle
1623363551,26167,21812,4355,1507,998,https://www.intensivregister.de/api/public/reporting/laendertabelle
1623367149,26166,21810,4356,1508,997,https://www.intensivregister.de/api/public/reporting/laendertabelle
1623370747,26164,21805,4359,1508,997,https://www.intensivregister.de/api/public/reporting/laendertabelle
1623374344,26164,21794,4370,1508,997,https://www.intensivregister.de/api/public/reporting/laendertabelle
1623377952,26159,21794,4365,1506,994,https://www.intensivregister.de/api/public/reporting/laendertabelle
1623381550,26135,21765,4370,1496,982,https://www.intensivregister.de/api/public/reporting/laendertabelle
1623385147,26124,21742,4382,1467,972,https://www.intensivregister.de/api/public/reporting/laendertabelle
1623388745,26096,21724,4372,1440,964,https://www.intensivregister.de/api/public/reporting/laendertabelle
1623392353,26076,21701,4375,1433,955,https://www.intensivregister.de/api/public/reporting/laendertabelle
1623395950,26081,21702,4379,1420,948,https://www.intensivregister.de/api/public/reporting/laendertabelle
1623399548,26082,21676,4406,1419,948,https://www.intensivregister.de/api/public/reporting/laendertabelle
1623403146,26082,21664,4418,1418,949,https://www.intensivregister.de/api/public/reporting/laendertabelle
1623406743,26078,21665,4413,1418,949,https://www.intensivregister.de/api/public/reporting/laendertabelle
1623410351,26077,21665,4412,1418,949,https://www.intensivregister.de/api/public/reporting/laendertabelle
1623413949,26072,21666,4406,1418,949,https://www.intensivregister.de/api/public/reporting/laendertabelle
1623417550,26072,21658,4414,1417,948,https://www.intensivregister.de/api/public/reporting/laendertabelle
1623421152,26072,21659,4413,1417,948,https://www.intensivregister.de/api/public/reporting/laendertabelle
1623428343,26072,21659,4413,1416,947,https://www.intensivregister.de/api/public/reporting/laendertabelle
1623431944,26072,21657,4415,1415,947,https://www.intensivregister.de/api/public/reporting/laendertabelle
1623442748,26073,21655,4418,1415,948,https://www.intensivregister.de/api/public/reporting/laendertabelle
1623446349,26073,21659,4414,1415,948,https://www.intensivregister.de/api/public/reporting/laendertabelle
1623449950,26072,21660,4412,1414,948,https://www.intensivregister.de/api/public/reporting/laendertabelle
1623453551,26069,21673,4396,1414,948,https://www.intensivregister.de/api/public/reporting/laendertabelle
1623457152,26069,21672,4397,1414,947,https://www.intensivregister.de/api/public/reporting/laendertabelle
1623460750,26069,21677,4392,1413,947,https://www.intensivregister.de/api/public/reporting/laendertabelle
1623464349,26063,21654,4409,1404,943,https://www.intensivregister.de/api/public/reporting/laendertabelle
1623467949,26046,21617,4429,1395,935,https://www.intensivregister.de/api/public/reporting/laendertabelle
1623471547,26010,21539,4471,1376,930,https://www.intensivregister.de/api/public/reporting/laendertabelle
1623475146,25993,21486,4507,1354,922,https://www.intensivregister.de/api/public/reporting/laendertabelle
1623478746,25975,21493,4482,1353,919,https://www.intensivregister.de/api/public/reporting/laendertabelle
1623482345,25958,21460,4498,1345,914,https://www.intensivregister.de/api/public/reporting/laendertabelle
1623485944,25956,21460,4496,1348,915,https://www.intensivregister.de/api/public/reporting/laendertabelle
1623489543,25951,21457,4494,1350,915,https://www.intensivregister.de/api/public/reporting/laendertabelle
1623493152,25951,21460,4491,1350,915,https://www.intensivregister.de/api/public/reporting/laendertabelle
1623496751,25952,21461,4491,1350,915,https://www.intensivregister.de/api/public/reporting/laendertabelle
1623500350,25952,21463,4489,1350,915,https://www.intensivregister.de/api/public/reporting/laendertabelle
1623503949,25952,21459,4493,1350,915,https://www.intensivregister.de/api/public/reporting/laendertabelle
1623507549,25952,21459,4493,1349,914,https://www.intensivregister.de/api/public/reporting/laendertabelle
1623514747,25952,21457,4495,1350,914,https://www.intensivregister.de/api/public/reporting/laendertabelle
1623518346,25952,21455,4497,1350,914,https://www.intensivregister.de/api/public/reporting/laendertabelle
1623521945,25952,21450,4502,1350,914,https://www.intensivregister.de/api/public/reporting/laendertabelle
1623529143,25952,21447,4505,1350,914,https://www.intensivregister.de/api/public/reporting/laendertabelle
1623532752,25952,21437,4515,1350,913,https://www.intensivregister.de/api/public/reporting/laendertabelle
1623536351,25950,21433,4517,1350,913,https://www.intensivregister.de/api/public/reporting/laendertabelle
1623539950,25947,21434,4513,1350,913,https://www.intensivregister.de/api/public/reporting/laendertabelle
1623543549,25944,21432,4512,1350,913,https://www.intensivregister.de/api/public/reporting/laendertabelle
1623547149,25945,21440,4505,1349,912,https://www.intensivregister.de/api/public/reporting/laendertabelle
1623550748,25933,21426,4507,1348,912,https://www.intensivregister.de/api/public/reporting/laendertabelle
1623554347,25920,21368,4552,1343,914,https://www.intensivregister.de/api/public/reporting/laendertabelle
1623557946,25887,21248,4639,1342,919,https://www.intensivregister.de/api/public/reporting/laendertabelle
1623561545,25853,21160,4693,1341,918,https://www.intensivregister.de/api/public/reporting/laendertabelle
1623565144,25831,21116,4715,1338,915,https://www.intensivregister.de/api/public/reporting/laendertabelle
1623568743,25810,21019,4791,1336,918,https://www.intensivregister.de/api/public/reporting/laendertabelle
1623572352,25809,21011,4798,1335,919,https://www.intensivregister.de/api/public/reporting/laendertabelle
1623575951,25812,21010,4802,1335,919,https://www.intensivregister.de/api/public/reporting/laendertabelle
1623579550,25812,21009,4803,1334,920,https://www.intensivregister.de/api/public/reporting/laendertabelle
1623583150,25814,21010,4804,1335,920,https://www.intensivregister.de/api/public/reporting/laendertabelle
1623590348,25812,21014,4798,1336,921,https://www.intensivregister.de/api/public/reporting/laendertabelle
1623593948,25812,21013,4799,1336,921,https://www.intensivregister.de/api/public/reporting/laendertabelle
1623608344,25814,21013,4801,1336,921,https://www.intensivregister.de/api/public/reporting/laendertabelle
1623615552,25814,21011,4803,1335,920,https://www.intensivregister.de/api/public/reporting/laendertabelle
1623619152,25816,21014,4802,1335,921,https://www.intensivregister.de/api/public/reporting/laendertabelle
1623622751,25816,21015,4801,1335,921,https://www.intensivregister.de/api/public/reporting/laendertabelle
1623626350,25818,21021,4797,1335,921,https://www.intensivregister.de/api/public/reporting/laendertabelle
1623633549,25817,21025,4792,1335,921,https://www.intensivregister.de/api/public/reporting/laendertabelle
1623637148,25849,21055,4794,1329,917,https://www.intensivregister.de/api/public/reporting/laendertabelle
1623640747,25890,21091,4799,1311,901,https://www.intensivregister.de/api/public/reporting/laendertabelle
1623644346,25949,21169,4780,1292,892,https://www.intensivregister.de/api/public/reporting/laendertabelle
1623647946,25994,21270,4724,1297,889,https://www.intensivregister.de/api/public/reporting/laendertabelle
1623651545,26010,21294,4716,1286,877,https://www.intensivregister.de/api/public/reporting/laendertabelle
1623655144,26021,21281,4740,1279,867,https://www.intensivregister.de/api/public/reporting/laendertabelle
1623658744,26023,21272,4751,1276,866,https://www.intensivregister.de/api/public/reporting/laendertabelle
1623662343,26020,21273,4747,1276,866,https://www.intensivregister.de/api/public/reporting/laendertabelle
1623665953,26020,21269,4751,1275,865,https://www.intensivregister.de/api/public/reporting/laendertabelle
1623669552,26023,21271,4752,1276,865,https://www.intensivregister.de/api/public/reporting/laendertabelle
1623676751,26026,21271,4755,1277,864,https://www.intensivregister.de/api/public/reporting/laendertabelle
1623680350,26026,21272,4754,1277,864,https://www.intensivregister.de/api/public/reporting/laendertabelle
1623687549,26026,21270,4756,1277,864,https://www.intensivregister.de/api/public/reporting/laendertabelle
1623691148,26030,21275,4755,1277,864,https://www.intensivregister.de/api/public/reporting/laendertabelle
1623694748,26041,21286,4755,1277,864,https://www.intensivregister.de/api/public/reporting/laendertabelle
1623698347,26041,21285,4756,1277,864,https://www.intensivregister.de/api/public/reporting/laendertabelle
1623701946,26043,21296,4747,1276,864,https://www.intensivregister.de/api/public/reporting/laendertabelle
1623705545,26044,21297,4747,1276,863,https://www.intensivregister.de/api/public/reporting/laendertabelle
1623709144,26045,21292,4753,1276,863,https://www.intensivregister.de/api/public/reporting/laendertabelle
1623712744,26049,21294,4755,1276,863,https://www.intensivregister.de/api/public/reporting/laendertabelle
1623716343,26049,21292,4757,1277,864,https://www.intensivregister.de/api/public/reporting/laendertabelle
1623719952,26038,21303,4735,1277,863,https://www.intensivregister.de/api/public/reporting/laendertabelle
1623723551,26042,21340,4702,1270,857,https://www.intensivregister.de/api/public/reporting/laendertabelle
1623727151,26071,21477,4594,1253,849,https://www.intensivregister.de/api/public/reporting/laendertabelle
1623730750,26100,21539,4561,1242,834,https://www.intensivregister.de/api/public/reporting/laendertabelle
1623734349,26138,21647,4491,1234,832,https://www.intensivregister.de/api/public/reporting/laendertabelle
1623737948,26108,21635,4473,1212,824,https://www.intensivregister.de/api/public/reporting/laendertabelle
1623741548,26114,21650,4464,1211,825,https://www.intensivregister.de/api/public/reporting/laendertabelle
1623745147,26115,21659,4456,1210,825,https://www.intensivregister.de/api/public/reporting/laendertabelle
1623748747,26110,21655,4455,1209,825,https://www.intensivregister.de/api/public/reporting/laendertabelle
1623752346,26120,21656,4464,1208,825,https://www.intensivregister.de/api/public/reporting/laendertabelle
1623755945,26120,21658,4462,1208,825,https://www.intensivregister.de/api/public/reporting/laendertabelle
1623759544,26120,21662,4458,1209,825,https://www.intensivregister.de/api/public/reporting/laendertabelle
1623763144,26120,21664,4456,1209,825,https://www.intensivregister.de/api/public/reporting/laendertabelle
1623766743,26120,21663,4457,1209,825,https://www.intensivregister.de/api/public/reporting/laendertabelle
1623770343,26124,21665,4459,1209,825,https://www.intensivregister.de/api/public/reporting/laendertabelle
1623773952,26124,21666,4458,1209,825,https://www.intensivregister.de/api/public/reporting/laendertabelle
1623777551,26124,21673,4451,1209,825,https://www.intensivregister.de/api/public/reporting/laendertabelle
1623788349,26122,21674,4448,1208,825,https://www.intensivregister.de/api/public/reporting/laendertabelle
1623791948,26123,21676,4447,1207,826,https://www.intensivregister.de/api/public/reporting/laendertabelle
1623799146,26121,21679,4442,1207,826,https://www.intensivregister.de/api/public/reporting/laendertabelle
1623802745,26119,21675,4444,1206,826,https://www.intensivregister.de/api/public/reporting/laendertabelle
1623806344,26118,21686,4432,1206,826,https://www.intensivregister.de/api/public/reporting/laendertabelle
1623809950,26113,21680,4433,1198,818,https://www.intensivregister.de/api/public/reporting/laendertabelle
1623813545,26107,21724,4383,1179,809,https://www.intensivregister.de/api/public/reporting/laendertabelle
1623817152,26111,21716,4395,1157,794,https://www.intensivregister.de/api/public/reporting/laendertabelle
1623820749,26119,21714,4405,1143,789,https://www.intensivregister.de/api/public/reporting/laendertabelle
1623824346,26123,21725,4398,1134,780,https://www.intensivregister.de/api/public/reporting/laendertabelle
1623827953,26118,21728,4390,1133,783,https://www.intensivregister.de/api/public/reporting/laendertabelle
1623831550,26117,21717,4400,1131,783,https://www.intensivregister.de/api/public/reporting/laendertabelle
1623835146,26118,21707,4411,1131,782,https://www.intensivregister.de/api/public/reporting/laendertabelle
1623838743,26109,21699,4410,1128,778,https://www.intensivregister.de/api/public/reporting/laendertabelle
1623842350,26109,21699,4410,1129,779,https://www.intensivregister.de/api/public/reporting/laendertabelle
1623849544,26109,21695,4414,1129,779,https://www.intensivregister.de/api/public/reporting/laendertabelle
1623853151,26110,21697,4413,1129,779,https://www.intensivregister.de/api/public/reporting/laendertabelle
1623860346,26110,21694,4416,1129,779,https://www.intensivregister.de/api/public/reporting/laendertabelle
1623863946,26112,21694,4418,1129,779,https://www.intensivregister.de/api/public/reporting/laendertabelle
1623867545,26113,21696,4417,1129,779,https://www.intensivregister.de/api/public/reporting/laendertabelle
1623871144,26113,21698,4415,1129,779,https://www.intensivregister.de/api/public/reporting/laendertabelle
1623874752,26112,21689,4423,1129,779,https://www.intensivregister.de/api/public/reporting/laendertabelle
1623878352,26112,21691,4421,1129,779,https://www.intensivregister.de/api/public/reporting/laendertabelle
1623881951,26111,21690,4421,1129,779,https://www.intensivregister.de/api/public/reporting/laendertabelle
1623885550,26111,21692,4419,1129,779,https://www.intensivregister.de/api/public/reporting/laendertabelle
1623889150,26114,21684,4430,1128,779,https://www.intensivregister.de/api/public/reporting/laendertabelle
1623892749,26116,21688,4428,1128,778,https://www.intensivregister.de/api/public/reporting/laendertabelle
1623896348,26107,21651,4456,1120,780,https://www.intensivregister.de/api/public/reporting/laendertabelle
1623899947,26094,21610,4484,1111,771,https://www.intensivregister.de/api/public/reporting/laendertabelle
1623903547,26103,21624,4479,1083,759,https://www.intensivregister.de/api/public/reporting/laendertabelle
1623907147,26098,21620,4478,1078,756,https://www.intensivregister.de/api/public/reporting/laendertabelle
1623910746,26091,21611,4480,1072,750,https://www.intensivregister.de/api/public/reporting/laendertabelle
1623914346,26068,21632,4436,1067,748,https://www.intensivregister.de/api/public/reporting/laendertabelle
1623917946,26067,21632,4435,1067,746,https://www.intensivregister.de/api/public/reporting/laendertabelle
1623921545,26067,21644,4423,1065,744,https://www.intensivregister.de/api/public/reporting/laendertabelle
1623925145,26067,21638,4429,1065,744,https://www.intensivregister.de/api/public/reporting/laendertabelle
1623928750,26068,21641,4427,1065,744,https://www.intensivregister.de/api/public/reporting/laendertabelle
1623932345,26068,21640,4428,1064,743,https://www.intensivregister.de/api/public/reporting/laendertabelle
1623935950,26068,21639,4429,1064,743,https://www.intensivregister.de/api/public/reporting/laendertabelle
1623939545,26070,21639,4431,1064,743,https://www.intensivregister.de/api/public/reporting/laendertabelle
1623957549,26070,21638,4432,1064,743,https://www.intensivregister.de/api/public/reporting/laendertabelle
1623961144,26072,21642,4430,1063,742,https://www.intensivregister.de/api/public/reporting/laendertabelle
1623964749,26071,21634,4437,1063,742,https://www.intensivregister.de/api/public/reporting/laendertabelle
1623968345,26073,21638,4435,1063,742,https://www.intensivregister.de/api/public/reporting/laendertabelle
1623975544,26072,21636,4436,1063,742,https://www.intensivregister.de/api/public/reporting/laendertabelle
1623979150,26073,21651,4422,1060,739,https://www.intensivregister.de/api/public/reporting/laendertabelle
1623982745,26073,21680,4393,1057,738,https://www.intensivregister.de/api/public/reporting/laendertabelle
1623986349,26071,21700,4371,1046,731,https://www.intensivregister.de/api/public/reporting/laendertabelle
1623989944,26057,21723,4334,1029,719,https://www.intensivregister.de/api/public/reporting/laendertabelle
1623993549,26035,21693,4342,1014,706,https://www.intensivregister.de/api/public/reporting/laendertabelle
1623997144,26027,21688,4339,1012,704,https://www.intensivregister.de/api/public/reporting/laendertabelle
1624000750,26025,21691,4334,1011,705,https://www.intensivregister.de/api/public/reporting/laendertabelle
1624004345,26027,21700,4327,1010,704,https://www.intensivregister.de/api/public/reporting/laendertabelle
1624007950,26023,21696,4327,1010,703,https://www.intensivregister.de/api/public/reporting/laendertabelle
1624011546,26023,21693,4330,1010,702,https://www.intensivregister.de/api/public/reporting/laendertabelle
1624015150,26022,21694,4328,1011,703,https://www.intensivregister.de/api/public/reporting/laendertabelle
1624018746,26024,21696,4328,1011,703,https://www.intensivregister.de/api/public/reporting/laendertabelle
1624022350,26023,21695,4328,1011,703,https://www.intensivregister.de/api/public/reporting/laendertabelle
1624025945,26021,21694,4327,1010,703,https://www.intensivregister.de/api/public/reporting/laendertabelle
1624029550,26021,21691,4330,1009,702,https://www.intensivregister.de/api/public/reporting/laendertabelle
1624047545,26019,21689,4330,1008,702,https://www.intensivregister.de/api/public/reporting/laendertabelle
1624051143,26016,21679,4337,1008,702,https://www.intensivregister.de/api/public/reporting/laendertabelle
1624054752,26014,21676,4338,1008,702,https://www.intensivregister.de/api/public/reporting/laendertabelle
1624058350,26015,21687,4328,1008,703,https://www.intensivregister.de/api/public/reporting/laendertabelle
1624061948,26015,21684,4331,1007,702,https://www.intensivregister.de/api/public/reporting/laendertabelle
1624065545,26014,21684,4330,1005,700,https://www.intensivregister.de/api/public/reporting/laendertabelle
1624069151,26022,21668,4354,999,700,https://www.intensivregister.de/api/public/reporting/laendertabelle
1624072747,26017,21666,4351,992,693,https://www.intensivregister.de/api/public/reporting/laendertabelle
1624076343,25976,21597,4379,980,682,https://www.intensivregister.de/api/public/reporting/laendertabelle
1624079949,25944,21479,4465,969,671,https://www.intensivregister.de/api/public/reporting/laendertabelle
1624083545,25920,21418,4502,964,666,https://www.intensivregister.de/api/public/reporting/laendertabelle
1624087152,25896,21364,4532,964,663,https://www.intensivregister.de/api/public/reporting/laendertabelle
1624090748,25892,21354,4538,964,662,https://www.intensivregister.de/api/public/reporting/laendertabelle
1624094345,25896,21351,4545,964,662,https://www.intensivregister.de/api/public/reporting/laendertabelle
1624097952,25897,21356,4541,964,662,https://www.intensivregister.de/api/public/reporting/laendertabelle
1624101548,25908,21359,4549,964,662,https://www.intensivregister.de/api/public/reporting/laendertabelle
1624105145,25908,21358,4550,964,662,https://www.intensivregister.de/api/public/reporting/laendertabelle
1624108752,25906,21352,4554,964,662,https://www.intensivregister.de/api/public/reporting/laendertabelle
1624115945,25906,21350,4556,964,662,https://www.intensivregister.de/api/public/reporting/laendertabelle
1624123148,25906,21347,4559,963,662,https://www.intensivregister.de/api/public/reporting/laendertabelle
1624126744,25904,21345,4559,963,662,https://www.intensivregister.de/api/public/reporting/laendertabelle
1624130351,25904,21344,4560,962,662,https://www.intensivregister.de/api/public/reporting/laendertabelle
1624133950,25904,21330,4574,962,662,https://www.intensivregister.de/api/public/reporting/laendertabelle
1624137549,25905,21327,4578,962,662,https://www.intensivregister.de/api/public/reporting/laendertabelle
1624141145,25904,21322,4582,963,662,https://www.intensivregister.de/api/public/reporting/laendertabelle
1624144747,25900,21322,4578,963,662,https://www.intensivregister.de/api/public/reporting/laendertabelle
1624148352,25900,21320,4580,963,662,https://www.intensivregister.de/api/public/reporting/laendertabelle
1624151945,25900,21311,4589,962,662,https://www.intensivregister.de/api/public/reporting/laendertabelle
1624155549,25883,21276,4607,960,661,https://www.intensivregister.de/api/public/reporting/laendertabelle
1624159143,25867,21204,4663,959,662,https://www.intensivregister.de/api/public/reporting/laendertabelle
1624162747,25829,21077,4752,954,657,https://www.intensivregister.de/api/public/reporting/laendertabelle
1624166351,25811,21006,4805,944,648,https://www.intensivregister.de/api/public/reporting/laendertabelle
1624169945,25783,20952,4831,934,639,https://www.intensivregister.de/api/public/reporting/laendertabelle
1624173549,25781,20924,4857,930,636,https://www.intensivregister.de/api/public/reporting/laendertabelle
1624177145,25784,20924,4860,931,638,https://www.intensivregister.de/api/public/reporting/laendertabelle
1624180746,25785,20927,4858,931,638,https://www.intensivregister.de/api/public/reporting/laendertabelle
1624184343,25779,20926,4853,931,638,https://www.intensivregister.de/api/public/reporting/laendertabelle
1624195147,25785,20932,4853,931,638,https://www.intensivregister.de/api/public/reporting/laendertabelle
1624198744,25785,20936,4849,931,638,https://www.intensivregister.de/api/public/reporting/laendertabelle
1624202352,25783,20937,4846,931,638,https://www.intensivregister.de/api/public/reporting/laendertabelle
1624205950,25783,20939,4844,931,638,https://www.intensivregister.de/api/public/reporting/laendertabelle
1624213145,25783,20938,4845,931,638,https://www.intensivregister.de/api/public/reporting/laendertabelle
1624216743,25778,20927,4851,931,638,https://www.intensivregister.de/api/public/reporting/laendertabelle
1624220351,25778,20922,4856,931,638,https://www.intensivregister.de/api/public/reporting/laendertabelle
1624223949,25776,20922,4854,932,638,https://www.intensivregister.de/api/public/reporting/laendertabelle
1624227547,25776,20929,4847,933,638,https://www.intensivregister.de/api/public/reporting/laendertabelle
1624231146,25776,20922,4854,933,638,https://www.intensivregister.de/api/public/reporting/laendertabelle
1624234744,25776,20920,4856,933,638,https://www.intensivregister.de/api/public/reporting/laendertabelle
1624238353,25782,20925,4857,933,638,https://www.intensivregister.de/api/public/reporting/laendertabelle
1624241951,25806,20992,4814,930,636,https://www.intensivregister.de/api/public/reporting/laendertabelle
1624245549,25841,21014,4827,915,627,https://www.intensivregister.de/api/public/reporting/laendertabelle
1624249148,25882,21068,4814,903,622,https://www.intensivregister.de/api/public/reporting/laendertabelle
1624252746,25939,21178,4761,896,617,https://www.intensivregister.de/api/public/reporting/laendertabelle
1624256345,25944,21236,4708,895,611,https://www.intensivregister.de/api/public/reporting/laendertabelle
1624259943,25935,21224,4711,889,609,https://www.intensivregister.de/api/public/reporting/laendertabelle
1624263551,25935,21218,4717,887,610,https://www.intensivregister.de/api/public/reporting/laendertabelle
1624267150,25935,21215,4720,887,610,https://www.intensivregister.de/api/public/reporting/laendertabelle
1624270745,25936,21216,4720,888,611,https://www.intensivregister.de/api/public/reporting/laendertabelle
1624274347,25934,21225,4709,888,611,https://www.intensivregister.de/api/public/reporting/laendertabelle
1624277950,25934,21230,4704,888,611,https://www.intensivregister.de/api/public/reporting/laendertabelle
1624281552,25936,21227,4709,885,611,https://www.intensivregister.de/api/public/reporting/laendertabelle
1624285145,25940,21231,4709,885,611,https://www.intensivregister.de/api/public/reporting/laendertabelle
1624299544,25941,21232,4709,885,611,https://www.intensivregister.de/api/public/reporting/laendertabelle
1624303146,25941,21233,4708,885,611,https://www.intensivregister.de/api/public/reporting/laendertabelle
1624306749,25940,21224,4716,885,611,https://www.intensivregister.de/api/public/reporting/laendertabelle
1624310350,25938,21231,4707,884,611,https://www.intensivregister.de/api/public/reporting/laendertabelle
1624313947,25938,21238,4700,884,611,https://www.intensivregister.de/api/public/reporting/laendertabelle
1624317548,25937,21237,4700,884,611,https://www.intensivregister.de/api/public/reporting/laendertabelle
1624321149,25935,21236,4699,883,610,https://www.intensivregister.de/api/public/reporting/laendertabelle
1624324751,25937,21253,4684,883,610,https://www.intensivregister.de/api/public/reporting/laendertabelle
1624328352,25953,21302,4651,883,608,https://www.intensivregister.de/api/public/reporting/laendertabelle
1624331947,25969,21413,4556,876,606,https://www.intensivregister.de/api/public/reporting/laendertabelle
1624335544,25989,21537,4452,861,597,https://www.intensivregister.de/api/public/reporting/laendertabelle
1624339146,25984,21631,4353,857,601,https://www.intensivregister.de/api/public/reporting/laendertabelle
1624342747,26005,21713,4292,855,601,https://www.intensivregister.de/api/public/reporting/laendertabelle
1624346348,26011,21719,4292,850,599,https://www.intensivregister.de/api/public/reporting/laendertabelle
1624349949,26021,21723,4298,850,600,https://www.intensivregister.de/api/public/reporting/laendertabelle
1624353551,26024,21707,4317,850,600,https://www.intensivregister.de/api/public/reporting/laendertabelle
1624357152,26024,21709,4315,850,600,https://www.intensivregister.de/api/public/reporting/laendertabelle
1624364345,26024,21707,4317,849,600,https://www.intensivregister.de/api/public/reporting/laendertabelle
1624378750,26024,21709,4315,849,600,https://www.intensivregister.de/api/public/reporting/laendertabelle
1624382352,26024,21712,4312,849,600,https://www.intensivregister.de/api/public/reporting/laendertabelle
1624389544,26024,21714,4310,849,600,https://www.intensivregister.de/api/public/reporting/laendertabelle
1624393149,26022,21720,4302,848,600,https://www.intensivregister.de/api/public/reporting/laendertabelle
1624396752,26023,21716,4307,848,600,https://www.intensivregister.de/api/public/reporting/laendertabelle
1624400345,26023,21717,4306,847,600,https://www.intensivregister.de/api/public/reporting/laendertabelle
1624403949,26023,21719,4304,847,600,https://www.intensivregister.de/api/public/reporting/laendertabelle
1624407552,26021,21717,4304,847,600,https://www.intensivregister.de/api/public/reporting/laendertabelle
1624411145,26023,21737,4286,847,600,https://www.intensivregister.de/api/public/reporting/laendertabelle
1624414749,26019,21721,4298,840,596,https://www.intensivregister.de/api/public/reporting/laendertabelle
1624418352,26035,21765,4270,834,593,https://www.intensivregister.de/api/public/reporting/laendertabelle
1624421945,26064,21797,4267,819,584,https://www.intensivregister.de/api/public/reporting/laendertabelle
1624425548,26072,21840,4232,818,583,https://www.intensivregister.de/api/public/reporting/laendertabelle
1624429152,26079,21859,4220,814,583,https://www.intensivregister.de/api/public/reporting/laendertabelle
1624432745,26067,21869,4198,815,584,https://www.intensivregister.de/api/public/reporting/laendertabelle
1624436349,26064,21860,4204,814,584,https://www.intensivregister.de/api/public/reporting/laendertabelle
1624439947,26068,21852,4216,814,584,https://www.intensivregister.de/api/public/reporting/laendertabelle
1624443545,26069,21847,4222,814,584,https://www.intensivregister.de/api/public/reporting/laendertabelle
1624450751,26069,21845,4224,816,586,https://www.intensivregister.de/api/public/reporting/laendertabelle
1624454349,26069,21846,4223,816,586,https://www.intensivregister.de/api/public/reporting/laendertabelle
1624457947,26065,21844,4221,816,586,https://www.intensivregister.de/api/public/reporting/laendertabelle
1624475947,26065,21842,4223,816,586,https://www.intensivregister.de/api/public/reporting/laendertabelle
1624479544,26061,21824,4237,816,586,https://www.intensivregister.de/api/public/reporting/laendertabelle
1624483152,26061,21825,4236,816,585,https://www.intensivregister.de/api/public/reporting/laendertabelle
1624486749,26061,21823,4238,816,585,https://www.intensivregister.de/api/public/reporting/laendertabelle
1624490348,26060,21825,4235,816,585,https://www.intensivregister.de/api/public/reporting/laendertabelle
1624493946,26058,21822,4236,816,585,https://www.intensivregister.de/api/public/reporting/laendertabelle
1624497543,26059,21823,4236,815,585,https://www.intensivregister.de/api/public/reporting/laendertabelle
1624501151,26066,21820,4246,812,586,https://www.intensivregister.de/api/public/reporting/laendertabelle
1624504749,26051,21797,4254,808,578,https://www.intensivregister.de/api/public/reporting/laendertabelle
1624508346,26010,21728,4282,805,573,https://www.intensivregister.de/api/public/reporting/laendertabelle
1624511944,26007,21694,4313,795,566,https://www.intensivregister.de/api/public/reporting/laendertabelle
1624515552,26014,21700,4314,786,558,https://www.intensivregister.de/api/public/reporting/laendertabelle
1624519150,26020,21724,4296,783,554,https://www.intensivregister.de/api/public/reporting/laendertabelle
1624522748,26028,21728,4300,781,554,https://www.intensivregister.de/api/public/reporting/laendertabelle
1624526346,26027,21719,4308,781,554,https://www.intensivregister.de/api/public/reporting/laendertabelle
1624529943,26025,21712,4313,780,554,https://www.intensivregister.de/api/public/reporting/laendertabelle
1624533551,26025,21713,4312,780,554,https://www.intensivregister.de/api/public/reporting/laendertabelle
1624537149,26023,21713,4310,780,554,https://www.intensivregister.de/api/public/reporting/laendertabelle
1624540747,26023,21717,4306,779,555,https://www.intensivregister.de/api/public/reporting/laendertabelle
1624544345,26023,21718,4305,779,555,https://www.intensivregister.de/api/public/reporting/laendertabelle
1624547943,26023,21716,4307,779,555,https://www.intensivregister.de/api/public/reporting/laendertabelle
1624551551,26023,21717,4306,779,555,https://www.intensivregister.de/api/public/reporting/laendertabelle
1624555150,26023,21718,4305,779,555,https://www.intensivregister.de/api/public/reporting/laendertabelle
1624558747,26023,21722,4301,779,554,https://www.intensivregister.de/api/public/reporting/laendertabelle
1624562345,26023,21721,4302,779,554,https://www.intensivregister.de/api/public/reporting/laendertabelle
1624565953,26022,21717,4305,779,554,https://www.intensivregister.de/api/public/reporting/laendertabelle
1624569550,26021,21715,4306,779,554,https://www.intensivregister.de/api/public/reporting/laendertabelle
1624573148,26021,21720,4301,779,554,https://www.intensivregister.de/api/public/reporting/laendertabelle
1624576745,26021,21721,4300,779,554,https://www.intensivregister.de/api/public/reporting/laendertabelle
1624580344,26018,21714,4304,779,554,https://www.intensivregister.de/api/public/reporting/laendertabelle
1624583952,26015,21713,4302,779,554,https://www.intensivregister.de/api/public/reporting/laendertabelle
1624587550,26022,21733,4289,773,548,https://www.intensivregister.de/api/public/reporting/laendertabelle
1624591148,26011,21687,4324,766,545,https://www.intensivregister.de/api/public/reporting/laendertabelle
1624594746,25995,21667,4328,758,539,https://www.intensivregister.de/api/public/reporting/laendertabelle
1624598344,25974,21673,4301,746,531,https://www.intensivregister.de/api/public/reporting/laendertabelle
1624601952,25973,21664,4309,742,525,https://www.intensivregister.de/api/public/reporting/laendertabelle
1624605550,25973,21672,4301,736,520,https://www.intensivregister.de/api/public/reporting/laendertabelle
1624609148,25959,21656,4303,737,520,https://www.intensivregister.de/api/public/reporting/laendertabelle
1624612746,25959,21654,4305,734,517,https://www.intensivregister.de/api/public/reporting/laendertabelle
1624616344,25958,21650,4308,734,517,https://www.intensivregister.de/api/public/reporting/laendertabelle
1624619952,25954,21644,4310,731,517,https://www.intensivregister.de/api/public/reporting/laendertabelle
1624623550,25952,21638,4314,731,517,https://www.intensivregister.de/api/public/reporting/laendertabelle
1624627148,25952,21641,4311,731,517,https://www.intensivregister.de/api/public/reporting/laendertabelle
1624641550,25950,21638,4312,728,515,https://www.intensivregister.de/api/public/reporting/laendertabelle
1624648745,25950,21639,4311,728,515,https://www.intensivregister.de/api/public/reporting/laendertabelle
1624652343,25950,21638,4312,728,515,https://www.intensivregister.de/api/public/reporting/laendertabelle
1624655951,25948,21642,4306,728,515,https://www.intensivregister.de/api/public/reporting/laendertabelle
1624659548,25950,21647,4303,728,515,https://www.intensivregister.de/api/public/reporting/laendertabelle
1624663146,25951,21644,4307,728,515,https://www.intensivregister.de/api/public/reporting/laendertabelle
1624666744,25951,21642,4309,728,515,https://www.intensivregister.de/api/public/reporting/laendertabelle
1624670352,25948,21626,4322,728,515,https://www.intensivregister.de/api/public/reporting/laendertabelle
1624673950,25950,21595,4355,729,515,https://www.intensivregister.de/api/public/reporting/laendertabelle
1624677547,25925,21547,4378,726,514,https://www.intensivregister.de/api/public/reporting/laendertabelle
1624681145,25880,21440,4440,714,506,https://www.intensivregister.de/api/public/reporting/laendertabelle
1624684743,25821,21340,4481,713,501,https://www.intensivregister.de/api/public/reporting/laendertabelle
1624688351,25758,21229,4529,711,497,https://www.intensivregister.de/api/public/reporting/laendertabelle
1624691949,25739,21198,4541,712,492,https://www.intensivregister.de/api/public/reporting/laendertabelle
1624695547,25735,21197,4538,713,492,https://www.intensivregister.de/api/public/reporting/laendertabelle
1624699145,25734,21191,4543,712,492,https://www.intensivregister.de/api/public/reporting/laendertabelle
1624702753,25733,21188,4545,713,493,https://www.intensivregister.de/api/public/reporting/laendertabelle
1624706350,25733,21187,4546,713,493,https://www.intensivregister.de/api/public/reporting/laendertabelle
1624709948,25734,21190,4544,713,493,https://www.intensivregister.de/api/public/reporting/laendertabelle
1624713546,25734,21189,4545,713,493,https://www.intensivregister.de/api/public/reporting/laendertabelle
1624717144,25736,21193,4543,712,492,https://www.intensivregister.de/api/public/reporting/laendertabelle
1624727947,25736,21192,4544,712,492,https://www.intensivregister.de/api/public/reporting/laendertabelle
1624738751,25736,21194,4542,711,492,https://www.intensivregister.de/api/public/reporting/laendertabelle
1624742349,25733,21194,4539,711,492,https://www.intensivregister.de/api/public/reporting/laendertabelle
1624745946,25733,21196,4537,711,492,https://www.intensivregister.de/api/public/reporting/laendertabelle
1624749544,25733,21197,4536,711,492,https://www.intensivregister.de/api/public/reporting/laendertabelle
1624753152,25732,21196,4536,711,492,https://www.intensivregister.de/api/public/reporting/laendertabelle
1624756750,25731,21198,4533,709,489,https://www.intensivregister.de/api/public/reporting/laendertabelle
1624760348,25732,21194,4538,708,487,https://www.intensivregister.de/api/public/reporting/laendertabelle
1624763945,25723,21118,4605,710,487,https://www.intensivregister.de/api/public/reporting/laendertabelle
1624767543,25718,21060,4658,706,484,https://www.intensivregister.de/api/public/reporting/laendertabelle
1624771151,25694,20925,4769,707,483,https://www.intensivregister.de/api/public/reporting/laendertabelle
1624774747,25663,20855,4808,705,482,https://www.intensivregister.de/api/public/reporting/laendertabelle
1624778346,25680,20845,4835,706,484,https://www.intensivregister.de/api/public/reporting/laendertabelle
1624781944,25680,20847,4833,705,483,https://www.intensivregister.de/api/public/reporting/laendertabelle
1624785552,25679,20845,4834,705,483,https://www.intensivregister.de/api/public/reporting/laendertabelle
1624789150,25679,20846,4833,705,483,https://www.intensivregister.de/api/public/reporting/laendertabelle
1624792749,25679,20843,4836,705,483,https://www.intensivregister.de/api/public/reporting/laendertabelle
1624796347,25679,20841,4838,705,483,https://www.intensivregister.de/api/public/reporting/laendertabelle
1624803543,25679,20839,4840,705,483,https://www.intensivregister.de/api/public/reporting/laendertabelle
1624810750,25679,20837,4842,705,483,https://www.intensivregister.de/api/public/reporting/laendertabelle
1624814348,25679,20836,4843,705,483,https://www.intensivregister.de/api/public/reporting/laendertabelle
1624825153,25681,20836,4845,705,483,https://www.intensivregister.de/api/public/reporting/laendertabelle
1624828751,25681,20833,4848,705,483,https://www.intensivregister.de/api/public/reporting/laendertabelle
1624832349,25681,20831,4850,705,483,https://www.intensivregister.de/api/public/reporting/laendertabelle
1624835947,25681,20834,4847,705,483,https://www.intensivregister.de/api/public/reporting/laendertabelle
1624839546,25682,20838,4844,706,483,https://www.intensivregister.de/api/public/reporting/laendertabelle
1624843144,25682,20837,4845,705,483,https://www.intensivregister.de/api/public/reporting/laendertabelle
1624846752,25698,20868,4830,701,482,https://www.intensivregister.de/api/public/reporting/laendertabelle
1624850350,25739,20893,4846,707,484,https://www.intensivregister.de/api/public/reporting/laendertabelle
1624853948,25812,20927,4885,702,485,https://www.intensivregister.de/api/public/reporting/laendertabelle
1624857547,25840,20983,4857,697,487,https://www.intensivregister.de/api/public/reporting/laendertabelle
1624861145,25859,21011,4848,696,486,https://www.intensivregister.de/api/public/reporting/laendertabelle
1624864744,25880,21028,4852,693,487,https://www.intensivregister.de/api/public/reporting/laendertabelle
1624868352,25894,21046,4848,693,487,https://www.intensivregister.de/api/public/reporting/laendertabelle
1624871950,25891,21041,4850,688,482,https://www.intensivregister.de/api/public/reporting/laendertabelle
1624875548,25895,21043,4852,688,482,https://www.intensivregister.de/api/public/reporting/laendertabelle
1624879147,25895,21038,4857,688,481,https://www.intensivregister.de/api/public/reporting/laendertabelle
1624882745,25895,21040,4855,688,481,https://www.intensivregister.de/api/public/reporting/laendertabelle
1624893550,25895,21038,4857,687,481,https://www.intensivregister.de/api/public/reporting/laendertabelle
1624897149,25895,21034,4861,687,481,https://www.intensivregister.de/api/public/reporting/laendertabelle
1624911552,25899,21041,4858,686,481,https://www.intensivregister.de/api/public/reporting/laendertabelle
1624915150,25899,21035,4864,685,481,https://www.intensivregister.de/api/public/reporting/laendertabelle
1624922346,25900,21038,4862,685,480,https://www.intensivregister.de/api/public/reporting/laendertabelle
1624925945,25901,21039,4862,685,480,https://www.intensivregister.de/api/public/reporting/laendertabelle
1624929543,25907,21052,4855,686,480,https://www.intensivregister.de/api/public/reporting/laendertabelle
1624933151,25896,21091,4805,687,476,https://www.intensivregister.de/api/public/reporting/laendertabelle
1624936746,25929,21192,4737,685,469,https://www.intensivregister.de/api/public/reporting/laendertabelle
1624940352,25958,21341,4617,683,469,https://www.intensivregister.de/api/public/reporting/laendertabelle
1624943948,25969,21415,4554,677,463,https://www.intensivregister.de/api/public/reporting/laendertabelle
1624947544,25977,21474,4503,675,458,https://www.intensivregister.de/api/public/reporting/laendertabelle
1624951146,25992,21507,4485,667,456,https://www.intensivregister.de/api/public/reporting/laendertabelle
1624954743,25990,21499,4491,666,455,https://www.intensivregister.de/api/public/reporting/laendertabelle
1624958351,25992,21504,4488,665,454,https://www.intensivregister.de/api/public/reporting/laendertabelle
1624961949,25992,21494,4498,663,453,https://www.intensivregister.de/api/public/reporting/laendertabelle
1624965546,25997,21491,4506,663,453,https://www.intensivregister.de/api/public/reporting/laendertabelle
1624969144,25999,21490,4509,663,453,https://www.intensivregister.de/api/public/reporting/laendertabelle
1624972752,25999,21490,4509,662,453,https://www.intensivregister.de/api/public/reporting/laendertabelle
1624990751,25999,21489,4510,662,453,https://www.intensivregister.de/api/public/reporting/laendertabelle
1624997947,25996,21491,4505,662,453,https://www.intensivregister.de/api/public/reporting/laendertabelle
1625001545,25996,21493,4503,662,453,https://www.intensivregister.de/api/public/reporting/laendertabelle
1625005153,25997,21494,4503,663,453,https://www.intensivregister.de/api/public/reporting/laendertabelle
1625008750,25999,21496,4503,663,453,https://www.intensivregister.de/api/public/reporting/laendertabelle
1625012348,25997,21491,4506,663,453,https://www.intensivregister.de/api/public/reporting/laendertabelle
1625015945,25988,21492,4496,662,452,https://www.intensivregister.de/api/public/reporting/laendertabelle
1625019543,25991,21529,4462,653,452,https://www.intensivregister.de/api/public/reporting/laendertabelle
1625023151,25987,21535,4452,646,447,https://www.intensivregister.de/api/public/reporting/laendertabelle
1625026749,26004,21541,4463,637,442,https://www.intensivregister.de/api/public/reporting/laendertabelle
1625030346,25986,21535,4451,627,434,https://www.intensivregister.de/api/public/reporting/laendertabelle
1625033944,25981,21550,4431,615,426,https://www.intensivregister.de/api/public/reporting/laendertabelle
1625037552,25984,21537,4447,614,428,https://www.intensivregister.de/api/public/reporting/laendertabelle
1625041150,25988,21539,4449,614,428,https://www.intensivregister.de/api/public/reporting/laendertabelle
1625044747,25988,21533,4455,612,426,https://www.intensivregister.de/api/public/reporting/laendertabelle
1625048345,25988,21533,4455,614,426,https://www.intensivregister.de/api/public/reporting/laendertabelle
1625051943,25988,21527,4461,614,426,https://www.intensivregister.de/api/public/reporting/laendertabelle
1625055552,25988,21523,4465,614,426,https://www.intensivregister.de/api/public/reporting/laendertabelle
1625059149,25988,21526,4462,615,427,https://www.intensivregister.de/api/public/reporting/laendertabelle
1625062747,25988,21525,4463,615,427,https://www.intensivregister.de/api/public/reporting/laendertabelle
1625066344,25988,21527,4461,615,427,https://www.intensivregister.de/api/public/reporting/laendertabelle
1625069952,25988,21524,4464,615,427,https://www.intensivregister.de/api/public/reporting/laendertabelle
1625073549,25988,21525,4463,615,427,https://www.intensivregister.de/api/public/reporting/laendertabelle
1625080745,25989,21527,4462,615,427,https://www.intensivregister.de/api/public/reporting/laendertabelle
1625084343,25989,21525,4464,615,427,https://www.intensivregister.de/api/public/reporting/laendertabelle
1625087951,25989,21528,4461,614,427,https://www.intensivregister.de/api/public/reporting/laendertabelle
1625091549,25988,21528,4460,613,427,https://www.intensivregister.de/api/public/reporting/laendertabelle
1625095147,25988,21532,4456,613,427,https://www.intensivregister.de/api/public/reporting/laendertabelle
1625098745,25990,21531,4459,613,427,https://www.intensivregister.de/api/public/reporting/laendertabelle
1625102343,25995,21537,4458,613,427,https://www.intensivregister.de/api/public/reporting/laendertabelle
1625105951,25991,21486,4505,609,426,https://www.intensivregister.de/api/public/reporting/laendertabelle
1625109549,25992,21547,4445,604,424,https://www.intensivregister.de/api/public/reporting/laendertabelle
1625113147,25983,21483,4500,604,418,https://www.intensivregister.de/api/public/reporting/laendertabelle
1625116745,25981,21477,4504,599,418,https://www.intensivregister.de/api/public/reporting/laendertabelle
1625120353,25960,21392,4568,592,413,https://www.intensivregister.de/api/public/reporting/laendertabelle
1625123950,25956,21406,4550,590,412,https://www.intensivregister.de/api/public/reporting/laendertabelle
1625127548,25952,21406,4546,590,412,https://www.intensivregister.de/api/public/reporting/laendertabelle
1625131146,25950,21403,4547,590,412,https://www.intensivregister.de/api/public/reporting/laendertabelle
1625134744,25950,21398,4552,590,412,https://www.intensivregister.de/api/public/reporting/laendertabelle
1625138352,25950,21393,4557,589,411,https://www.intensivregister.de/api/public/reporting/laendertabelle
1625141950,25949,21390,4559,589,411,https://www.intensivregister.de/api/public/reporting/laendertabelle
1625159948,25949,21391,4558,589,411,https://www.intensivregister.de/api/public/reporting/laendertabelle
1625163546,25949,21393,4556,589,411,https://www.intensivregister.de/api/public/reporting/laendertabelle
1625167144,25948,21393,4555,589,411,https://www.intensivregister.de/api/public/reporting/laendertabelle
1625170752,25945,21393,4552,589,411,https://www.intensivregister.de/api/public/reporting/laendertabelle
1625174350,25945,21395,4550,589,411,https://www.intensivregister.de/api/public/reporting/laendertabelle
1625177948,25945,21387,4558,589,411,https://www.intensivregister.de/api/public/reporting/laendertabelle
1625181546,25944,21388,4556,589,411,https://www.intensivregister.de/api/public/reporting/laendertabelle
1625185144,25942,21396,4546,589,411,https://www.intensivregister.de/api/public/reporting/laendertabelle
1625188752,25943,21407,4536,589,410,https://www.intensivregister.de/api/public/reporting/laendertabelle
1625192350,25923,21406,4517,589,409,https://www.intensivregister.de/api/public/reporting/laendertabelle
1625195948,25921,21422,4499,578,398,https://www.intensivregister.de/api/public/reporting/laendertabelle
1625199546,25894,21392,4502,572,395,https://www.intensivregister.de/api/public/reporting/laendertabelle
1625203144,25875,21388,4487,574,394,https://www.intensivregister.de/api/public/reporting/laendertabelle
1625206752,25866,21382,4484,569,391,https://www.intensivregister.de/api/public/reporting/laendertabelle
1625210349,25712,21241,4471,562,387,https://www.intensivregister.de/api/public/reporting/laendertabelle
1625213947,25707,21237,4470,562,386,https://www.intensivregister.de/api/public/reporting/laendertabelle
1625217545,25701,21238,4463,562,386,https://www.intensivregister.de/api/public/reporting/laendertabelle
1625221143,25703,21247,4456,562,386,https://www.intensivregister.de/api/public/reporting/laendertabelle
1625224752,25700,21242,4458,562,385,https://www.intensivregister.de/api/public/reporting/laendertabelle
1625228349,25672,21224,4448,560,382,https://www.intensivregister.de/api/public/reporting/laendertabelle
1625231947,25672,21225,4447,560,382,https://www.intensivregister.de/api/public/reporting/laendertabelle
1625235545,25670,21228,4442,560,382,https://www.intensivregister.de/api/public/reporting/laendertabelle
1625239143,25670,21224,4446,560,382,https://www.intensivregister.de/api/public/reporting/laendertabelle
1625242751,25670,21225,4445,560,382,https://www.intensivregister.de/api/public/reporting/laendertabelle
1625257153,25669,21221,4448,560,382,https://www.intensivregister.de/api/public/reporting/laendertabelle
1625260751,25667,21210,4457,560,382,https://www.intensivregister.de/api/public/reporting/laendertabelle
1625264348,25667,21211,4456,560,382,https://www.intensivregister.de/api/public/reporting/laendertabelle
1625267947,25664,21214,4450,560,382,https://www.intensivregister.de/api/public/reporting/laendertabelle
1625271544,25663,21209,4454,560,382,https://www.intensivregister.de/api/public/reporting/laendertabelle
1625275153,25664,21205,4459,560,382,https://www.intensivregister.de/api/public/reporting/laendertabelle
1625278750,25662,21204,4458,561,382,https://www.intensivregister.de/api/public/reporting/laendertabelle
1625282348,25645,21173,4472,558,381,https://www.intensivregister.de/api/public/reporting/laendertabelle
1625285946,25617,21092,4525,551,374,https://www.intensivregister.de/api/public/reporting/laendertabelle
1625289544,25555,20961,4594,545,370,https://www.intensivregister.de/api/public/reporting/laendertabelle
1625293152,25560,20870,4690,548,367,https://www.intensivregister.de/api/public/reporting/laendertabelle
1625296750,25538,20826,4712,547,368,https://www.intensivregister.de/api/public/reporting/laendertabelle
1625300348,25534,20812,4722,546,367,https://www.intensivregister.de/api/public/reporting/laendertabelle
1625303946,25534,20815,4719,546,368,https://www.intensivregister.de/api/public/reporting/laendertabelle
1625307543,25531,20810,4721,546,368,https://www.intensivregister.de/api/public/reporting/laendertabelle
1625311151,25531,20808,4723,546,368,https://www.intensivregister.de/api/public/reporting/laendertabelle
1625314749,25531,20807,4724,546,368,https://www.intensivregister.de/api/public/reporting/laendertabelle
1625318347,25531,20806,4725,546,368,https://www.intensivregister.de/api/public/reporting/laendertabelle
1625321945,25531,20805,4726,546,368,https://www.intensivregister.de/api/public/reporting/laendertabelle
1625329151,25531,20800,4731,546,368,https://www.intensivregister.de/api/public/reporting/laendertabelle
1625339945,25531,20799,4732,546,368,https://www.intensivregister.de/api/public/reporting/laendertabelle
1625343553,25529,20799,4730,546,368,https://www.intensivregister.de/api/public/reporting/laendertabelle
1625347150,25527,20797,4730,546,368,https://www.intensivregister.de/api/public/reporting/laendertabelle
1625350748,25525,20801,4724,546,368,https://www.intensivregister.de/api/public/reporting/laendertabelle
1625354346,25523,20799,4724,546,368,https://www.intensivregister.de/api/public/reporting/laendertabelle
1625357944,25523,20800,4723,546,368,https://www.intensivregister.de/api/public/reporting/laendertabelle
1625361552,25523,20801,4722,546,368,https://www.intensivregister.de/api/public/reporting/laendertabelle
1625365149,25515,20769,4746,547,369,https://www.intensivregister.de/api/public/reporting/laendertabelle
1625368747,25515,20719,4796,546,368,https://www.intensivregister.de/api/public/reporting/laendertabelle
1625372345,25500,20662,4838,545,366,https://www.intensivregister.de/api/public/reporting/laendertabelle
1625375943,25463,20582,4881,547,364,https://www.intensivregister.de/api/public/reporting/laendertabelle
1625379551,25461,20519,4942,547,361,https://www.intensivregister.de/api/public/reporting/laendertabelle
1625383149,25451,20484,4967,546,360,https://www.intensivregister.de/api/public/reporting/laendertabelle
1625386747,25448,20479,4969,547,361,https://www.intensivregister.de/api/public/reporting/laendertabelle
1625390345,25448,20474,4974,546,361,https://www.intensivregister.de/api/public/reporting/laendertabelle
1625393953,25448,20473,4975,546,361,https://www.intensivregister.de/api/public/reporting/laendertabelle
1625397551,25450,20475,4975,546,361,https://www.intensivregister.de/api/public/reporting/laendertabelle
1625408344,25450,20477,4973,546,361,https://www.intensivregister.de/api/public/reporting/laendertabelle
1625415550,25450,20472,4978,546,361,https://www.intensivregister.de/api/public/reporting/laendertabelle
1625419148,25473,20495,4978,546,361,https://www.intensivregister.de/api/public/reporting/laendertabelle
1625422746,25473,20498,4975,546,361,https://www.intensivregister.de/api/public/reporting/laendertabelle
1625426344,25473,20497,4976,546,361,https://www.intensivregister.de/api/public/reporting/laendertabelle
1625429952,25475,20494,4981,546,361,https://www.intensivregister.de/api/public/reporting/laendertabelle
1625433550,25475,20494,4981,545,361,https://www.intensivregister.de/api/public/reporting/laendertabelle
1625440746,25475,20497,4978,545,361,https://www.intensivregister.de/api/public/reporting/laendertabelle
1625444344,25477,20498,4979,545,361,https://www.intensivregister.de/api/public/reporting/laendertabelle
1625447952,25478,20504,4974,544,360,https://www.intensivregister.de/api/public/reporting/laendertabelle
1625451550,25512,20505,5007,543,359,https://www.intensivregister.de/api/public/reporting/laendertabelle
1625455148,25552,20505,5047,534,357,https://www.intensivregister.de/api/public/reporting/laendertabelle
1625458746,25587,20516,5071,535,359,https://www.intensivregister.de/api/public/reporting/laendertabelle
1625462344,25645,20600,5045,532,357,https://www.intensivregister.de/api/public/reporting/laendertabelle
1625465952,25661,20614,5047,531,358,https://www.intensivregister.de/api/public/reporting/laendertabelle
1625469550,25681,20621,5060,526,355,https://www.intensivregister.de/api/public/reporting/laendertabelle
1625473148,25683,20627,5056,526,355,https://www.intensivregister.de/api/public/reporting/laendertabelle
1625476746,25689,20639,5050,526,355,https://www.intensivregister.de/api/public/reporting/laendertabelle
1625480344,25684,20630,5054,525,355,https://www.intensivregister.de/api/public/reporting/laendertabelle
1625483952,25684,20629,5055,525,355,https://www.intensivregister.de/api/public/reporting/laendertabelle
1625487550,25684,20635,5049,525,355,https://www.intensivregister.de/api/public/reporting/laendertabelle
1625516352,25688,20628,5060,525,354,https://www.intensivregister.de/api/public/reporting/laendertabelle
1625519950,25685,20629,5056,526,354,https://www.intensivregister.de/api/public/reporting/laendertabelle
1625523548,25685,20630,5055,526,354,https://www.intensivregister.de/api/public/reporting/laendertabelle
1625527145,25684,20630,5054,528,355,https://www.intensivregister.de/api/public/reporting/laendertabelle
1625530743,25684,20633,5051,527,354,https://www.intensivregister.de/api/public/reporting/laendertabelle
1625534351,25689,20649,5040,525,352,https://www.intensivregister.de/api/public/reporting/laendertabelle
1625537994,25712,20748,4964,525,350,https://www.intensivregister.de/api/public/reporting/laendertabelle
1625541546,25727,20866,4861,520,346,https://www.intensivregister.de/api/public/reporting/laendertabelle
1625545144,25724,21001,4723,514,338,https://www.intensivregister.de/api/public/reporting/laendertabelle
1625548752,25747,21078,4669,512,332,https://www.intensivregister.de/api/public/reporting/laendertabelle
1625552350,25774,21112,4662,509,331,https://www.intensivregister.de/api/public/reporting/laendertabelle
1625555948,25785,21145,4640,509,329,https://www.intensivregister.de/api/public/reporting/laendertabelle
1625559546,25783,21153,4630,508,329,https://www.intensivregister.de/api/public/reporting/laendertabelle
1625563144,25783,21166,4617,508,329,https://www.intensivregister.de/api/public/reporting/laendertabelle
1625566752,25783,21168,4615,508,329,https://www.intensivregister.de/api/public/reporting/laendertabelle
1625570350,25783,21164,4619,508,329,https://www.intensivregister.de/api/public/reporting/laendertabelle
1625573948,25783,21164,4619,506,326,https://www.intensivregister.de/api/public/reporting/laendertabelle
1625577546,25783,21157,4626,506,325,https://www.intensivregister.de/api/public/reporting/laendertabelle
1625595545,25783,21159,4624,506,325,https://www.intensivregister.de/api/public/reporting/laendertabelle
1625599143,25783,21157,4626,506,325,https://www.intensivregister.de/api/public/reporting/laendertabelle
1625602751,25782,21157,4625,506,325,https://www.intensivregister.de/api/public/reporting/laendertabelle
1625606349,25780,21155,4625,505,325,https://www.intensivregister.de/api/public/reporting/laendertabelle
1625609947,25780,21154,4626,505,325,https://www.intensivregister.de/api/public/reporting/laendertabelle
1625613545,25780,21155,4625,505,325,https://www.intensivregister.de/api/public/reporting/laendertabelle
1625617153,25780,21151,4629,505,325,https://www.intensivregister.de/api/public/reporting/laendertabelle
1625620749,25782,21139,4643,503,323,https://www.intensivregister.de/api/public/reporting/laendertabelle
1625624347,25792,21133,4659,505,323,https://www.intensivregister.de/api/public/reporting/laendertabelle
1625627944,25782,21146,4636,496,319,https://www.intensivregister.de/api/public/reporting/laendertabelle
1625631552,25772,21206,4566,490,309,https://www.intensivregister.de/api/public/reporting/laendertabelle
1625635150,25786,21210,4576,488,310,https://www.intensivregister.de/api/public/reporting/laendertabelle
1625638748,25790,21245,4545,487,305,https://www.intensivregister.de/api/public/reporting/laendertabelle
1625642345,25797,21272,4525,483,303,https://www.intensivregister.de/api/public/reporting/laendertabelle
1625645943,25799,21268,4531,484,303,https://www.intensivregister.de/api/public/reporting/laendertabelle
1625649551,25799,21269,4530,484,303,https://www.intensivregister.de/api/public/reporting/laendertabelle
1625653149,25799,21268,4531,484,303,https://www.intensivregister.de/api/public/reporting/laendertabelle
1625656747,25799,21266,4533,484,303,https://www.intensivregister.de/api/public/reporting/laendertabelle
1625660345,25803,21269,4534,484,303,https://www.intensivregister.de/api/public/reporting/laendertabelle
1625663953,25803,21272,4531,484,303,https://www.intensivregister.de/api/public/reporting/laendertabelle
1625667550,25803,21271,4532,484,303,https://www.intensivregister.de/api/public/reporting/laendertabelle
1625674746,25803,21269,4534,484,303,https://www.intensivregister.de/api/public/reporting/laendertabelle
1625681952,25802,21267,4535,484,303,https://www.intensivregister.de/api/public/reporting/laendertabelle
1625689147,25796,21263,4533,484,303,https://www.intensivregister.de/api/public/reporting/laendertabelle
1625692745,25796,21262,4534,484,303,https://www.intensivregister.de/api/public/reporting/laendertabelle
1625696353,25796,21258,4538,484,303,https://www.intensivregister.de/api/public/reporting/laendertabelle
1625699950,25800,21252,4548,484,304,https://www.intensivregister.de/api/public/reporting/laendertabelle
1625703546,25800,21253,4547,484,304,https://www.intensivregister.de/api/public/reporting/laendertabelle
1625707143,25796,21252,4544,484,305,https://www.intensivregister.de/api/public/reporting/laendertabelle
1625710751,25786,21242,4544,484,306,https://www.intensivregister.de/api/public/reporting/laendertabelle
1625714348,25798,21251,4547,483,305,https://www.intensivregister.de/api/public/reporting/laendertabelle
1625717945,25806,21242,4564,475,303,https://www.intensivregister.de/api/public/reporting/laendertabelle
1625721557,25789,21201,4588,472,300,https://www.intensivregister.de/api/public/reporting/laendertabelle
1625725150,25800,21194,4606,471,300,https://www.intensivregister.de/api/public/reporting/laendertabelle
1625728747,25796,21175,4621,470,299,https://www.intensivregister.de/api/public/reporting/laendertabelle
1625732345,25788,21165,4623,470,296,https://www.intensivregister.de/api/public/reporting/laendertabelle
1625735952,25786,21160,4626,469,297,https://www.intensivregister.de/api/public/reporting/laendertabelle
1625739549,25787,21168,4619,469,297,https://www.intensivregister.de/api/public/reporting/laendertabelle
1625743147,25783,21166,4617,469,298,https://www.intensivregister.de/api/public/reporting/laendertabelle
1625746744,25776,21165,4611,468,297,https://www.intensivregister.de/api/public/reporting/laendertabelle
1625757552,25776,21164,4612,468,297,https://www.intensivregister.de/api/public/reporting/laendertabelle
1625761150,25776,21161,4615,468,297,https://www.intensivregister.de/api/public/reporting/laendertabelle
1625771952,25776,21162,4614,468,297,https://www.intensivregister.de/api/public/reporting/laendertabelle
1625775549,25780,21157,4623,467,297,https://www.intensivregister.de/api/public/reporting/laendertabelle
1625779146,25782,21158,4624,467,296,https://www.intensivregister.de/api/public/reporting/laendertabelle
1625782744,25782,21166,4616,467,296,https://www.intensivregister.de/api/public/reporting/laendertabelle
1625786351,25779,21164,4615,467,296,https://www.intensivregister.de/api/public/reporting/laendertabelle
1625789948,25781,21167,4614,467,296,https://www.intensivregister.de/api/public/reporting/laendertabelle
1625793545,25779,21173,4606,467,296,https://www.intensivregister.de/api/public/reporting/laendertabelle
1625797153,25770,21207,4563,465,295,https://www.intensivregister.de/api/public/reporting/laendertabelle
1625800750,25727,21146,4581,463,296,https://www.intensivregister.de/api/public/reporting/laendertabelle
1625804347,25692,21143,4549,456,295,https://www.intensivregister.de/api/public/reporting/laendertabelle
1625807945,25673,21176,4497,450,291,https://www.intensivregister.de/api/public/reporting/laendertabelle
1625811554,25664,21190,4474,453,292,https://www.intensivregister.de/api/public/reporting/laendertabelle
1625815149,25634,21176,4458,453,293,https://www.intensivregister.de/api/public/reporting/laendertabelle
1625818747,25663,21185,4478,453,293,https://www.intensivregister.de/api/public/reporting/laendertabelle
1625822344,25651,21168,4483,453,293,https://www.intensivregister.de/api/public/reporting/laendertabelle
1625825951,25620,21151,4469,451,291,https://www.intensivregister.de/api/public/reporting/laendertabelle
1625829549,25618,21154,4464,447,288,https://www.intensivregister.de/api/public/reporting/laendertabelle
1625833147,25618,21151,4467,447,288,https://www.intensivregister.de/api/public/reporting/laendertabelle
1625836744,25618,21150,4468,447,288,https://www.intensivregister.de/api/public/reporting/laendertabelle
1625840351,25620,21149,4471,447,288,https://www.intensivregister.de/api/public/reporting/laendertabelle
1625851143,25620,21149,4471,448,288,https://www.intensivregister.de/api/public/reporting/laendertabelle
1625861944,25612,21144,4468,448,288,https://www.intensivregister.de/api/public/reporting/laendertabelle
1625865552,25613,21147,4466,448,288,https://www.intensivregister.de/api/public/reporting/laendertabelle
1625869149,25614,21138,4476,448,288,https://www.intensivregister.de/api/public/reporting/laendertabelle
1625872747,25614,21140,4474,448,288,https://www.intensivregister.de/api/public/reporting/laendertabelle
1625876344,25614,21142,4472,448,288,https://www.intensivregister.de/api/public/reporting/laendertabelle
1625879950,25618,21140,4478,448,288,https://www.intensivregister.de/api/public/reporting/laendertabelle
1625883544,25610,21128,4482,448,288,https://www.intensivregister.de/api/public/reporting/laendertabelle
1625887147,25589,21043,4546,445,285,https://www.intensivregister.de/api/public/reporting/laendertabelle
1625890751,25561,20944,4617,439,285,https://www.intensivregister.de/api/public/reporting/laendertabelle
1625894345,25502,20841,4661,439,285,https://www.intensivregister.de/api/public/reporting/laendertabelle
1625897948,25471,20736,4735,440,285,https://www.intensivregister.de/api/public/reporting/laendertabelle
1625901552,25450,20700,4750,437,283,https://www.intensivregister.de/api/public/reporting/laendertabelle
1625905146,25447,20690,4757,435,283,https://www.intensivregister.de/api/public/reporting/laendertabelle
1625908751,25448,20691,4757,435,283,https://www.intensivregister.de/api/public/reporting/laendertabelle
1625915948,25440,20688,4752,435,283,https://www.intensivregister.de/api/public/reporting/laendertabelle
1625919551,25436,20686,4750,435,283,https://www.intensivregister.de/api/public/reporting/laendertabelle
1625926748,25436,20685,4751,435,283,https://www.intensivregister.de/api/public/reporting/laendertabelle
1625930352,25420,20671,4749,435,283,https://www.intensivregister.de/api/public/reporting/laendertabelle
1625933945,25420,20664,4756,435,283,https://www.intensivregister.de/api/public/reporting/laendertabelle
1625937549,25420,20662,4758,436,283,https://www.intensivregister.de/api/public/reporting/laendertabelle
1625944746,25420,20663,4757,436,283,https://www.intensivregister.de/api/public/reporting/laendertabelle
1625948351,25421,20653,4768,441,283,https://www.intensivregister.de/api/public/reporting/laendertabelle
1625951944,25422,20641,4781,441,283,https://www.intensivregister.de/api/public/reporting/laendertabelle
1625955548,25421,20639,4782,441,283,https://www.intensivregister.de/api/public/reporting/laendertabelle
1625959151,25420,20645,4775,441,282,https://www.intensivregister.de/api/public/reporting/laendertabelle
1625962745,25420,20644,4776,441,282,https://www.intensivregister.de/api/public/reporting/laendertabelle
1625966348,25420,20650,4770,441,282,https://www.intensivregister.de/api/public/reporting/laendertabelle
1625969952,25416,20633,4783,441,281,https://www.intensivregister.de/api/public/reporting/laendertabelle
1625973545,25419,20591,4828,441,279,https://www.intensivregister.de/api/public/reporting/laendertabelle
1625977149,25410,20471,4939,436,273,https://www.intensivregister.de/api/public/reporting/laendertabelle
1625980752,25338,20337,5001,435,268,https://www.intensivregister.de/api/public/reporting/laendertabelle
1625984346,25323,20276,5047,435,267,https://www.intensivregister.de/api/public/reporting/laendertabelle
1625987950,25329,20283,5046,433,268,https://www.intensivregister.de/api/public/reporting/laendertabelle
1625991545,25332,20281,5051,433,268,https://www.intensivregister.de/api/public/reporting/laendertabelle
1625995146,25335,20283,5052,434,269,https://www.intensivregister.de/api/public/reporting/laendertabelle
1625998750,25334,20284,5050,434,269,https://www.intensivregister.de/api/public/reporting/laendertabelle
1626002343,25334,20283,5051,434,269,https://www.intensivregister.de/api/public/reporting/laendertabelle
1626005947,25335,20281,5054,434,269,https://www.intensivregister.de/api/public/reporting/laendertabelle
1626009551,25335,20283,5052,434,269,https://www.intensivregister.de/api/public/reporting/laendertabelle
1626013144,25335,20286,5049,434,269,https://www.intensivregister.de/api/public/reporting/laendertabelle
1626016748,25335,20288,5047,434,269,https://www.intensivregister.de/api/public/reporting/laendertabelle
1626020351,25335,20289,5046,434,269,https://www.intensivregister.de/api/public/reporting/laendertabelle
1626023945,25335,20287,5048,434,269,https://www.intensivregister.de/api/public/reporting/laendertabelle
1626034745,25336,20280,5056,429,269,https://www.intensivregister.de/api/public/reporting/laendertabelle
1626038348,25336,20279,5057,429,269,https://www.intensivregister.de/api/public/reporting/laendertabelle
1626041952,25336,20277,5059,429,270,https://www.intensivregister.de/api/public/reporting/laendertabelle
1626052743,25336,20282,5054,430,270,https://www.intensivregister.de/api/public/reporting/laendertabelle
1626056346,25359,20260,5099,433,271,https://www.intensivregister.de/api/public/reporting/laendertabelle
1626059950,25439,20289,5150,439,274,https://www.intensivregister.de/api/public/reporting/laendertabelle
1626063543,25481,20336,5145,439,274,https://www.intensivregister.de/api/public/reporting/laendertabelle
1626067147,25544,20399,5145,436,278,https://www.intensivregister.de/api/public/reporting/laendertabelle
1626070751,25565,20451,5114,440,278,https://www.intensivregister.de/api/public/reporting/laendertabelle
1626074345,25572,20454,5118,435,278,https://www.intensivregister.de/api/public/reporting/laendertabelle
1626077949,25578,20474,5104,433,277,https://www.intensivregister.de/api/public/reporting/laendertabelle
1626081553,25578,20468,5110,432,277,https://www.intensivregister.de/api/public/reporting/laendertabelle
1626085146,25578,20473,5105,432,277,https://www.intensivregister.de/api/public/reporting/laendertabelle
1626088750,25578,20476,5102,431,276,https://www.intensivregister.de/api/public/reporting/laendertabelle
1626110358,25578,20473,5105,431,276,https://www.intensivregister.de/api/public/reporting/laendertabelle
1626117549,25576,20475,5101,431,276,https://www.intensivregister.de/api/public/reporting/laendertabelle
1626121143,25573,20482,5091,431,276,https://www.intensivregister.de/api/public/reporting/laendertabelle
1626124746,25573,20493,5080,431,276,https://www.intensivregister.de/api/public/reporting/laendertabelle
1626128350,25574,20496,5078,431,276,https://www.intensivregister.de/api/public/reporting/laendertabelle
1626131944,25574,20495,5079,430,275,https://www.intensivregister.de/api/public/reporting/laendertabelle
1626135547,25574,20491,5083,430,275,https://www.intensivregister.de/api/public/reporting/laendertabelle
1626139151,25549,20479,5070,429,273,https://www.intensivregister.de/api/public/reporting/laendertabelle
1626142745,25559,20578,4981,430,274,https://www.intensivregister.de/api/public/reporting/laendertabelle
1626146348,25588,20704,4884,423,271,https://www.intensivregister.de/api/public/reporting/laendertabelle
1626149951,25609,20914,4695,414,268,https://www.intensivregister.de/api/public/reporting/laendertabelle
1626153545,25618,21008,4610,410,268,https://www.intensivregister.de/api/public/reporting/laendertabelle
1626157149,25603,21014,4589,408,267,https://www.intensivregister.de/api/public/reporting/laendertabelle
1626160753,25603,21022,4581,408,266,https://www.intensivregister.de/api/public/reporting/laendertabelle
1626164346,25620,21040,4580,407,265,https://www.intensivregister.de/api/public/reporting/laendertabelle
1626167950,25621,21034,4587,407,265,https://www.intensivregister.de/api/public/reporting/laendertabelle
1626171544,25620,21036,4584,407,266,https://www.intensivregister.de/api/public/reporting/laendertabelle
1626175148,25626,21039,4587,407,266,https://www.intensivregister.de/api/public/reporting/laendertabelle
1626178751,25622,21042,4580,407,266,https://www.intensivregister.de/api/public/reporting/laendertabelle
1626182345,25622,21048,4574,407,266,https://www.intensivregister.de/api/public/reporting/laendertabelle
1626185949,25621,21048,4573,407,266,https://www.intensivregister.de/api/public/reporting/laendertabelle
1626189552,25621,21050,4571,407,266,https://www.intensivregister.de/api/public/reporting/laendertabelle
1626196749,25621,21051,4570,407,266,https://www.intensivregister.de/api/public/reporting/laendertabelle
1626203947,25621,21050,4571,407,266,https://www.intensivregister.de/api/public/reporting/laendertabelle
1626207551,25623,21042,4581,407,266,https://www.intensivregister.de/api/public/reporting/laendertabelle
1626214748,25624,21044,4580,407,266,https://www.intensivregister.de/api/public/reporting/laendertabelle
1626221945,25648,21063,4585,407,266,https://www.intensivregister.de/api/public/reporting/laendertabelle
1626225549,25648,21069,4579,406,266,https://www.intensivregister.de/api/public/reporting/laendertabelle
1626229152,25651,21079,4572,403,266,https://www.intensivregister.de/api/public/reporting/laendertabelle
1626232746,25661,21130,4531,406,267,https://www.intensivregister.de/api/public/reporting/laendertabelle
1626236349,25671,21175,4496,402,264,https://www.intensivregister.de/api/public/reporting/laendertabelle
1626239944,25643,21171,4472,398,260,https://www.intensivregister.de/api/public/reporting/laendertabelle
1626243547,25624,21187,4437,394,259,https://www.intensivregister.de/api/public/reporting/laendertabelle
1626247151,25626,21174,4452,397,260,https://www.intensivregister.de/api/public/reporting/laendertabelle
1626250744,25624,21172,4452,398,260,https://www.intensivregister.de/api/public/reporting/laendertabelle
1626254348,25622,21171,4451,398,260,https://www.intensivregister.de/api/public/reporting/laendertabelle
1626257952,25622,21176,4446,398,260,https://www.intensivregister.de/api/public/reporting/laendertabelle
1626261546,25622,21181,4441,398,260,https://www.intensivregister.de/api/public/reporting/laendertabelle
1626265150,25622,21184,4438,398,260,https://www.intensivregister.de/api/public/reporting/laendertabelle
1626268744,25621,21181,4440,398,260,https://www.intensivregister.de/api/public/reporting/laendertabelle
1626272347,25621,21180,4441,399,261,https://www.intensivregister.de/api/public/reporting/laendertabelle
1626283148,25621,21181,4440,399,261,https://www.intensivregister.de/api/public/reporting/laendertabelle
1626293951,25620,21183,4437,401,262,https://www.intensivregister.de/api/public/reporting/laendertabelle
1626297552,25620,21185,4435,401,262,https://www.intensivregister.de/api/public/reporting/laendertabelle
1626301146,25619,21185,4434,401,262,https://www.intensivregister.de/api/public/reporting/laendertabelle
1626304749,25619,21188,4431,401,262,https://www.intensivregister.de/api/public/reporting/laendertabelle
1626308343,25614,21184,4430,401,262,https://www.intensivregister.de/api/public/reporting/laendertabelle
1626311946,25614,21175,4439,399,261,https://www.intensivregister.de/api/public/reporting/laendertabelle
1626315550,25605,21162,4443,400,262,https://www.intensivregister.de/api/public/reporting/laendertabelle
1626319144,25611,21153,4458,400,260,https://www.intensivregister.de/api/public/reporting/laendertabelle
1626322747,25617,21210,4407,397,257,https://www.intensivregister.de/api/public/reporting/laendertabelle
1626326351,25615,21185,4430,395,253,https://www.intensivregister.de/api/public/reporting/laendertabelle
1626329944,25592,21158,4434,396,254,https://www.intensivregister.de/api/public/reporting/laendertabelle
1626333548,25594,21179,4415,395,253,https://www.intensivregister.de/api/public/reporting/laendertabelle
1626337152,25587,21156,4431,396,254,https://www.intensivregister.de/api/public/reporting/laendertabelle
1626340745,25590,21156,4434,396,254,https://www.intensivregister.de/api/public/reporting/laendertabelle
1626344349,25590,21159,4431,396,254,https://www.intensivregister.de/api/public/reporting/laendertabelle
1626347943,25588,21156,4432,397,254,https://www.intensivregister.de/api/public/reporting/laendertabelle
1626351547,25588,21154,4434,397,254,https://www.intensivregister.de/api/public/reporting/laendertabelle
1626365952,25588,21158,4430,397,254,https://www.intensivregister.de/api/public/reporting/laendertabelle
1626380346,25586,21159,4427,397,254,https://www.intensivregister.de/api/public/reporting/laendertabelle
1626383950,25586,21160,4426,397,254,https://www.intensivregister.de/api/public/reporting/laendertabelle
1626387544,25586,21158,4428,396,254,https://www.intensivregister.de/api/public/reporting/laendertabelle
1626391147,25588,21154,4434,396,254,https://www.intensivregister.de/api/public/reporting/laendertabelle
1626394751,25588,21150,4438,396,254,https://www.intensivregister.de/api/public/reporting/laendertabelle
1626398352,25591,21164,4427,396,254,https://www.intensivregister.de/api/public/reporting/laendertabelle
1626401946,25585,21165,4420,394,255,https://www.intensivregister.de/api/public/reporting/laendertabelle
1626405548,25522,21127,4395,390,250,https://www.intensivregister.de/api/public/reporting/laendertabelle
1626409150,25471,21111,4360,383,246,https://www.intensivregister.de/api/public/reporting/laendertabelle
1626412753,25425,21045,4380,382,242,https://www.intensivregister.de/api/public/reporting/laendertabelle
1626416349,25425,21035,4390,379,240,https://www.intensivregister.de/api/public/reporting/laendertabelle
1626419951,25390,21029,4361,379,240,https://www.intensivregister.de/api/public/reporting/laendertabelle
1626423544,25390,21025,4365,378,240,https://www.intensivregister.de/api/public/reporting/laendertabelle
1626427147,25394,21026,4368,378,240,https://www.intensivregister.de/api/public/reporting/laendertabelle
1626430749,25394,21030,4364,379,240,https://www.intensivregister.de/api/public/reporting/laendertabelle
1626434351,25397,21032,4365,379,240,https://www.intensivregister.de/api/public/reporting/laendertabelle
1626437944,25397,21038,4359,380,240,https://www.intensivregister.de/api/public/reporting/laendertabelle
1626445149,25398,21040,4358,380,240,https://www.intensivregister.de/api/public/reporting/laendertabelle
1626448751,25395,21035,4360,380,240,https://www.intensivregister.de/api/public/reporting/laendertabelle
1626466747,25397,21029,4368,380,240,https://www.intensivregister.de/api/public/reporting/laendertabelle
1626470349,25398,21025,4373,380,240,https://www.intensivregister.de/api/public/reporting/laendertabelle
1626473952,25397,21024,4373,380,239,https://www.intensivregister.de/api/public/reporting/laendertabelle
1626477544,25397,21020,4377,380,239,https://www.intensivregister.de/api/public/reporting/laendertabelle
1626481147,25395,21018,4377,380,239,https://www.intensivregister.de/api/public/reporting/laendertabelle
1626484748,25387,21009,4378,380,239,https://www.intensivregister.de/api/public/reporting/laendertabelle
1626488351,25365,20975,4390,377,237,https://www.intensivregister.de/api/public/reporting/laendertabelle
1626491943,25346,20945,4401,376,236,https://www.intensivregister.de/api/public/reporting/laendertabelle
1626495545,25329,20852,4477,380,240,https://www.intensivregister.de/api/public/reporting/laendertabelle
1626499148,25268,20709,4559,377,239,https://www.intensivregister.de/api/public/reporting/laendertabelle
1626502750,25270,20695,4575,372,232,https://www.intensivregister.de/api/public/reporting/laendertabelle
1626506343,25282,20704,4578,371,232,https://www.intensivregister.de/api/public/reporting/laendertabelle
1626509948,25276,20695,4581,371,232,https://www.intensivregister.de/api/public/reporting/laendertabelle
1626513547,25276,20694,4582,372,232,https://www.intensivregister.de/api/public/reporting/laendertabelle
1626517150,25276,20688,4588,372,232,https://www.intensivregister.de/api/public/reporting/laendertabelle
1626520752,25276,20687,4589,372,232,https://www.intensivregister.de/api/public/reporting/laendertabelle
1626524344,25276,20686,4590,372,232,https://www.intensivregister.de/api/public/reporting/laendertabelle
1626527946,25276,20683,4593,372,232,https://www.intensivregister.de/api/public/reporting/laendertabelle
1626535151,25280,20682,4598,371,232,https://www.intensivregister.de/api/public/reporting/laendertabelle
1626538743,25280,20678,4602,371,232,https://www.intensivregister.de/api/public/reporting/laendertabelle
1626545948,25280,20675,4605,371,232,https://www.intensivregister.de/api/public/reporting/laendertabelle
1626549550,25280,20677,4603,371,232,https://www.intensivregister.de/api/public/reporting/laendertabelle
1626553143,25279,20668,4611,371,232,https://www.intensivregister.de/api/public/reporting/laendertabelle
1626556745,25277,20657,4620,371,232,https://www.intensivregister.de/api/public/reporting/laendertabelle
1626560347,25280,20660,4620,371,232,https://www.intensivregister.de/api/public/reporting/laendertabelle
1626563950,25281,20658,4623,370,231,https://www.intensivregister.de/api/public/reporting/laendertabelle
1626567552,25280,20657,4623,370,231,https://www.intensivregister.de/api/public/reporting/laendertabelle
1626571144,25281,20650,4631,370,231,https://www.intensivregister.de/api/public/reporting/laendertabelle
1626574747,25274,20630,4644,372,231,https://www.intensivregister.de/api/public/reporting/laendertabelle
1626578350,25268,20575,4693,371,229,https://www.intensivregister.de/api/public/reporting/laendertabelle
1626581952,25251,20456,4795,371,229,https://www.intensivregister.de/api/public/reporting/laendertabelle
1626585544,25237,20380,4857,369,233,https://www.intensivregister.de/api/public/reporting/laendertabelle
1626589147,25213,20304,4909,369,235,https://www.intensivregister.de/api/public/reporting/laendertabelle
1626592749,25213,20301,4912,370,236,https://www.intensivregister.de/api/public/reporting/laendertabelle
1626596351,25212,20300,4912,370,236,https://www.intensivregister.de/api/public/reporting/laendertabelle
1626599944,25212,20301,4911,370,236,https://www.intensivregister.de/api/public/reporting/laendertabelle
1626603546,25210,20301,4909,370,236,https://www.intensivregister.de/api/public/reporting/laendertabelle
1626607148,25208,20298,4910,370,237,https://www.intensivregister.de/api/public/reporting/laendertabelle
1626610750,25209,20299,4910,370,237,https://www.intensivregister.de/api/public/reporting/laendertabelle
1626614352,25209,20289,4920,370,237,https://www.intensivregister.de/api/public/reporting/laendertabelle
1626617945,25200,20282,4918,370,237,https://www.intensivregister.de/api/public/reporting/laendertabelle
1626621547,25200,20285,4915,370,237,https://www.intensivregister.de/api/public/reporting/laendertabelle
1626625149,25200,20288,4912,370,237,https://www.intensivregister.de/api/public/reporting/laendertabelle
1626632343,25200,20291,4909,370,237,https://www.intensivregister.de/api/public/reporting/laendertabelle
1626639547,25198,20291,4907,370,237,https://www.intensivregister.de/api/public/reporting/laendertabelle
1626643149,25197,20294,4903,370,237,https://www.intensivregister.de/api/public/reporting/laendertabelle
1626646752,25196,20296,4900,370,237,https://www.intensivregister.de/api/public/reporting/laendertabelle
1626650344,25193,20299,4894,370,237,https://www.intensivregister.de/api/public/reporting/laendertabelle
1626653946,25193,20298,4895,370,237,https://www.intensivregister.de/api/public/reporting/laendertabelle
1626657548,25193,20299,4894,370,237,https://www.intensivregister.de/api/public/reporting/laendertabelle
1626661150,25235,20311,4924,369,236,https://www.intensivregister.de/api/public/reporting/laendertabelle
1626664752,25297,20378,4919,369,234,https://www.intensivregister.de/api/public/reporting/laendertabelle
1626668344,25381,20437,4944,369,230,https://www.intensivregister.de/api/public/reporting/laendertabelle
1626671946,25435,20486,4949,373,228,https://www.intensivregister.de/api/public/reporting/laendertabelle
1626675549,25453,20507,4946,369,227,https://www.intensivregister.de/api/public/reporting/laendertabelle
1626679151,25452,20491,4961,369,227,https://www.intensivregister.de/api/public/reporting/laendertabelle
1626682743,25455,20501,4954,369,227,https://www.intensivregister.de/api/public/reporting/laendertabelle
1626686345,25455,20500,4955,369,227,https://www.intensivregister.de/api/public/reporting/laendertabelle
1626689948,25456,20499,4957,369,227,https://www.intensivregister.de/api/public/reporting/laendertabelle
1626693550,25460,20505,4955,369,227,https://www.intensivregister.de/api/public/reporting/laendertabelle
1626700744,25460,20506,4954,369,227,https://www.intensivregister.de/api/public/reporting/laendertabelle
1626704350,25460,20509,4951,369,227,https://www.intensivregister.de/api/public/reporting/laendertabelle
1626707952,25460,20508,4952,369,227,https://www.intensivregister.de/api/public/reporting/laendertabelle
1626711553,25460,20509,4951,369,227,https://www.intensivregister.de/api/public/reporting/laendertabelle
1626718748,25460,20506,4954,369,227,https://www.intensivregister.de/api/public/reporting/laendertabelle
1626725952,25461,20503,4958,369,227,https://www.intensivregister.de/api/public/reporting/laendertabelle
1626729554,25459,20505,4954,369,227,https://www.intensivregister.de/api/public/reporting/laendertabelle
1626736751,25459,20510,4949,369,227,https://www.intensivregister.de/api/public/reporting/laendertabelle
1626740347,25461,20514,4947,369,227,https://www.intensivregister.de/api/public/reporting/laendertabelle
1626743949,25460,20518,4942,369,227,https://www.intensivregister.de/api/public/reporting/laendertabelle
1626747551,25470,20575,4895,369,224,https://www.intensivregister.de/api/public/reporting/laendertabelle
1626751154,25474,20745,4729,365,218,https://www.intensivregister.de/api/public/reporting/laendertabelle
1626754756,25488,20879,4609,368,216,https://www.intensivregister.de/api/public/reporting/laendertabelle
1626758348,25499,20945,4554,363,215,https://www.intensivregister.de/api/public/reporting/laendertabelle
1626761951,25495,20988,4507,360,212,https://www.intensivregister.de/api/public/reporting/laendertabelle
1626765553,25513,21013,4500,361,214,https://www.intensivregister.de/api/public/reporting/laendertabelle
1626769156,25513,21010,4503,361,214,https://www.intensivregister.de/api/public/reporting/laendertabelle
1626772748,25518,21022,4496,361,214,https://www.intensivregister.de/api/public/reporting/laendertabelle
1626776350,25518,21028,4490,361,214,https://www.intensivregister.de/api/public/reporting/laendertabelle
1626779952,25518,21037,4481,361,214,https://www.intensivregister.de/api/public/reporting/laendertabelle
1626783555,25517,21039,4478,361,214,https://www.intensivregister.de/api/public/reporting/laendertabelle
1626805148,25517,21038,4479,361,214,https://www.intensivregister.de/api/public/reporting/laendertabelle
1626808751,25517,21041,4476,361,214,https://www.intensivregister.de/api/public/reporting/laendertabelle
1626812353,25493,21028,4465,360,214,https://www.intensivregister.de/api/public/reporting/laendertabelle
1626815955,25493,21030,4463,360,214,https://www.intensivregister.de/api/public/reporting/laendertabelle
1626819547,25493,21031,4462,360,214,https://www.intensivregister.de/api/public/reporting/laendertabelle
1626823149,25493,21037,4456,360,214,https://www.intensivregister.de/api/public/reporting/laendertabelle
1626826752,25494,21040,4454,360,214,https://www.intensivregister.de/api/public/reporting/laendertabelle
1626830354,25492,21055,4437,361,214,https://www.intensivregister.de/api/public/reporting/laendertabelle
1626833947,25490,21023,4467,363,215,https://www.intensivregister.de/api/public/reporting/laendertabelle
1626837549,25453,21007,4446,357,212,https://www.intensivregister.de/api/public/reporting/laendertabelle
1626841153,25440,21026,4414,360,212,https://www.intensivregister.de/api/public/reporting/laendertabelle
1626844754,25451,21028,4423,358,209,https://www.intensivregister.de/api/public/reporting/laendertabelle
1626848356,25462,21061,4401,358,210,https://www.intensivregister.de/api/public/reporting/laendertabelle
1626851948,25461,21064,4397,357,207,https://www.intensivregister.de/api/public/reporting/laendertabelle
1626855547,25469,21087,4382,357,207,https://www.intensivregister.de/api/public/reporting/laendertabelle
1626859150,25474,21091,4383,358,207,https://www.intensivregister.de/api/public/reporting/laendertabelle
1626862753,25474,21086,4388,358,207,https://www.intensivregister.de/api/public/reporting/laendertabelle
1626866345,25473,21086,4387,358,207,https://www.intensivregister.de/api/public/reporting/laendertabelle
1626869948,25473,21081,4392,358,207,https://www.intensivregister.de/api/public/reporting/laendertabelle
1626873550,25473,21085,4388,357,205,https://www.intensivregister.de/api/public/reporting/laendertabelle
1626877143,25473,21084,4389,357,205,https://www.intensivregister.de/api/public/reporting/laendertabelle
1626880745,25473,21081,4392,357,205,https://www.intensivregister.de/api/public/reporting/laendertabelle
1626884348,25473,21079,4394,357,205,https://www.intensivregister.de/api/public/reporting/laendertabelle
1626891552,25470,21080,4390,358,205,https://www.intensivregister.de/api/public/reporting/laendertabelle
1626895145,25469,21080,4389,358,205,https://www.intensivregister.de/api/public/reporting/laendertabelle
1626898747,25468,21078,4390,358,205,https://www.intensivregister.de/api/public/reporting/laendertabelle
1626902350,25468,21075,4393,359,205,https://www.intensivregister.de/api/public/reporting/laendertabelle
1626905952,25467,21072,4395,359,205,https://www.intensivregister.de/api/public/reporting/laendertabelle
1626909544,25485,21080,4405,359,205,https://www.intensivregister.de/api/public/reporting/laendertabelle
1626913147,25485,21088,4397,359,205,https://www.intensivregister.de/api/public/reporting/laendertabelle
1626916749,25487,21075,4412,358,205,https://www.intensivregister.de/api/public/reporting/laendertabelle
1626920351,25479,21019,4460,359,205,https://www.intensivregister.de/api/public/reporting/laendertabelle
1626923944,25451,20943,4508,361,206,https://www.intensivregister.de/api/public/reporting/laendertabelle
1626927547,25446,20949,4497,354,205,https://www.intensivregister.de/api/public/reporting/laendertabelle
1626931150,25461,20965,4496,353,202,https://www.intensivregister.de/api/public/reporting/laendertabelle
1626934752,25448,20976,4472,354,200,https://www.intensivregister.de/api/public/reporting/laendertabelle
1626938344,25442,20975,4467,353,199,https://www.intensivregister.de/api/public/reporting/laendertabelle
1626941947,25450,20983,4467,354,199,https://www.intensivregister.de/api/public/reporting/laendertabelle
1626945550,25450,20985,4465,355,199,https://www.intensivregister.de/api/public/reporting/laendertabelle
1626949152,25449,20986,4463,355,199,https://www.intensivregister.de/api/public/reporting/laendertabelle
1626952745,25448,20988,4460,355,199,https://www.intensivregister.de/api/public/reporting/laendertabelle
1626956347,25448,20983,4465,357,199,https://www.intensivregister.de/api/public/reporting/laendertabelle
1626963543,25448,20982,4466,357,199,https://www.intensivregister.de/api/public/reporting/laendertabelle
1626974351,25448,20984,4464,357,199,https://www.intensivregister.de/api/public/reporting/laendertabelle
1626977953,25448,20983,4465,357,199,https://www.intensivregister.de/api/public/reporting/laendertabelle
1626981545,25448,20980,4468,357,199,https://www.intensivregister.de/api/public/reporting/laendertabelle
1626985147,25448,20971,4477,359,199,https://www.intensivregister.de/api/public/reporting/laendertabelle
1626988750,25448,20973,4475,359,199,https://www.intensivregister.de/api/public/reporting/laendertabelle
1626992352,25448,20974,4474,359,199,https://www.intensivregister.de/api/public/reporting/laendertabelle
1626995945,25449,20977,4472,359,199,https://www.intensivregister.de/api/public/reporting/laendertabelle
1626999547,25449,20978,4471,359,199,https://www.intensivregister.de/api/public/reporting/laendertabelle
1627003150,25450,20990,4460,359,199,https://www.intensivregister.de/api/public/reporting/laendertabelle
1627006743,25426,21019,4407,359,199,https://www.intensivregister.de/api/public/reporting/laendertabelle
1627010345,25410,21057,4353,360,200,https://www.intensivregister.de/api/public/reporting/laendertabelle
1627013948,25388,21041,4347,359,202,https://www.intensivregister.de/api/public/reporting/laendertabelle
1627017551,25356,20982,4374,356,200,https://www.intensivregister.de/api/public/reporting/laendertabelle
1627021143,25352,20978,4374,357,199,https://www.intensivregister.de/api/public/reporting/laendertabelle
1627024747,25348,20972,4376,356,199,https://www.intensivregister.de/api/public/reporting/laendertabelle
1627028350,25345,20983,4362,357,199,https://www.intensivregister.de/api/public/reporting/laendertabelle
1627031952,25337,20973,4364,359,199,https://www.intensivregister.de/api/public/reporting/laendertabelle
1627039151,25339,20977,4362,359,199,https://www.intensivregister.de/api/public/reporting/laendertabelle
1627042756,25339,20978,4361,359,199,https://www.intensivregister.de/api/public/reporting/laendertabelle
1627049949,25339,20978,4361,358,198,https://www.intensivregister.de/api/public/reporting/laendertabelle
1627053551,25339,20976,4363,358,198,https://www.intensivregister.de/api/public/reporting/laendertabelle
1627064348,25339,20975,4364,358,198,https://www.intensivregister.de/api/public/reporting/laendertabelle
1627071554,25331,20965,4366,358,198,https://www.intensivregister.de/api/public/reporting/laendertabelle
1627075156,25327,20958,4369,358,198,https://www.intensivregister.de/api/public/reporting/laendertabelle
1627078749,25327,20951,4376,358,198,https://www.intensivregister.de/api/public/reporting/laendertabelle
1627082352,25327,20947,4380,358,198,https://www.intensivregister.de/api/public/reporting/laendertabelle
1627085951,25326,20950,4376,358,198,https://www.intensivregister.de/api/public/reporting/laendertabelle
1627089546,25328,20952,4376,358,198,https://www.intensivregister.de/api/public/reporting/laendertabelle
1627093151,25332,20937,4395,359,198,https://www.intensivregister.de/api/public/reporting/laendertabelle
1627096747,25321,20911,4410,362,197,https://www.intensivregister.de/api/public/reporting/laendertabelle
1627100352,25292,20816,4476,366,199,https://www.intensivregister.de/api/public/reporting/laendertabelle
1627103948,25252,20737,4515,359,196,https://www.intensivregister.de/api/public/reporting/laendertabelle
1627107553,25257,20726,4531,359,196,https://www.intensivregister.de/api/public/reporting/laendertabelle
1627111148,25249,20683,4566,355,193,https://www.intensivregister.de/api/public/reporting/laendertabelle
1627114753,25246,20674,4572,355,193,https://www.intensivregister.de/api/public/reporting/laendertabelle
1627118348,25243,20668,4575,355,193,https://www.intensivregister.de/api/public/reporting/laendertabelle
1627121953,25244,20668,4576,355,193,https://www.intensivregister.de/api/public/reporting/laendertabelle
1627125548,25244,20665,4579,355,193,https://www.intensivregister.de/api/public/reporting/laendertabelle
1627129153,25240,20662,4578,355,193,https://www.intensivregister.de/api/public/reporting/laendertabelle
1627132748,25240,20663,4577,355,193,https://www.intensivregister.de/api/public/reporting/laendertabelle
1627139949,25240,20659,4581,355,193,https://www.intensivregister.de/api/public/reporting/laendertabelle
1627143554,25241,20660,4581,355,193,https://www.intensivregister.de/api/public/reporting/laendertabelle
1627147150,25241,20658,4583,355,193,https://www.intensivregister.de/api/public/reporting/laendertabelle
1627150757,25241,20653,4588,355,193,https://www.intensivregister.de/api/public/reporting/laendertabelle
1627154349,25238,20652,4586,355,193,https://www.intensivregister.de/api/public/reporting/laendertabelle
1627157955,25238,20645,4593,355,193,https://www.intensivregister.de/api/public/reporting/laendertabelle
1627161550,25238,20644,4594,355,193,https://www.intensivregister.de/api/public/reporting/laendertabelle
1627165155,25241,20648,4593,355,193,https://www.intensivregister.de/api/public/reporting/laendertabelle
1627168750,25241,20646,4595,355,193,https://www.intensivregister.de/api/public/reporting/laendertabelle
1627172358,25242,20644,4598,355,193,https://www.intensivregister.de/api/public/reporting/laendertabelle
1627175951,25240,20630,4610,355,193,https://www.intensivregister.de/api/public/reporting/laendertabelle
1627179547,25245,20622,4623,356,193,https://www.intensivregister.de/api/public/reporting/laendertabelle
1627183152,25225,20553,4672,362,196,https://www.intensivregister.de/api/public/reporting/laendertabelle
1627186746,25211,20449,4762,363,196,https://www.intensivregister.de/api/public/reporting/laendertabelle
1627190351,25187,20386,4801,368,196,https://www.intensivregister.de/api/public/reporting/laendertabelle
1627193947,25140,20283,4857,368,194,https://www.intensivregister.de/api/public/reporting/laendertabelle
1627197552,25136,20282,4854,372,197,https://www.intensivregister.de/api/public/reporting/laendertabelle
1627201147,25131,20275,4856,372,197,https://www.intensivregister.de/api/public/reporting/laendertabelle
1627204752,25131,20277,4854,372,197,https://www.intensivregister.de/api/public/reporting/laendertabelle
1627208347,25131,20271,4860,372,197,https://www.intensivregister.de/api/public/reporting/laendertabelle
1627211952,25134,20269,4865,372,197,https://www.intensivregister.de/api/public/reporting/laendertabelle
1627215549,25134,20258,4876,372,197,https://www.intensivregister.de/api/public/reporting/laendertabelle
1627222748,25134,20256,4878,372,197,https://www.intensivregister.de/api/public/reporting/laendertabelle
1627226353,25134,20253,4881,372,197,https://www.intensivregister.de/api/public/reporting/laendertabelle
1627229948,25126,20248,4878,372,197,https://www.intensivregister.de/api/public/reporting/laendertabelle
1627233554,25126,20247,4879,372,197,https://www.intensivregister.de/api/public/reporting/laendertabelle
1627240750,25126,20249,4877,372,197,https://www.intensivregister.de/api/public/reporting/laendertabelle
1627244356,25114,20240,4874,371,197,https://www.intensivregister.de/api/public/reporting/laendertabelle
1627247951,25113,20244,4869,372,197,https://www.intensivregister.de/api/public/reporting/laendertabelle
1627251555,25113,20242,4871,372,197,https://www.intensivregister.de/api/public/reporting/laendertabelle
1627255151,25110,20241,4869,372,197,https://www.intensivregister.de/api/public/reporting/laendertabelle
1627258747,25110,20242,4868,372,197,https://www.intensivregister.de/api/public/reporting/laendertabelle
1627262352,25110,20251,4859,372,197,https://www.intensivregister.de/api/public/reporting/laendertabelle
1627265947,25134,20259,4875,373,197,https://www.intensivregister.de/api/public/reporting/laendertabelle
1627269552,25177,20279,4898,371,196,https://www.intensivregister.de/api/public/reporting/laendertabelle
1627273147,25237,20356,4881,365,194,https://www.intensivregister.de/api/public/reporting/laendertabelle
1627276752,25317,20463,4854,367,193,https://www.intensivregister.de/api/public/reporting/laendertabelle
1627280348,25337,20466,4871,369,193,https://www.intensivregister.de/api/public/reporting/laendertabelle
1627283946,25339,20485,4854,368,193,https://www.intensivregister.de/api/public/reporting/laendertabelle
1627287547,25349,20486,4863,369,194,https://www.intensivregister.de/api/public/reporting/laendertabelle
1627291147,25353,20493,4860,368,193,https://www.intensivregister.de/api/public/reporting/laendertabelle
1627294747,25352,20491,4861,368,193,https://www.intensivregister.de/api/public/reporting/laendertabelle
1627298347,25353,20495,4858,369,193,https://www.intensivregister.de/api/public/reporting/laendertabelle
1627309156,25353,20494,4859,369,193,https://www.intensivregister.de/api/public/reporting/laendertabelle
1627316356,25353,20490,4863,369,193,https://www.intensivregister.de/api/public/reporting/laendertabelle
1627319956,25353,20487,4866,369,193,https://www.intensivregister.de/api/public/reporting/laendertabelle
1627327156,25353,20488,4865,369,193,https://www.intensivregister.de/api/public/reporting/laendertabelle
1627330756,25352,20491,4861,369,193,https://www.intensivregister.de/api/public/reporting/laendertabelle
1627334356,25350,20486,4864,369,193,https://www.intensivregister.de/api/public/reporting/laendertabelle
1627337955,25350,20485,4865,369,193,https://www.intensivregister.de/api/public/reporting/laendertabelle
1627341561,25353,20488,4865,369,193,https://www.intensivregister.de/api/public/reporting/laendertabelle
1627345158,25353,20494,4859,369,193,https://www.intensivregister.de/api/public/reporting/laendertabelle
1627348747,25354,20499,4855,368,193,https://www.intensivregister.de/api/public/reporting/laendertabelle
1627352346,25381,20583,4798,371,193,https://www.intensivregister.de/api/public/reporting/laendertabelle
1627355957,25399,20668,4731,374,197,https://www.intensivregister.de/api/public/reporting/laendertabelle
1627359547,25432,20809,4623,374,197,https://www.intensivregister.de/api/public/reporting/laendertabelle
1627363147,25430,20840,4590,370,198,https://www.intensivregister.de/api/public/reporting/laendertabelle
1627366747,25435,20908,4527,368,197,https://www.intensivregister.de/api/public/reporting/laendertabelle
1627370347,25449,20931,4518,371,199,https://www.intensivregister.de/api/public/reporting/laendertabelle
1627373957,25438,20940,4498,369,198,https://www.intensivregister.de/api/public/reporting/laendertabelle
1627377556,25437,20949,4488,369,198,https://www.intensivregister.de/api/public/reporting/laendertabelle
1627381157,25437,20946,4491,369,199,https://www.intensivregister.de/api/public/reporting/laendertabelle
1627384756,25438,20947,4491,369,199,https://www.intensivregister.de/api/public/reporting/laendertabelle
1627388356,25438,20947,4491,362,198,https://www.intensivregister.de/api/public/reporting/laendertabelle
1627391956,25438,20944,4494,362,198,https://www.intensivregister.de/api/public/reporting/laendertabelle
1627395556,25438,20946,4492,362,198,https://www.intensivregister.de/api/public/reporting/laendertabelle
1627402756,25438,20943,4495,362,198,https://www.intensivregister.de/api/public/reporting/laendertabelle
1627406356,25438,20948,4490,362,198,https://www.intensivregister.de/api/public/reporting/laendertabelle
1627413556,25441,20949,4492,362,198,https://www.intensivregister.de/api/public/reporting/laendertabelle
1627417162,25448,20955,4493,362,198,https://www.intensivregister.de/api/public/reporting/laendertabelle
1627424348,25448,20963,4485,362,198,https://www.intensivregister.de/api/public/reporting/laendertabelle
1627427947,25446,20962,4484,361,197,https://www.intensivregister.de/api/public/reporting/laendertabelle
1627431548,25445,20960,4485,361,197,https://www.intensivregister.de/api/public/reporting/laendertabelle
1627435149,25445,20967,4478,361,197,https://www.intensivregister.de/api/public/reporting/laendertabelle
1627438749,25457,21012,4445,358,196,https://www.intensivregister.de/api/public/reporting/laendertabelle
1627442349,25437,21065,4372,360,193,https://www.intensivregister.de/api/public/reporting/laendertabelle
1627445951,25425,21150,4275,362,188,https://www.intensivregister.de/api/public/reporting/laendertabelle
1627449552,25437,21206,4231,364,191,https://www.intensivregister.de/api/public/reporting/laendertabelle
1627453152,25433,21180,4253,360,191,https://www.intensivregister.de/api/public/reporting/laendertabelle
1627456752,25431,21188,4243,357,191,https://www.intensivregister.de/api/public/reporting/laendertabelle
1627460353,25423,21190,4233,357,191,https://www.intensivregister.de/api/public/reporting/laendertabelle
1627463954,25423,21192,4231,356,191,https://www.intensivregister.de/api/public/reporting/laendertabelle
1627467554,25423,21189,4234,355,189,https://www.intensivregister.de/api/public/reporting/laendertabelle
1627471154,25423,21187,4236,355,189,https://www.intensivregister.de/api/public/reporting/laendertabelle
1627478355,25423,21193,4230,355,189,https://www.intensivregister.de/api/public/reporting/laendertabelle
1627485558,25423,21195,4228,355,189,https://www.intensivregister.de/api/public/reporting/laendertabelle
1627489156,25423,21195,4228,354,189,https://www.intensivregister.de/api/public/reporting/laendertabelle
1627503549,25423,21184,4239,354,189,https://www.intensivregister.de/api/public/reporting/laendertabelle
1627507151,25427,21189,4238,354,189,https://www.intensivregister.de/api/public/reporting/laendertabelle
1627510749,25424,21181,4243,353,189,https://www.intensivregister.de/api/public/reporting/laendertabelle
1627514350,25422,21176,4246,353,189,https://www.intensivregister.de/api/public/reporting/laendertabelle
1627517951,25424,21182,4242,353,189,https://www.intensivregister.de/api/public/reporting/laendertabelle
1627521552,25422,21190,4232,354,190,https://www.intensivregister.de/api/public/reporting/laendertabelle
1627525153,25448,21178,4270,352,190,https://www.intensivregister.de/api/public/reporting/laendertabelle
1627528755,25475,21219,4256,348,190,https://www.intensivregister.de/api/public/reporting/laendertabelle
1627532356,25479,21174,4305,354,191,https://www.intensivregister.de/api/public/reporting/laendertabelle
1627535946,25471,21155,4316,353,190,https://www.intensivregister.de/api/public/reporting/laendertabelle
1627539548,25476,21162,4314,349,187,https://www.intensivregister.de/api/public/reporting/laendertabelle
1627543148,25474,21137,4337,349,187,https://www.intensivregister.de/api/public/reporting/laendertabelle
1627546756,25480,21137,4343,346,187,https://www.intensivregister.de/api/public/reporting/laendertabelle
1627550349,25480,21134,4346,346,187,https://www.intensivregister.de/api/public/reporting/laendertabelle
1627553950,25475,21127,4348,346,187,https://www.intensivregister.de/api/public/reporting/laendertabelle
1627557551,25476,21132,4344,346,187,https://www.intensivregister.de/api/public/reporting/laendertabelle
1627561152,25471,21126,4345,346,187,https://www.intensivregister.de/api/public/reporting/laendertabelle
1627564756,25471,21127,4344,347,188,https://www.intensivregister.de/api/public/reporting/laendertabelle
1627575555,25471,21128,4343,347,188,https://www.intensivregister.de/api/public/reporting/laendertabelle
1627579156,25471,21135,4336,347,188,https://www.intensivregister.de/api/public/reporting/laendertabelle
1627586348,25471,21134,4337,347,188,https://www.intensivregister.de/api/public/reporting/laendertabelle
1627589948,25466,21128,4338,347,188,https://www.intensivregister.de/api/public/reporting/laendertabelle
1627593549,25466,21132,4334,347,188,https://www.intensivregister.de/api/public/reporting/laendertabelle
1627597151,25464,21141,4323,347,188,https://www.intensivregister.de/api/public/reporting/laendertabelle
1627600752,25462,21133,4329,347,188,https://www.intensivregister.de/api/public/reporting/laendertabelle
1627604353,25462,21136,4326,349,189,https://www.intensivregister.de/api/public/reporting/laendertabelle
1627607952,25467,21129,4338,350,190,https://www.intensivregister.de/api/public/reporting/laendertabelle
1627611551,25458,21142,4316,348,189,https://www.intensivregister.de/api/public/reporting/laendertabelle
1627615150,25445,21042,4403,352,191,https://www.intensivregister.de/api/public/reporting/laendertabelle
1627618749,25330,20927,4403,354,187,https://www.intensivregister.de/api/public/reporting/laendertabelle
1627622348,25310,20963,4347,351,185,https://www.intensivregister.de/api/public/reporting/laendertabelle
1627625947,25311,20980,4331,349,182,https://www.intensivregister.de/api/public/reporting/laendertabelle
1627629556,25311,20984,4327,349,181,https://www.intensivregister.de/api/public/reporting/laendertabelle
1627633155,25313,20991,4322,350,182,https://www.intensivregister.de/api/public/reporting/laendertabelle
1627636754,25313,20985,4328,351,182,https://www.intensivregister.de/api/public/reporting/laendertabelle
1627640354,25314,20981,4333,351,182,https://www.intensivregister.de/api/public/reporting/laendertabelle
1627643952,25314,20979,4335,350,182,https://www.intensivregister.de/api/public/reporting/laendertabelle
1627647552,25340,20999,4341,351,183,https://www.intensivregister.de/api/public/reporting/laendertabelle
1627651151,25340,21000,4340,352,183,https://www.intensivregister.de/api/public/reporting/laendertabelle
1627654750,25341,21000,4341,353,183,https://www.intensivregister.de/api/public/reporting/laendertabelle
1627658348,25339,20999,4340,353,183,https://www.intensivregister.de/api/public/reporting/laendertabelle
1627661947,25339,20996,4343,353,183,https://www.intensivregister.de/api/public/reporting/laendertabelle
1627665556,25339,20997,4342,353,183,https://www.intensivregister.de/api/public/reporting/laendertabelle
1627669155,25339,20995,4344,353,183,https://www.intensivregister.de/api/public/reporting/laendertabelle
1627676353,25344,20990,4354,352,183,https://www.intensivregister.de/api/public/reporting/laendertabelle
1627679952,25341,20990,4351,353,183,https://www.intensivregister.de/api/public/reporting/laendertabelle
1627683551,25338,20991,4347,353,183,https://www.intensivregister.de/api/public/reporting/laendertabelle
1627687150,25338,20993,4345,353,183,https://www.intensivregister.de/api/public/reporting/laendertabelle
1627690749,25338,20988,4350,353,183,https://www.intensivregister.de/api/public/reporting/laendertabelle
1627694349,25336,20973,4363,353,182,https://www.intensivregister.de/api/public/reporting/laendertabelle
1627697948,25336,20982,4354,353,181,https://www.intensivregister.de/api/public/reporting/laendertabelle
1627701547,25333,20948,4385,351,182,https://www.intensivregister.de/api/public/reporting/laendertabelle
1627705156,25274,20881,4393,352,182,https://www.intensivregister.de/api/public/reporting/laendertabelle
1627708755,25267,20843,4424,354,182,https://www.intensivregister.de/api/public/reporting/laendertabelle
1627712354,25220,20739,4481,361,180,https://www.intensivregister.de/api/public/reporting/laendertabelle
1627715953,25173,20666,4507,360,181,https://www.intensivregister.de/api/public/reporting/laendertabelle
1627719553,25159,20637,4522,359,181,https://www.intensivregister.de/api/public/reporting/laendertabelle
1627723152,25159,20626,4533,358,181,https://www.intensivregister.de/api/public/reporting/laendertabelle
1627726751,25156,20629,4527,357,181,https://www.intensivregister.de/api/public/reporting/laendertabelle
1627730350,25156,20631,4525,357,181,https://www.intensivregister.de/api/public/reporting/laendertabelle
1627733949,25152,20616,4536,357,181,https://www.intensivregister.de/api/public/reporting/laendertabelle
1627741147,25152,20614,4538,357,181,https://www.intensivregister.de/api/public/reporting/laendertabelle
1627744756,25147,20608,4539,357,181,https://www.intensivregister.de/api/public/reporting/laendertabelle
1627748355,25147,20610,4537,357,181,https://www.intensivregister.de/api/public/reporting/laendertabelle
1627759155,25147,20611,4536,357,181,https://www.intensivregister.de/api/public/reporting/laendertabelle
1627762751,25143,20604,4539,357,181,https://www.intensivregister.de/api/public/reporting/laendertabelle
1627766350,25143,20606,4537,357,181,https://www.intensivregister.de/api/public/reporting/laendertabelle
1627769949,25143,20605,4538,357,181,https://www.intensivregister.de/api/public/reporting/laendertabelle
1627773549,25144,20601,4543,357,181,https://www.intensivregister.de/api/public/reporting/laendertabelle
1627777148,25146,20604,4542,357,181,https://www.intensivregister.de/api/public/reporting/laendertabelle
1627780747,25143,20607,4536,357,181,https://www.intensivregister.de/api/public/reporting/laendertabelle
1627784347,25137,20580,4557,356,181,https://www.intensivregister.de/api/public/reporting/laendertabelle
1627787946,25122,20529,4593,354,182,https://www.intensivregister.de/api/public/reporting/laendertabelle
1627791555,25103,20448,4655,358,180,https://www.intensivregister.de/api/public/reporting/laendertabelle
1627795155,25055,20359,4696,358,181,https://www.intensivregister.de/api/public/reporting/laendertabelle
1627798754,25045,20346,4699,361,183,https://www.intensivregister.de/api/public/reporting/laendertabelle
1627802354,25004,20277,4727,361,184,https://www.intensivregister.de/api/public/reporting/laendertabelle
1627805954,25001,20270,4731,362,184,https://www.intensivregister.de/api/public/reporting/laendertabelle
1627809551,25000,20271,4729,364,184,https://www.intensivregister.de/api/public/reporting/laendertabelle
1627813153,24998,20271,4727,363,184,https://www.intensivregister.de/api/public/reporting/laendertabelle
1627816756,24998,20272,4726,363,184,https://www.intensivregister.de/api/public/reporting/laendertabelle
1627823954,24998,20272,4726,364,184,https://www.intensivregister.de/api/public/reporting/laendertabelle
1627838350,24998,20270,4728,364,184,https://www.intensivregister.de/api/public/reporting/laendertabelle
1627845555,24980,20255,4725,364,184,https://www.intensivregister.de/api/public/reporting/laendertabelle
1627849148,24979,20257,4722,364,184,https://www.intensivregister.de/api/public/reporting/laendertabelle
1627852750,24979,20254,4725,364,184,https://www.intensivregister.de/api/public/reporting/laendertabelle
1627856352,24980,20257,4723,364,184,https://www.intensivregister.de/api/public/reporting/laendertabelle
1627859955,24979,20250,4729,364,184,https://www.intensivregister.de/api/public/reporting/laendertabelle
1627863556,24981,20250,4731,364,184,https://www.intensivregister.de/api/public/reporting/laendertabelle
1627867148,24981,20244,4737,364,184,https://www.intensivregister.de/api/public/reporting/laendertabelle
1627870749,25015,20247,4768,367,183,https://www.intensivregister.de/api/public/reporting/laendertabelle
1627874351,25086,20271,4815,367,184,https://www.intensivregister.de/api/public/reporting/laendertabelle
1627877953,25117,20237,4880,368,182,https://www.intensivregister.de/api/public/reporting/laendertabelle
1627881556,25184,20320,4864,372,183,https://www.intensivregister.de/api/public/reporting/laendertabelle
1627885149,25211,20327,4884,373,184,https://www.intensivregister.de/api/public/reporting/laendertabelle
1627888752,25225,20352,4873,376,186,https://www.intensivregister.de/api/public/reporting/laendertabelle
1627892355,25233,20347,4886,376,185,https://www.intensivregister.de/api/public/reporting/laendertabelle
1627895948,25251,20356,4895,378,186,https://www.intensivregister.de/api/public/reporting/laendertabelle
1627899551,25253,20361,4892,379,186,https://www.intensivregister.de/api/public/reporting/laendertabelle
1627903154,25254,20371,4883,379,186,https://www.intensivregister.de/api/public/reporting/laendertabelle
1627906756,25254,20372,4882,380,187,https://www.intensivregister.de/api/public/reporting/laendertabelle
1627913952,25256,20375,4881,379,186,https://www.intensivregister.de/api/public/reporting/laendertabelle
1627917554,25256,20377,4879,379,186,https://www.intensivregister.de/api/public/reporting/laendertabelle
1627935554,25252,20367,4885,378,186,https://www.intensivregister.de/api/public/reporting/laendertabelle
1627939156,25250,20357,4893,377,186,https://www.intensivregister.de/api/public/reporting/laendertabelle
1627942748,25250,20363,4887,377,186,https://www.intensivregister.de/api/public/reporting/laendertabelle
1627946351,25250,20368,4882,377,186,https://www.intensivregister.de/api/public/reporting/laendertabelle
1627949953,25254,20373,4881,377,186,https://www.intensivregister.de/api/public/reporting/laendertabelle
1627953555,25249,20376,4873,377,186,https://www.intensivregister.de/api/public/reporting/laendertabelle
1627957147,25253,20406,4847,377,188,https://www.intensivregister.de/api/public/reporting/laendertabelle
1627960750,25257,20461,4796,378,187,https://www.intensivregister.de/api/public/reporting/laendertabelle
1627964352,25348,20718,4630,378,190,https://www.intensivregister.de/api/public/reporting/laendertabelle
1627967955,25378,20837,4541,377,195,https://www.intensivregister.de/api/public/reporting/laendertabelle
1627971548,25378,20843,4535,379,194,https://www.intensivregister.de/api/public/reporting/laendertabelle
1627975151,25374,20845,4529,377,194,https://www.intensivregister.de/api/public/reporting/laendertabelle
1627978755,25384,20851,4533,377,194,https://www.intensivregister.de/api/public/reporting/laendertabelle
1627982347,25383,20843,4540,379,193,https://www.intensivregister.de/api/public/reporting/laendertabelle
1627985950,25377,20844,4533,379,193,https://www.intensivregister.de/api/public/reporting/laendertabelle
1627989553,25378,20844,4534,380,193,https://www.intensivregister.de/api/public/reporting/laendertabelle
1627996748,25378,20846,4532,380,193,https://www.intensivregister.de/api/public/reporting/laendertabelle
1628021947,25378,20839,4539,380,193,https://www.intensivregister.de/api/public/reporting/laendertabelle
1628025550,25378,20841,4537,380,193,https://www.intensivregister.de/api/public/reporting/laendertabelle
1628029152,25379,20838,4541,380,193,https://www.intensivregister.de/api/public/reporting/laendertabelle
1628032748,25378,20840,4538,380,193,https://www.intensivregister.de/api/public/reporting/laendertabelle
1628036350,25378,20846,4532,381,194,https://www.intensivregister.de/api/public/reporting/laendertabelle
1628039950,25378,20843,4535,382,194,https://www.intensivregister.de/api/public/reporting/laendertabelle
1628043549,25377,20867,4510,387,197,https://www.intensivregister.de/api/public/reporting/laendertabelle
1628047149,25376,20878,4498,388,200,https://www.intensivregister.de/api/public/reporting/laendertabelle
1628050749,25415,20947,4468,388,200,https://www.intensivregister.de/api/public/reporting/laendertabelle
1628054349,25424,20928,4496,385,197,https://www.intensivregister.de/api/public/reporting/laendertabelle
1628057948,25424,20933,4491,388,197,https://www.intensivregister.de/api/public/reporting/laendertabelle
1628061556,25438,20936,4502,392,198,https://www.intensivregister.de/api/public/reporting/laendertabelle
1628065154,25434,20914,4520,393,199,https://www.intensivregister.de/api/public/reporting/laendertabelle
1628068754,25430,20908,4522,394,199,https://www.intensivregister.de/api/public/reporting/laendertabelle
1628072352,25431,20905,4526,394,199,https://www.intensivregister.de/api/public/reporting/laendertabelle
1628079549,25431,20905,4526,395,199,https://www.intensivregister.de/api/public/reporting/laendertabelle
1628083147,25432,20902,4530,394,198,https://www.intensivregister.de/api/public/reporting/laendertabelle
1628097556,25432,20902,4530,395,199,https://www.intensivregister.de/api/public/reporting/laendertabelle
1628108348,25433,20904,4529,395,199,https://www.intensivregister.de/api/public/reporting/laendertabelle
1628111956,25433,20903,4530,395,199,https://www.intensivregister.de/api/public/reporting/laendertabelle
1628115554,25435,20903,4532,395,199,https://www.intensivregister.de/api/public/reporting/laendertabelle
1628119150,25435,20901,4534,395,199,https://www.intensivregister.de/api/public/reporting/laendertabelle
1628122747,25436,20907,4529,395,199,https://www.intensivregister.de/api/public/reporting/laendertabelle
1628126354,25437,20910,4527,395,200,https://www.intensivregister.de/api/public/reporting/laendertabelle
1628129952,25445,20898,4547,390,199,https://www.intensivregister.de/api/public/reporting/laendertabelle
1628133550,25420,20900,4520,390,199,https://www.intensivregister.de/api/public/reporting/laendertabelle
1628137149,25413,20915,4498,386,207,https://www.intensivregister.de/api/public/reporting/laendertabelle
1628140748,25379,20907,4472,392,208,https://www.intensivregister.de/api/public/reporting/laendertabelle
1628144355,25396,20884,4512,389,209,https://www.intensivregister.de/api/public/reporting/laendertabelle
1628147954,25397,20876,4521,387,206,https://www.intensivregister.de/api/public/reporting/laendertabelle
1628151552,25398,20870,4528,388,206,https://www.intensivregister.de/api/public/reporting/laendertabelle
1628155151,25397,20864,4533,388,205,https://www.intensivregister.de/api/public/reporting/laendertabelle
1628158749,25397,20862,4535,388,205,https://www.intensivregister.de/api/public/reporting/laendertabelle
1628162347,25397,20862,4535,387,206,https://www.intensivregister.de/api/public/reporting/laendertabelle
1628165955,25401,20872,4529,388,206,https://www.intensivregister.de/api/public/reporting/laendertabelle
1628169552,25401,20876,4525,388,206,https://www.intensivregister.de/api/public/reporting/laendertabelle
1628173149,25401,20872,4529,389,206,https://www.intensivregister.de/api/public/reporting/laendertabelle
1628176756,25399,20869,4530,390,206,https://www.intensivregister.de/api/public/reporting/laendertabelle
1628183950,25399,20867,4532,390,206,https://www.intensivregister.de/api/public/reporting/laendertabelle
1628187557,25399,20869,4530,390,206,https://www.intensivregister.de/api/public/reporting/laendertabelle
1628191153,25398,20868,4530,390,206,https://www.intensivregister.de/api/public/reporting/laendertabelle
1628194749,25402,20872,4530,390,206,https://www.intensivregister.de/api/public/reporting/laendertabelle
1628198347,25407,20871,4536,390,206,https://www.intensivregister.de/api/public/reporting/laendertabelle
1628201953,25408,20877,4531,390,206,https://www.intensivregister.de/api/public/reporting/laendertabelle
1628205550,25410,20871,4539,390,206,https://www.intensivregister.de/api/public/reporting/laendertabelle
1628209147,25410,20871,4539,389,205,https://www.intensivregister.de/api/public/reporting/laendertabelle
1628212754,25411,20867,4544,390,205,https://www.intensivregister.de/api/public/reporting/laendertabelle
1628216352,25395,20900,4495,387,204,https://www.intensivregister.de/api/public/reporting/laendertabelle
1628219949,25404,20937,4467,387,202,https://www.intensivregister.de/api/public/reporting/laendertabelle
1628223556,25388,20973,4415,384,202,https://www.intensivregister.de/api/public/reporting/laendertabelle
1628227154,25352,20981,4371,387,203,https://www.intensivregister.de/api/public/reporting/laendertabelle
1628230750,25321,20974,4347,392,208,https://www.intensivregister.de/api/public/reporting/laendertabelle
1628234356,25308,20947,4361,392,208,https://www.intensivregister.de/api/public/reporting/laendertabelle
1628237953,25306,20938,4368,392,208,https://www.intensivregister.de/api/public/reporting/laendertabelle
1628241549,25306,20943,4363,393,209,https://www.intensivregister.de/api/public/reporting/laendertabelle
1628245156,25305,20956,4349,395,209,https://www.intensivregister.de/api/public/reporting/laendertabelle
1628248753,25305,20958,4347,394,207,https://www.intensivregister.de/api/public/reporting/laendertabelle
1628263148,25305,20959,4346,396,207,https://www.intensivregister.de/api/public/reporting/laendertabelle
1628281150,25306,20955,4351,397,208,https://www.intensivregister.de/api/public/reporting/laendertabelle
1628284747,25306,20951,4355,397,208,https://www.intensivregister.de/api/public/reporting/laendertabelle
1628288353,25305,20940,4365,397,208,https://www.intensivregister.de/api/public/reporting/laendertabelle
1628291949,25305,20934,4371,398,208,https://www.intensivregister.de/api/public/reporting/laendertabelle
1628295556,25305,20931,4374,398,208,https://www.intensivregister.de/api/public/reporting/laendertabelle
1628299153,25315,20944,4371,399,209,https://www.intensivregister.de/api/public/reporting/laendertabelle
1628302750,25298,20931,4367,400,208,https://www.intensivregister.de/api/public/reporting/laendertabelle
1628306357,25280,20935,4345,408,208,https://www.intensivregister.de/api/public/reporting/laendertabelle
1628309953,25235,20858,4377,412,207,https://www.intensivregister.de/api/public/reporting/laendertabelle
1628313550,25169,20762,4407,415,208,https://www.intensivregister.de/api/public/reporting/laendertabelle
1628317148,25149,20719,4430,415,206,https://www.intensivregister.de/api/public/reporting/laendertabelle
1628320754,25115,20683,4432,417,206,https://www.intensivregister.de/api/public/reporting/laendertabelle
1628324351,25114,20664,4450,418,205,https://www.intensivregister.de/api/public/reporting/laendertabelle
1628327948,25116,20657,4459,418,205,https://www.intensivregister.de/api/public/reporting/laendertabelle
1628331555,25113,20651,4462,418,205,https://www.intensivregister.de/api/public/reporting/laendertabelle
1628335152,25121,20637,4484,418,205,https://www.intensivregister.de/api/public/reporting/laendertabelle
1628338749,25121,20636,4485,418,205,https://www.intensivregister.de/api/public/reporting/laendertabelle
1628345953,25121,20635,4486,418,205,https://www.intensivregister.de/api/public/reporting/laendertabelle
1628349550,25121,20638,4483,418,205,https://www.intensivregister.de/api/public/reporting/laendertabelle
1628353157,25121,20641,4480,418,205,https://www.intensivregister.de/api/public/reporting/laendertabelle
1628356753,25123,20643,4480,418,205,https://www.intensivregister.de/api/public/reporting/laendertabelle
1628360350,25123,20640,4483,418,205,https://www.intensivregister.de/api/public/reporting/laendertabelle
1628367553,25121,20629,4492,417,204,https://www.intensivregister.de/api/public/reporting/laendertabelle
1628371150,25120,20626,4494,417,205,https://www.intensivregister.de/api/public/reporting/laendertabelle
1628374747,25120,20620,4500,417,205,https://www.intensivregister.de/api/public/reporting/laendertabelle
1628378354,25120,20623,4497,417,205,https://www.intensivregister.de/api/public/reporting/laendertabelle
1628381950,25114,20619,4495,417,205,https://www.intensivregister.de/api/public/reporting/laendertabelle
1628385547,25114,20617,4497,417,205,https://www.intensivregister.de/api/public/reporting/laendertabelle
1628389153,25107,20620,4487,420,206,https://www.intensivregister.de/api/public/reporting/laendertabelle
1628392749,25096,20527,4569,420,205,https://www.intensivregister.de/api/public/reporting/laendertabelle
1628396356,25080,20486,4594,424,202,https://www.intensivregister.de/api/public/reporting/laendertabelle
1628399953,25055,20448,4607,434,201,https://www.intensivregister.de/api/public/reporting/laendertabelle
1628403549,25042,20403,4639,436,201,https://www.intensivregister.de/api/public/reporting/laendertabelle
1628407155,25042,20352,4690,437,201,https://www.intensivregister.de/api/public/reporting/laendertabelle
1628410752,25041,20349,4692,439,202,https://www.intensivregister.de/api/public/reporting/laendertabelle
1628414348,25041,20351,4690,439,202,https://www.intensivregister.de/api/public/reporting/laendertabelle
1628417955,25041,20350,4691,440,202,https://www.intensivregister.de/api/public/reporting/laendertabelle
1628421552,25041,20344,4697,441,202,https://www.intensivregister.de/api/public/reporting/laendertabelle
1628425149,25041,20343,4698,441,202,https://www.intensivregister.de/api/public/reporting/laendertabelle
1628428754,25041,20341,4700,441,202,https://www.intensivregister.de/api/public/reporting/laendertabelle
1628432351,25039,20342,4697,441,202,https://www.intensivregister.de/api/public/reporting/laendertabelle
1628435948,25037,20345,4692,441,202,https://www.intensivregister.de/api/public/reporting/laendertabelle
1628439554,25037,20343,4694,440,202,https://www.intensivregister.de/api/public/reporting/laendertabelle
1628443151,25037,20345,4692,440,202,https://www.intensivregister.de/api/public/reporting/laendertabelle
1628446747,25037,20342,4695,440,202,https://www.intensivregister.de/api/public/reporting/laendertabelle
1628450354,25037,20340,4697,440,202,https://www.intensivregister.de/api/public/reporting/laendertabelle
1628453950,25039,20339,4700,442,202,https://www.intensivregister.de/api/public/reporting/laendertabelle
1628461154,25039,20341,4698,442,202,https://www.intensivregister.de/api/public/reporting/laendertabelle
1628464750,25039,20335,4704,443,203,https://www.intensivregister.de/api/public/reporting/laendertabelle
1628468350,25041,20334,4707,443,203,https://www.intensivregister.de/api/public/reporting/laendertabelle
1628471954,25044,20334,4710,443,203,https://www.intensivregister.de/api/public/reporting/laendertabelle
1628475552,25066,20352,4714,442,204,https://www.intensivregister.de/api/public/reporting/laendertabelle
1628479151,25122,20361,4761,449,205,https://www.intensivregister.de/api/public/reporting/laendertabelle
1628482751,25174,20365,4809,451,204,https://www.intensivregister.de/api/public/reporting/laendertabelle
1628486351,25231,20436,4795,451,203,https://www.intensivregister.de/api/public/reporting/laendertabelle
1628489952,25242,20485,4757,457,207,https://www.intensivregister.de/api/public/reporting/laendertabelle
1628493552,25276,20502,4774,456,211,https://www.intensivregister.de/api/public/reporting/laendertabelle
1628497154,25271,20495,4776,455,211,https://www.intensivregister.de/api/public/reporting/laendertabelle
1628500754,25272,20491,4781,456,211,https://www.intensivregister.de/api/public/reporting/laendertabelle
1628504354,25273,20487,4786,456,211,https://www.intensivregister.de/api/public/reporting/laendertabelle
1628507955,25273,20487,4786,457,211,https://www.intensivregister.de/api/public/reporting/laendertabelle
1628511555,25272,20489,4783,457,211,https://www.intensivregister.de/api/public/reporting/laendertabelle
1628518755,25272,20488,4784,457,212,https://www.intensivregister.de/api/public/reporting/laendertabelle
1628522354,25272,20489,4783,457,212,https://www.intensivregister.de/api/public/reporting/laendertabelle
1628540354,25270,20491,4779,457,213,https://www.intensivregister.de/api/public/reporting/laendertabelle
1628543954,25270,20493,4777,457,213,https://www.intensivregister.de/api/public/reporting/laendertabelle
1628551154,25268,20491,4777,457,213,https://www.intensivregister.de/api/public/reporting/laendertabelle
1628554753,25269,20496,4773,457,211,https://www.intensivregister.de/api/public/reporting/laendertabelle
1628558353,25272,20500,4772,457,211,https://www.intensivregister.de/api/public/reporting/laendertabelle
1628561953,25293,20536,4757,453,212,https://www.intensivregister.de/api/public/reporting/laendertabelle
1628565553,25314,20600,4714,450,213,https://www.intensivregister.de/api/public/reporting/laendertabelle
1628569152,25342,20722,4620,447,212,https://www.intensivregister.de/api/public/reporting/laendertabelle
1628572754,25403,20794,4609,446,214,https://www.intensivregister.de/api/public/reporting/laendertabelle
1628576354,25403,20834,4569,444,213,https://www.intensivregister.de/api/public/reporting/laendertabelle
1628579955,25404,20821,4583,442,215,https://www.intensivregister.de/api/public/reporting/laendertabelle
1628583555,25390,20807,4583,443,215,https://www.intensivregister.de/api/public/reporting/laendertabelle
1628587156,25390,20809,4581,444,216,https://www.intensivregister.de/api/public/reporting/laendertabelle
1628590756,25390,20818,4572,445,215,https://www.intensivregister.de/api/public/reporting/laendertabelle
1628594356,25397,20821,4576,448,219,https://www.intensivregister.de/api/public/reporting/laendertabelle
1628601557,25397,20819,4578,448,219,https://www.intensivregister.de/api/public/reporting/laendertabelle
1628608747,25398,20825,4573,448,219,https://www.intensivregister.de/api/public/reporting/laendertabelle
1628619556,25398,20827,4571,448,219,https://www.intensivregister.de/api/public/reporting/laendertabelle
1628626747,25400,20820,4580,448,219,https://www.intensivregister.de/api/public/reporting/laendertabelle
1628630357,25402,20824,4578,448,219,https://www.intensivregister.de/api/public/reporting/laendertabelle
1628633956,25399,20819,4580,448,219,https://www.intensivregister.de/api/public/reporting/laendertabelle
1628637556,25399,20821,4578,449,219,https://www.intensivregister.de/api/public/reporting/laendertabelle
1628641156,25398,20814,4584,450,219,https://www.intensivregister.de/api/public/reporting/laendertabelle
1628644756,25398,20820,4578,451,219,https://www.intensivregister.de/api/public/reporting/laendertabelle
1628648356,25405,20843,4562,451,220,https://www.intensivregister.de/api/public/reporting/laendertabelle
1628651955,25399,20831,4568,449,219,https://www.intensivregister.de/api/public/reporting/laendertabelle
1628655554,25395,20891,4504,443,216,https://www.intensivregister.de/api/public/reporting/laendertabelle
1628659154,25394,20927,4467,446,219,https://www.intensivregister.de/api/public/reporting/laendertabelle
1628662754,25398,20927,4471,448,219,https://www.intensivregister.de/api/public/reporting/laendertabelle
1628666353,25396,20950,4446,454,222,https://www.intensivregister.de/api/public/reporting/laendertabelle
1628669953,25396,20947,4449,454,222,https://www.intensivregister.de/api/public/reporting/laendertabelle
1628673553,25396,20945,4451,454,222,https://www.intensivregister.de/api/public/reporting/laendertabelle
1628677153,25397,20947,4450,455,223,https://www.intensivregister.de/api/public/reporting/laendertabelle
1628680753,25396,20947,4449,454,223,https://www.intensivregister.de/api/public/reporting/laendertabelle
1628684352,25395,20946,4449,454,223,https://www.intensivregister.de/api/public/reporting/laendertabelle
1628687952,25395,20947,4448,454,223,https://www.intensivregister.de/api/public/reporting/laendertabelle
1628691552,25395,20945,4450,454,223,https://www.intensivregister.de/api/public/reporting/laendertabelle
1628695153,25393,20943,4450,454,223,https://www.intensivregister.de/api/public/reporting/laendertabelle
1628698752,25391,20940,4451,454,223,https://www.intensivregister.de/api/public/reporting/laendertabelle
1628713150,25392,20939,4453,453,223,https://www.intensivregister.de/api/public/reporting/laendertabelle
1628716749,25394,20942,4452,453,223,https://www.intensivregister.de/api/public/reporting/laendertabelle
1628720349,25395,20952,4443,453,223,https://www.intensivregister.de/api/public/reporting/laendertabelle
1628723948,25395,20946,4449,454,223,https://www.intensivregister.de/api/public/reporting/laendertabelle
1628727548,25395,20943,4452,454,223,https://www.intensivregister.de/api/public/reporting/laendertabelle
1628731147,25395,20945,4450,451,223,https://www.intensivregister.de/api/public/reporting/laendertabelle
1628734748,25392,20911,4481,452,226,https://www.intensivregister.de/api/public/reporting/laendertabelle
1628738347,25399,20945,4454,454,226,https://www.intensivregister.de/api/public/reporting/laendertabelle
1628741957,25389,20935,4454,461,226,https://www.intensivregister.de/api/public/reporting/laendertabelle
1628745556,25396,20935,4461,466,234,https://www.intensivregister.de/api/public/reporting/laendertabelle
1628749156,25389,20935,4454,470,235,https://www.intensivregister.de/api/public/reporting/laendertabelle
1628752756,25388,20902,4486,472,234,https://www.intensivregister.de/api/public/reporting/laendertabelle
1628756355,25386,20909,4477,473,233,https://www.intensivregister.de/api/public/reporting/laendertabelle
1628759955,25386,20908,4478,473,233,https://www.intensivregister.de/api/public/reporting/laendertabelle
1628763556,25384,20905,4479,474,234,https://www.intensivregister.de/api/public/reporting/laendertabelle
1628767155,25384,20904,4480,474,234,https://www.intensivregister.de/api/public/reporting/laendertabelle
1628774355,25384,20905,4479,474,234,https://www.intensivregister.de/api/public/reporting/laendertabelle
1628777955,25384,20909,4475,475,234,https://www.intensivregister.de/api/public/reporting/laendertabelle
1628781554,25381,20906,4475,475,234,https://www.intensivregister.de/api/public/reporting/laendertabelle
1628788753,25381,20902,4479,475,234,https://www.intensivregister.de/api/public/reporting/laendertabelle
1628792353,25381,20901,4480,475,234,https://www.intensivregister.de/api/public/reporting/laendertabelle
1628799552,25385,20899,4486,476,234,https://www.intensivregister.de/api/public/reporting/laendertabelle
1628803152,25381,20894,4487,476,234,https://www.intensivregister.de/api/public/reporting/laendertabelle
1628806751,25377,20894,4483,477,234,https://www.intensivregister.de/api/public/reporting/laendertabelle
1628810351,25376,20894,4482,477,234,https://www.intensivregister.de/api/public/reporting/laendertabelle
1628813950,25374,20894,4480,477,234,https://www.intensivregister.de/api/public/reporting/laendertabelle
1628817550,25367,20886,4481,477,234,https://www.intensivregister.de/api/public/reporting/laendertabelle
1628821150,25363,20922,4441,480,236,https://www.intensivregister.de/api/public/reporting/laendertabelle
1628824750,25356,20909,4447,480,236,https://www.intensivregister.de/api/public/reporting/laendertabelle
1628828350,25353,20913,4440,481,238,https://www.intensivregister.de/api/public/reporting/laendertabelle
1628831950,25332,20904,4428,477,234,https://www.intensivregister.de/api/public/reporting/laendertabelle
1628835550,25340,20923,4417,480,236,https://www.intensivregister.de/api/public/reporting/laendertabelle
1628839150,25342,20912,4430,482,240,https://www.intensivregister.de/api/public/reporting/laendertabelle
1628842751,25342,20917,4425,483,241,https://www.intensivregister.de/api/public/reporting/laendertabelle
1628846351,25339,20900,4439,484,241,https://www.intensivregister.de/api/public/reporting/laendertabelle
1628849950,25350,20902,4448,484,241,https://www.intensivregister.de/api/public/reporting/laendertabelle
1628853551,25350,20906,4444,488,242,https://www.intensivregister.de/api/public/reporting/laendertabelle
1628857151,25350,20905,4445,488,242,https://www.intensivregister.de/api/public/reporting/laendertabelle
1628860751,25350,20907,4443,488,242,https://www.intensivregister.de/api/public/reporting/laendertabelle
1628864351,25350,20905,4445,488,242,https://www.intensivregister.de/api/public/reporting/laendertabelle
1628867951,25350,20904,4446,488,242,https://www.intensivregister.de/api/public/reporting/laendertabelle
1628885951,25345,20903,4442,488,241,https://www.intensivregister.de/api/public/reporting/laendertabelle
1628889551,25343,20907,4436,487,241,https://www.intensivregister.de/api/public/reporting/laendertabelle
1628893151,25344,20906,4438,487,241,https://www.intensivregister.de/api/public/reporting/laendertabelle
1628896751,25343,20904,4439,487,241,https://www.intensivregister.de/api/public/reporting/laendertabelle
1628900351,25341,20902,4439,487,241,https://www.intensivregister.de/api/public/reporting/laendertabelle
1628903950,25340,20895,4445,486,241,https://www.intensivregister.de/api/public/reporting/laendertabelle
1628907550,25340,20904,4436,486,241,https://www.intensivregister.de/api/public/reporting/laendertabelle
1628911150,25326,20828,4498,491,244,https://www.intensivregister.de/api/public/reporting/laendertabelle
1628914749,25275,20784,4491,492,242,https://www.intensivregister.de/api/public/reporting/laendertabelle
1628918349,25239,20714,4525,484,235,https://www.intensivregister.de/api/public/reporting/laendertabelle
1628921948,25202,20629,4573,488,235,https://www.intensivregister.de/api/public/reporting/laendertabelle
1628925547,25200,20597,4603,489,236,https://www.intensivregister.de/api/public/reporting/laendertabelle
1628929156,25201,20609,4592,491,236,https://www.intensivregister.de/api/public/reporting/laendertabelle
1628932755,25195,20596,4599,490,235,https://www.intensivregister.de/api/public/reporting/laendertabelle
1628936355,25195,20587,4608,489,234,https://www.intensivregister.de/api/public/reporting/laendertabelle
1628939955,25195,20588,4607,489,234,https://www.intensivregister.de/api/public/reporting/laendertabelle
1628943554,25195,20587,4608,489,234,https://www.intensivregister.de/api/public/reporting/laendertabelle
1628947153,25194,20581,4613,489,234,https://www.intensivregister.de/api/public/reporting/laendertabelle
1628950752,25192,20574,4618,489,234,https://www.intensivregister.de/api/public/reporting/laendertabelle
1628954352,25192,20573,4619,489,234,https://www.intensivregister.de/api/public/reporting/laendertabelle
1628957951,25192,20574,4618,489,234,https://www.intensivregister.de/api/public/reporting/laendertabelle
1628972349,25184,20541,4643,490,234,https://www.intensivregister.de/api/public/reporting/laendertabelle
1628975948,25185,20543,4642,490,234,https://www.intensivregister.de/api/public/reporting/laendertabelle
1628979547,25184,20543,4641,490,234,https://www.intensivregister.de/api/public/reporting/laendertabelle
1628983147,25184,20545,4639,490,234,https://www.intensivregister.de/api/public/reporting/laendertabelle
1628990346,25186,20564,4622,490,235,https://www.intensivregister.de/api/public/reporting/laendertabelle
1628993956,25184,20544,4640,489,234,https://www.intensivregister.de/api/public/reporting/laendertabelle
1628997556,25176,20469,4707,490,237,https://www.intensivregister.de/api/public/reporting/laendertabelle
1629001155,25157,20444,4713,496,235,https://www.intensivregister.de/api/public/reporting/laendertabelle
1629004755,25140,20353,4787,512,239,https://www.intensivregister.de/api/public/reporting/laendertabelle
1629008354,25134,20297,4837,515,240,https://www.intensivregister.de/api/public/reporting/laendertabelle
1629011954,25133,20293,4840,516,242,https://www.intensivregister.de/api/public/reporting/laendertabelle
1629015554,25132,20300,4832,516,242,https://www.intensivregister.de/api/public/reporting/laendertabelle
1629019153,25131,20304,4827,516,242,https://www.intensivregister.de/api/public/reporting/laendertabelle
1629022752,25131,20303,4828,516,242,https://www.intensivregister.de/api/public/reporting/laendertabelle
1629026352,25131,20296,4835,514,241,https://www.intensivregister.de/api/public/reporting/laendertabelle
1629033551,25131,20298,4833,514,241,https://www.intensivregister.de/api/public/reporting/laendertabelle
1629037150,25131,20301,4830,516,241,https://www.intensivregister.de/api/public/reporting/laendertabelle
1629040750,25131,20304,4827,516,241,https://www.intensivregister.de/api/public/reporting/laendertabelle
1629044350,25131,20300,4831,517,242,https://www.intensivregister.de/api/public/reporting/laendertabelle
1629047949,25131,20303,4828,518,243,https://www.intensivregister.de/api/public/reporting/laendertabelle
1629058747,25131,20301,4830,518,243,https://www.intensivregister.de/api/public/reporting/laendertabelle
1629062347,25132,20300,4832,518,243,https://www.intensivregister.de/api/public/reporting/laendertabelle
1629065956,25132,20301,4831,518,243,https://www.intensivregister.de/api/public/reporting/laendertabelle
1629069556,25133,20300,4833,518,243,https://www.intensivregister.de/api/public/reporting/laendertabelle
1629073161,25138,20302,4836,517,242,https://www.intensivregister.de/api/public/reporting/laendertabelle
1629076755,25146,20310,4836,517,242,https://www.intensivregister.de/api/public/reporting/laendertabelle
1629080355,25171,20283,4888,520,244,https://www.intensivregister.de/api/public/reporting/laendertabelle
1629083950,25166,20327,4839,525,244,https://www.intensivregister.de/api/public/reporting/laendertabelle
1629087556,25211,20374,4837,526,248,https://www.intensivregister.de/api/public/reporting/laendertabelle
1629091151,25250,20450,4800,540,253,https://www.intensivregister.de/api/public/reporting/laendertabelle
1629094747,25290,20480,4810,547,257,https://www.intensivregister.de/api/public/reporting/laendertabelle
1629098354,25293,20509,4784,547,258,https://www.intensivregister.de/api/public/reporting/laendertabelle
1629101950,25289,20508,4781,548,259,https://www.intensivregister.de/api/public/reporting/laendertabelle
1629105547,25289,20506,4783,549,259,https://www.intensivregister.de/api/public/reporting/laendertabelle
1629109153,25292,20507,4785,550,260,https://www.intensivregister.de/api/public/reporting/laendertabelle
1629112749,25292,20504,4788,552,260,https://www.intensivregister.de/api/public/reporting/laendertabelle
1629116355,25293,20506,4787,552,259,https://www.intensivregister.de/api/public/reporting/laendertabelle
1629119951,25296,20504,4792,552,259,https://www.intensivregister.de/api/public/reporting/laendertabelle
1629127154,25296,20506,4790,552,259,https://www.intensivregister.de/api/public/reporting/laendertabelle
1629130750,25296,20510,4786,552,259,https://www.intensivregister.de/api/public/reporting/laendertabelle
1629137953,25296,20513,4783,553,260,https://www.intensivregister.de/api/public/reporting/laendertabelle
1629141549,25296,20515,4781,553,260,https://www.intensivregister.de/api/public/reporting/laendertabelle
1629145155,25300,20516,4784,553,260,https://www.intensivregister.de/api/public/reporting/laendertabelle
1629148753,25301,20512,4789,553,260,https://www.intensivregister.de/api/public/reporting/laendertabelle
1629152356,25299,20512,4787,553,260,https://www.intensivregister.de/api/public/reporting/laendertabelle
1629155952,25298,20508,4790,553,260,https://www.intensivregister.de/api/public/reporting/laendertabelle
1629159548,25294,20510,4784,554,261,https://www.intensivregister.de/api/public/reporting/laendertabelle
1629163155,25291,20519,4772,554,261,https://www.intensivregister.de/api/public/reporting/laendertabelle
1629166751,25296,20564,4732,554,264,https://www.intensivregister.de/api/public/reporting/laendertabelle
1629170348,25260,20625,4635,561,267,https://www.intensivregister.de/api/public/reporting/laendertabelle
1629173953,25283,20630,4653,566,272,https://www.intensivregister.de/api/public/reporting/laendertabelle
1629177549,25306,20692,4614,571,270,https://www.intensivregister.de/api/public/reporting/laendertabelle
1629181156,25311,20715,4596,570,267,https://www.intensivregister.de/api/public/reporting/laendertabelle
1629184753,25323,20742,4581,574,272,https://www.intensivregister.de/api/public/reporting/laendertabelle
1629188349,25324,20748,4576,574,272,https://www.intensivregister.de/api/public/reporting/laendertabelle
1629191956,25324,20760,4564,576,272,https://www.intensivregister.de/api/public/reporting/laendertabelle
1629195553,25323,20758,4565,578,274,https://www.intensivregister.de/api/public/reporting/laendertabelle
1629199149,25325,20760,4565,576,272,https://www.intensivregister.de/api/public/reporting/laendertabelle
1629202756,25322,20760,4562,578,273,https://www.intensivregister.de/api/public/reporting/laendertabelle
1629209949,25322,20760,4562,577,273,https://www.intensivregister.de/api/public/reporting/laendertabelle
1629213556,25322,20758,4564,577,273,https://www.intensivregister.de/api/public/reporting/laendertabelle
1629217150,25320,20758,4562,578,273,https://www.intensivregister.de/api/public/reporting/laendertabelle
1629224352,25320,20760,4560,579,274,https://www.intensivregister.de/api/public/reporting/laendertabelle
1629227948,25320,20761,4559,579,274,https://www.intensivregister.de/api/public/reporting/laendertabelle
1629231554,25318,20762,4556,579,274,https://www.intensivregister.de/api/public/reporting/laendertabelle
1629235149,25317,20762,4555,579,274,https://www.intensivregister.de/api/public/reporting/laendertabelle
1629238755,25317,20765,4552,579,274,https://www.intensivregister.de/api/public/reporting/laendertabelle
1629242351,25318,20763,4555,579,274,https://www.intensivregister.de/api/public/reporting/laendertabelle
1629245957,25314,20762,4552,579,274,https://www.intensivregister.de/api/public/reporting/laendertabelle
1629249552,25314,20762,4552,582,274,https://www.intensivregister.de/api/public/reporting/laendertabelle
1629253147,25312,20782,4530,581,276,https://www.intensivregister.de/api/public/reporting/laendertabelle
1629256753,25332,20796,4536,587,277,https://www.intensivregister.de/api/public/reporting/laendertabelle
1629260350,25333,20818,4515,591,278,https://www.intensivregister.de/api/public/reporting/laendertabelle
1629263951,25345,20861,4484,595,280,https://www.intensivregister.de/api/public/reporting/laendertabelle
1629267552,25353,20857,4496,597,280,https://www.intensivregister.de/api/public/reporting/laendertabelle
1629271154,25364,20865,4499,599,280,https://www.intensivregister.de/api/public/reporting/laendertabelle
1629274756,25364,20858,4506,601,281,https://www.intensivregister.de/api/public/reporting/laendertabelle
1629278348,25363,20860,4503,603,281,https://www.intensivregister.de/api/public/reporting/laendertabelle
1629281950,25363,20853,4510,603,281,https://www.intensivregister.de/api/public/reporting/laendertabelle
1629285551,25363,20850,4513,603,281,https://www.intensivregister.de/api/public/reporting/laendertabelle
1629289153,25363,20855,4508,605,282,https://www.intensivregister.de/api/public/reporting/laendertabelle
1629292754,25365,20857,4508,605,282,https://www.intensivregister.de/api/public/reporting/laendertabelle
1629307154,25365,20857,4508,604,281,https://www.intensivregister.de/api/public/reporting/laendertabelle
1629317950,25363,20855,4508,604,281,https://www.intensivregister.de/api/public/reporting/laendertabelle
1629321552,25365,20857,4508,604,281,https://www.intensivregister.de/api/public/reporting/laendertabelle
1629325153,25365,20852,4513,604,281,https://www.intensivregister.de/api/public/reporting/laendertabelle
1629328755,25359,20843,4516,604,281,https://www.intensivregister.de/api/public/reporting/laendertabelle
1629332353,25359,20841,4518,604,281,https://www.intensivregister.de/api/public/reporting/laendertabelle
1629335951,25359,20847,4512,604,281,https://www.intensivregister.de/api/public/reporting/laendertabelle
1629339550,25357,20827,4530,603,281,https://www.intensivregister.de/api/public/reporting/laendertabelle
1629343149,25368,20857,4511,602,279,https://www.intensivregister.de/api/public/reporting/laendertabelle
1629346748,25352,20831,4521,604,285,https://www.intensivregister.de/api/public/reporting/laendertabelle
1629350347,25351,20852,4499,610,290,https://www.intensivregister.de/api/public/reporting/laendertabelle
1629353948,25348,20843,4505,611,290,https://www.intensivregister.de/api/public/reporting/laendertabelle
1629357552,25346,20859,4487,620,293,https://www.intensivregister.de/api/public/reporting/laendertabelle
1629361153,25344,20856,4488,621,293,https://www.intensivregister.de/api/public/reporting/laendertabelle
1629368352,25344,20858,4486,621,292,https://www.intensivregister.de/api/public/reporting/laendertabelle
1629371953,25344,20862,4482,623,292,https://www.intensivregister.de/api/public/reporting/laendertabelle
1629375555,25342,20862,4480,625,292,https://www.intensivregister.de/api/public/reporting/laendertabelle
1629379149,25342,20864,4478,626,292,https://www.intensivregister.de/api/public/reporting/laendertabelle
1629382751,25342,20863,4479,626,292,https://www.intensivregister.de/api/public/reporting/laendertabelle
1629386352,25342,20864,4478,626,292,https://www.intensivregister.de/api/public/reporting/laendertabelle
1629389952,25342,20862,4480,626,292,https://www.intensivregister.de/api/public/reporting/laendertabelle
1629404347,25344,20867,4477,626,292,https://www.intensivregister.de/api/public/reporting/laendertabelle
1629407947,25343,20862,4481,626,292,https://www.intensivregister.de/api/public/reporting/laendertabelle
1629411556,25343,20861,4482,626,292,https://www.intensivregister.de/api/public/reporting/laendertabelle
1629415155,25345,20872,4473,626,292,https://www.intensivregister.de/api/public/reporting/laendertabelle
1629418756,25344,20871,4473,627,292,https://www.intensivregister.de/api/public/reporting/laendertabelle
1629422348,25346,20875,4471,627,292,https://www.intensivregister.de/api/public/reporting/laendertabelle
1629425948,25352,20890,4462,629,292,https://www.intensivregister.de/api/public/reporting/laendertabelle
1629429549,25333,20845,4488,643,297,https://www.intensivregister.de/api/public/reporting/laendertabelle
1629433151,25310,20871,4439,647,298,https://www.intensivregister.de/api/public/reporting/laendertabelle
1629436751,25273,20882,4391,657,306,https://www.intensivregister.de/api/public/reporting/laendertabelle
1629440352,25263,20929,4334,655,308,https://www.intensivregister.de/api/public/reporting/laendertabelle
1629443954,25254,20891,4363,650,312,https://www.intensivregister.de/api/public/reporting/laendertabelle
1629447555,25250,20872,4378,650,312,https://www.intensivregister.de/api/public/reporting/laendertabelle
1629451156,25248,20865,4383,650,312,https://www.intensivregister.de/api/public/reporting/laendertabelle
1629454750,25243,20860,4383,650,312,https://www.intensivregister.de/api/public/reporting/laendertabelle
1629458354,25243,20861,4382,650,312,https://www.intensivregister.de/api/public/reporting/laendertabelle
1629461956,25241,20858,4383,650,312,https://www.intensivregister.de/api/public/reporting/laendertabelle
1629465547,25241,20858,4383,651,312,https://www.intensivregister.de/api/public/reporting/laendertabelle
1629469148,25244,20867,4377,652,312,https://www.intensivregister.de/api/public/reporting/laendertabelle
1629483554,25243,20863,4380,651,311,https://www.intensivregister.de/api/public/reporting/laendertabelle
1629487156,25243,20861,4382,651,311,https://www.intensivregister.de/api/public/reporting/laendertabelle
1629490747,25243,20877,4366,652,311,https://www.intensivregister.de/api/public/reporting/laendertabelle
1629494347,25242,20875,4367,653,311,https://www.intensivregister.de/api/public/reporting/laendertabelle
1629497948,25240,20871,4369,653,311,https://www.intensivregister.de/api/public/reporting/laendertabelle
1629501550,25238,20869,4369,653,311,https://www.intensivregister.de/api/public/reporting/laendertabelle
1629505151,25238,20864,4374,653,311,https://www.intensivregister.de/api/public/reporting/laendertabelle
1629508755,25239,20860,4379,653,311,https://www.intensivregister.de/api/public/reporting/laendertabelle
1629512355,25249,20845,4404,655,310,https://www.intensivregister.de/api/public/reporting/laendertabelle
1629515956,25203,20793,4410,658,312,https://www.intensivregister.de/api/public/reporting/laendertabelle
1629519549,25149,20679,4470,675,313,https://www.intensivregister.de/api/public/reporting/laendertabelle
1629523152,25100,20633,4467,683,318,https://www.intensivregister.de/api/public/reporting/laendertabelle
1629526756,25072,20560,4512,685,314,https://www.intensivregister.de/api/public/reporting/laendertabelle
1629530349,25028,20486,4542,681,313,https://www.intensivregister.de/api/public/reporting/laendertabelle
1629533953,25020,20467,4553,683,314,https://www.intensivregister.de/api/public/reporting/laendertabelle
1629537556,25018,20447,4571,683,314,https://www.intensivregister.de/api/public/reporting/laendertabelle
1629541149,25016,20439,4577,683,314,https://www.intensivregister.de/api/public/reporting/laendertabelle
1629544748,25016,20436,4580,683,314,https://www.intensivregister.de/api/public/reporting/laendertabelle
1629548353,25016,20439,4577,684,314,https://www.intensivregister.de/api/public/reporting/laendertabelle
1629555551,25014,20435,4579,684,314,https://www.intensivregister.de/api/public/reporting/laendertabelle
1629559155,25014,20431,4583,684,314,https://www.intensivregister.de/api/public/reporting/laendertabelle
1629566352,25014,20434,4580,684,314,https://www.intensivregister.de/api/public/reporting/laendertabelle
1629569956,25014,20435,4579,684,314,https://www.intensivregister.de/api/public/reporting/laendertabelle
1629577151,25012,20435,4577,682,314,https://www.intensivregister.de/api/public/reporting/laendertabelle
1629580755,25013,20432,4581,681,313,https://www.intensivregister.de/api/public/reporting/laendertabelle
1629584348,25013,20428,4585,681,313,https://www.intensivregister.de/api/public/reporting/laendertabelle
1629587951,25013,20421,4592,681,313,https://www.intensivregister.de/api/public/reporting/laendertabelle
1629591555,25011,20422,4589,680,313,https://www.intensivregister.de/api/public/reporting/laendertabelle
1629595147,25012,20427,4585,681,313,https://www.intensivregister.de/api/public/reporting/laendertabelle
1629598750,24997,20387,4610,679,314,https://www.intensivregister.de/api/public/reporting/laendertabelle
1629602353,24999,20351,4648,684,320,https://www.intensivregister.de/api/public/reporting/laendertabelle
1629605956,24986,20274,4712,694,326,https://www.intensivregister.de/api/public/reporting/laendertabelle
1629609556,24962,20232,4730,706,330,https://www.intensivregister.de/api/public/reporting/laendertabelle
1629613150,24933,20197,4736,712,332,https://www.intensivregister.de/api/public/reporting/laendertabelle
1629616753,24901,20149,4752,713,335,https://www.intensivregister.de/api/public/reporting/laendertabelle
1629620347,24899,20141,4758,713,336,https://www.intensivregister.de/api/public/reporting/laendertabelle
1629623951,24898,20139,4759,714,336,https://www.intensivregister.de/api/public/reporting/laendertabelle
1629627553,24897,20137,4760,714,336,https://www.intensivregister.de/api/public/reporting/laendertabelle
1629631147,24867,20109,4758,714,336,https://www.intensivregister.de/api/public/reporting/laendertabelle
1629634750,24864,20108,4756,714,336,https://www.intensivregister.de/api/public/reporting/laendertabelle
1629638353,24864,20112,4752,714,336,https://www.intensivregister.de/api/public/reporting/laendertabelle
1629649153,24864,20117,4747,714,337,https://www.intensivregister.de/api/public/reporting/laendertabelle
1629659952,24864,20118,4746,714,337,https://www.intensivregister.de/api/public/reporting/laendertabelle
1629663556,24864,20121,4743,715,337,https://www.intensivregister.de/api/public/reporting/laendertabelle
1629667156,24864,20122,4742,715,337,https://www.intensivregister.de/api/public/reporting/laendertabelle
1629670755,24864,20119,4745,715,337,https://www.intensivregister.de/api/public/reporting/laendertabelle
1629674354,24861,20115,4746,715,337,https://www.intensivregister.de/api/public/reporting/laendertabelle
1629677948,24862,20127,4735,716,338,https://www.intensivregister.de/api/public/reporting/laendertabelle
1629681551,24865,20123,4742,716,338,https://www.intensivregister.de/api/public/reporting/laendertabelle
1629685155,24892,20162,4730,723,338,https://www.intensivregister.de/api/public/reporting/laendertabelle
1629688748,24980,20196,4784,735,342,https://www.intensivregister.de/api/public/reporting/laendertabelle
1629692352,25061,20238,4823,750,346,https://www.intensivregister.de/api/public/reporting/laendertabelle
1629695950,25117,20318,4799,771,361,https://www.intensivregister.de/api/public/reporting/laendertabelle
1629699551,25137,20359,4778,771,359,https://www.intensivregister.de/api/public/reporting/laendertabelle
1629703154,25155,20397,4758,775,360,https://www.intensivregister.de/api/public/reporting/laendertabelle
1629706756,25176,20410,4766,776,360,https://www.intensivregister.de/api/public/reporting/laendertabelle
1629710349,25172,20412,4760,777,360,https://www.intensivregister.de/api/public/reporting/laendertabelle
1629713954,25172,20414,4758,777,360,https://www.intensivregister.de/api/public/reporting/laendertabelle
1629717548,25172,20419,4753,777,360,https://www.intensivregister.de/api/public/reporting/laendertabelle
1629721151,25172,20418,4754,777,360,https://www.intensivregister.de/api/public/reporting/laendertabelle
1629724756,25173,20417,4756,777,360,https://www.intensivregister.de/api/public/reporting/laendertabelle
1629728350,25173,20419,4754,777,361,https://www.intensivregister.de/api/public/reporting/laendertabelle
1629731955,25173,20416,4757,777,361,https://www.intensivregister.de/api/public/reporting/laendertabelle
1629735549,25172,20418,4754,777,361,https://www.intensivregister.de/api/public/reporting/laendertabelle
1629739153,25172,20419,4753,777,361,https://www.intensivregister.de/api/public/reporting/laendertabelle
1629749948,25172,20418,4754,777,361,https://www.intensivregister.de/api/public/reporting/laendertabelle
1629753553,25172,20426,4746,778,362,https://www.intensivregister.de/api/public/reporting/laendertabelle
1629757147,25172,20422,4750,780,362,https://www.intensivregister.de/api/public/reporting/laendertabelle
1629760752,25177,20426,4751,781,362,https://www.intensivregister.de/api/public/reporting/laendertabelle
1629764356,25179,20427,4752,781,362,https://www.intensivregister.de/api/public/reporting/laendertabelle
1629767949,25178,20431,4747,781,362,https://www.intensivregister.de/api/public/reporting/laendertabelle
1629771553,25190,20454,4736,779,359,https://www.intensivregister.de/api/public/reporting/laendertabelle
1629775147,25172,20578,4594,784,370,https://www.intensivregister.de/api/public/reporting/laendertabelle
1629778751,25174,20719,4455,796,377,https://www.intensivregister.de/api/public/reporting/laendertabelle
1629782355,25185,20779,4406,799,376,https://www.intensivregister.de/api/public/reporting/laendertabelle
1629785950,25175,20789,4386,803,382,https://www.intensivregister.de/api/public/reporting/laendertabelle
1629789554,25210,20837,4373,805,381,https://www.intensivregister.de/api/public/reporting/laendertabelle
1629793148,25210,20826,4384,805,381,https://www.intensivregister.de/api/public/reporting/laendertabelle
1629796752,25213,20818,4395,804,381,https://www.intensivregister.de/api/public/reporting/laendertabelle
1629800355,25243,20847,4396,805,381,https://www.intensivregister.de/api/public/reporting/laendertabelle
1629803949,25247,20852,4395,806,381,https://www.intensivregister.de/api/public/reporting/laendertabelle
1629807553,25247,20853,4394,806,381,https://www.intensivregister.de/api/public/reporting/laendertabelle
1629811146,25244,20851,4393,806,381,https://www.intensivregister.de/api/public/reporting/laendertabelle
1629814750,25244,20852,4392,807,382,https://www.intensivregister.de/api/public/reporting/laendertabelle
1629821957,25244,20853,4391,807,382,https://www.intensivregister.de/api/public/reporting/laendertabelle
1629829154,25244,20854,4390,807,382,https://www.intensivregister.de/api/public/reporting/laendertabelle
1629832747,25244,20855,4389,807,382,https://www.intensivregister.de/api/public/reporting/laendertabelle
1629836351,25245,20854,4391,807,382,https://www.intensivregister.de/api/public/reporting/laendertabelle
1629839950,25248,20857,4391,807,382,https://www.intensivregister.de/api/public/reporting/laendertabelle
1629843548,25249,20861,4388,807,382,https://www.intensivregister.de/api/public/reporting/laendertabelle
1629847148,25251,20866,4385,808,383,https://www.intensivregister.de/api/public/reporting/laendertabelle
1629850747,25252,20865,4387,808,383,https://www.intensivregister.de/api/public/reporting/laendertabelle
1629854351,25252,20871,4381,808,382,https://www.intensivregister.de/api/public/reporting/laendertabelle
1629857956,25260,20888,4372,804,385,https://www.intensivregister.de/api/public/reporting/laendertabelle
1629861551,25280,20852,4428,811,393,https://www.intensivregister.de/api/public/reporting/laendertabelle
1629865156,25290,20852,4438,825,394,https://www.intensivregister.de/api/public/reporting/laendertabelle
1629868752,25258,20815,4443,824,394,https://www.intensivregister.de/api/public/reporting/laendertabelle
1629872348,25264,20818,4446,836,392,https://www.intensivregister.de/api/public/reporting/laendertabelle
1629875954,25268,20851,4417,837,398,https://www.intensivregister.de/api/public/reporting/laendertabelle
1629879575,25267,20854,4413,837,398,https://www.intensivregister.de/api/public/reporting/laendertabelle
1629883147,25267,20846,4421,838,398,https://www.intensivregister.de/api/public/reporting/laendertabelle
1629886753,25267,20848,4419,838,398,https://www.intensivregister.de/api/public/reporting/laendertabelle
1629890352,25269,20851,4418,838,398,https://www.intensivregister.de/api/public/reporting/laendertabelle
1629893956,25268,20851,4417,836,397,https://www.intensivregister.de/api/public/reporting/laendertabelle
1629897552,25268,20852,4416,836,397,https://www.intensivregister.de/api/public/reporting/laendertabelle
1629901148,25268,20855,4413,837,398,https://www.intensivregister.de/api/public/reporting/laendertabelle
1629904753,25268,20853,4415,837,399,https://www.intensivregister.de/api/public/reporting/laendertabelle
1629922747,25268,20851,4417,840,400,https://www.intensivregister.de/api/public/reporting/laendertabelle
1629926354,25268,20854,4414,840,400,https://www.intensivregister.de/api/public/reporting/laendertabelle
1629929951,25268,20847,4421,840,400,https://www.intensivregister.de/api/public/reporting/laendertabelle
1629933548,25270,20843,4427,841,400,https://www.intensivregister.de/api/public/reporting/laendertabelle
1629937154,25270,20842,4428,841,400,https://www.intensivregister.de/api/public/reporting/laendertabelle
1629940752,25270,20842,4428,842,400,https://www.intensivregister.de/api/public/reporting/laendertabelle
1629944348,25271,20844,4427,843,401,https://www.intensivregister.de/api/public/reporting/laendertabelle
1629947955,25269,20884,4385,849,408,https://www.intensivregister.de/api/public/reporting/laendertabelle
1629951552,25240,20883,4357,849,407,https://www.intensivregister.de/api/public/reporting/laendertabelle
1629955149,25261,20958,4303,867,420,https://www.intensivregister.de/api/public/reporting/laendertabelle
1629958756,25261,20972,4289,868,423,https://www.intensivregister.de/api/public/reporting/laendertabelle
1629962353,25266,20966,4300,869,428,https://www.intensivregister.de/api/public/reporting/laendertabelle
1629965950,25261,20968,4293,869,429,https://www.intensivregister.de/api/public/reporting/laendertabelle
1629969548,25250,20963,4287,870,429,https://www.intensivregister.de/api/public/reporting/laendertabelle
1629973154,25246,20955,4291,870,429,https://www.intensivregister.de/api/public/reporting/laendertabelle
1629976752,25246,20953,4293,870,429,https://www.intensivregister.de/api/public/reporting/laendertabelle
1629983955,25246,20954,4292,870,429,https://www.intensivregister.de/api/public/reporting/laendertabelle
1629987553,25246,20960,4286,870,429,https://www.intensivregister.de/api/public/reporting/laendertabelle
1630009152,25246,20959,4287,869,429,https://www.intensivregister.de/api/public/reporting/laendertabelle
1630012748,25243,20960,4283,869,429,https://www.intensivregister.de/api/public/reporting/laendertabelle
1630016356,25243,20955,4288,869,429,https://www.intensivregister.de/api/public/reporting/laendertabelle
1630019954,25242,20956,4286,869,429,https://www.intensivregister.de/api/public/reporting/laendertabelle
1630023551,25243,20964,4279,864,429,https://www.intensivregister.de/api/public/reporting/laendertabelle
1630027148,25242,20965,4277,865,430,https://www.intensivregister.de/api/public/reporting/laendertabelle
1630030755,25236,20967,4269,871,434,https://www.intensivregister.de/api/public/reporting/laendertabelle
1630034353,25211,20975,4236,883,438,https://www.intensivregister.de/api/public/reporting/laendertabelle
1630037949,25202,20967,4235,904,443,https://www.intensivregister.de/api/public/reporting/laendertabelle
1630041556,25183,20892,4291,917,446,https://www.intensivregister.de/api/public/reporting/laendertabelle
1630045153,25178,20898,4280,924,444,https://www.intensivregister.de/api/public/reporting/laendertabelle
1630048750,25178,20874,4304,923,445,https://www.intensivregister.de/api/public/reporting/laendertabelle
1630052347,25171,20857,4314,924,446,https://www.intensivregister.de/api/public/reporting/laendertabelle
1630055954,25166,20856,4310,925,447,https://www.intensivregister.de/api/public/reporting/laendertabelle
1630059551,25161,20844,4317,928,448,https://www.intensivregister.de/api/public/reporting/laendertabelle
1630066755,25151,20840,4311,928,449,https://www.intensivregister.de/api/public/reporting/laendertabelle
1630070353,25151,20841,4310,933,450,https://www.intensivregister.de/api/public/reporting/laendertabelle
1630073950,25151,20839,4312,933,450,https://www.intensivregister.de/api/public/reporting/laendertabelle
1630081153,25151,20839,4312,935,450,https://www.intensivregister.de/api/public/reporting/laendertabelle
1630095549,25148,20822,4326,936,450,https://www.intensivregister.de/api/public/reporting/laendertabelle
1630099147,25148,20816,4332,936,449,https://www.intensivregister.de/api/public/reporting/laendertabelle
1630102754,25144,20810,4334,937,449,https://www.intensivregister.de/api/public/reporting/laendertabelle
1630106352,25144,20817,4327,937,449,https://www.intensivregister.de/api/public/reporting/laendertabelle
1630109948,25145,20812,4333,937,449,https://www.intensivregister.de/api/public/reporting/laendertabelle
1630113554,25141,20808,4333,937,449,https://www.intensivregister.de/api/public/reporting/laendertabelle
1630117152,25139,20794,4345,934,448,https://www.intensivregister.de/api/public/reporting/laendertabelle
1630120749,25129,20761,4368,936,449,https://www.intensivregister.de/api/public/reporting/laendertabelle
1630124356,25062,20678,4384,938,452,https://www.intensivregister.de/api/public/reporting/laendertabelle
1630127955,24986,20646,4340,957,467,https://www.intensivregister.de/api/public/reporting/laendertabelle
1630131550,24958,20592,4366,971,473,https://www.intensivregister.de/api/public/reporting/laendertabelle
1630135148,24936,20513,4423,972,477,https://www.intensivregister.de/api/public/reporting/laendertabelle
1630138755,24918,20496,4422,975,478,https://www.intensivregister.de/api/public/reporting/laendertabelle
1630142353,24917,20498,4419,976,478,https://www.intensivregister.de/api/public/reporting/laendertabelle
1630145950,24917,20501,4416,977,477,https://www.intensivregister.de/api/public/reporting/laendertabelle
1630149547,24917,20506,4411,977,477,https://www.intensivregister.de/api/public/reporting/laendertabelle
1630153154,24917,20500,4417,975,477,https://www.intensivregister.de/api/public/reporting/laendertabelle
1630156751,24913,20493,4420,975,477,https://www.intensivregister.de/api/public/reporting/laendertabelle
1630163956,24913,20497,4416,975,477,https://www.intensivregister.de/api/public/reporting/laendertabelle
1630167553,24914,20500,4414,975,477,https://www.intensivregister.de/api/public/reporting/laendertabelle
1630174747,24914,20501,4413,975,477,https://www.intensivregister.de/api/public/reporting/laendertabelle
1630178354,24914,20499,4415,974,476,https://www.intensivregister.de/api/public/reporting/laendertabelle
1630181951,24913,20498,4415,974,476,https://www.intensivregister.de/api/public/reporting/laendertabelle
1630185548,24911,20501,4410,973,476,https://www.intensivregister.de/api/public/reporting/laendertabelle
1630189155,24911,20503,4408,973,476,https://www.intensivregister.de/api/public/reporting/laendertabelle
1630192752,24913,20508,4405,973,476,https://www.intensivregister.de/api/public/reporting/laendertabelle
1630196350,24912,20513,4399,974,476,https://www.intensivregister.de/api/public/reporting/laendertabelle
1630199956,24912,20521,4391,974,476,https://www.intensivregister.de/api/public/reporting/laendertabelle
1630203553,24912,20497,4415,976,478,https://www.intensivregister.de/api/public/reporting/laendertabelle
1630207151,24893,20461,4432,975,477,https://www.intensivregister.de/api/public/reporting/laendertabelle
1630210748,24868,20358,4510,986,480,https://www.intensivregister.de/api/public/reporting/laendertabelle
1630214356,24865,20293,4572,998,482,https://www.intensivregister.de/api/public/reporting/laendertabelle
1630217953,24847,20210,4637,1005,482,https://www.intensivregister.de/api/public/reporting/laendertabelle
1630221551,24838,20221,4617,1007,486,https://www.intensivregister.de/api/public/reporting/laendertabelle
1630225147,24826,20227,4599,1007,485,https://www.intensivregister.de/api/public/reporting/laendertabelle
1630228753,24826,20228,4598,1008,485,https://www.intensivregister.de/api/public/reporting/laendertabelle
1630232351,24824,20216,4608,1008,485,https://www.intensivregister.de/api/public/reporting/laendertabelle
1630235948,24824,20214,4610,1007,485,https://www.intensivregister.de/api/public/reporting/laendertabelle
1630239555,24823,20213,4610,1007,485,https://www.intensivregister.de/api/public/reporting/laendertabelle
1630243152,24823,20210,4613,1007,485,https://www.intensivregister.de/api/public/reporting/laendertabelle
1630246749,24824,20210,4614,1008,485,https://www.intensivregister.de/api/public/reporting/laendertabelle
1630257551,24824,20209,4615,1008,485,https://www.intensivregister.de/api/public/reporting/laendertabelle
1630264755,24824,20210,4614,1008,485,https://www.intensivregister.de/api/public/reporting/laendertabelle
1630268352,24824,20209,4615,1008,485,https://www.intensivregister.de/api/public/reporting/laendertabelle
1630271949,24826,20208,4618,1008,485,https://www.intensivregister.de/api/public/reporting/laendertabelle
1630275555,24825,20207,4618,1008,485,https://www.intensivregister.de/api/public/reporting/laendertabelle
1630279151,24823,20208,4615,1008,485,https://www.intensivregister.de/api/public/reporting/laendertabelle
1630282748,24824,20207,4617,1008,486,https://www.intensivregister.de/api/public/reporting/laendertabelle
1630286354,24835,20212,4623,1009,486,https://www.intensivregister.de/api/public/reporting/laendertabelle
1630289951,24884,20209,4675,1015,489,https://www.intensivregister.de/api/public/reporting/laendertabelle
1630293548,24947,20276,4671,1031,492,https://www.intensivregister.de/api/public/reporting/laendertabelle
1630297156,24995,20324,4671,1041,506,https://www.intensivregister.de/api/public/reporting/laendertabelle
1630300753,25034,20416,4618,1055,514,https://www.intensivregister.de/api/public/reporting/laendertabelle
1630304350,25083,20432,4651,1061,520,https://www.intensivregister.de/api/public/reporting/laendertabelle
1630307956,25101,20449,4652,1069,523,https://www.intensivregister.de/api/public/reporting/laendertabelle
1630311554,25105,20437,4668,1068,523,https://www.intensivregister.de/api/public/reporting/laendertabelle
1630315151,25110,20444,4666,1068,523,https://www.intensivregister.de/api/public/reporting/laendertabelle
1630318748,25109,20442,4667,1068,523,https://www.intensivregister.de/api/public/reporting/laendertabelle
1630322355,25107,20431,4676,1068,523,https://www.intensivregister.de/api/public/reporting/laendertabelle
1630325953,25105,20432,4673,1068,523,https://www.intensivregister.de/api/public/reporting/laendertabelle
1630333152,25105,20435,4670,1068,523,https://www.intensivregister.de/api/public/reporting/laendertabelle
1630336751,25102,20432,4670,1068,523,https://www.intensivregister.de/api/public/reporting/laendertabelle
1630340348,25101,20437,4664,1068,523,https://www.intensivregister.de/api/public/reporting/laendertabelle
1630343956,25101,20438,4663,1068,523,https://www.intensivregister.de/api/public/reporting/laendertabelle
1630354748,25103,20440,4663,1068,523,https://www.intensivregister.de/api/public/reporting/laendertabelle
1630358354,25103,20445,4658,1067,523,https://www.intensivregister.de/api/public/reporting/laendertabelle
1630361951,25108,20445,4663,1068,524,https://www.intensivregister.de/api/public/reporting/laendertabelle
1630365548,25106,20438,4668,1067,524,https://www.intensivregister.de/api/public/reporting/laendertabelle
1630369155,25108,20439,4669,1067,524,https://www.intensivregister.de/api/public/reporting/laendertabelle
1630372750,25111,20457,4654,1068,525,https://www.intensivregister.de/api/public/reporting/laendertabelle
1630376347,25127,20512,4615,1069,527,https://www.intensivregister.de/api/public/reporting/laendertabelle
1630379954,25129,20556,4573,1069,532,https://www.intensivregister.de/api/public/reporting/laendertabelle
1630383552,25192,20739,4453,1080,541,https://www.intensivregister.de/api/public/reporting/laendertabelle
1630387150,25195,20785,4410,1083,551,https://www.intensivregister.de/api/public/reporting/laendertabelle
1630390747,25221,20844,4377,1093,552,https://www.intensivregister.de/api/public/reporting/laendertabelle
1630394353,25219,20850,4369,1098,558,https://www.intensivregister.de/api/public/reporting/laendertabelle
1630397949,25218,20854,4364,1094,559,https://www.intensivregister.de/api/public/reporting/laendertabelle
1630405153,25248,20851,4397,1095,562,https://www.intensivregister.de/api/public/reporting/laendertabelle
1630408749,25249,20857,4392,1097,562,https://www.intensivregister.de/api/public/reporting/laendertabelle
1630412355,25254,20858,4396,1098,562,https://www.intensivregister.de/api/public/reporting/laendertabelle
1630415951,25253,20860,4393,1097,562,https://www.intensivregister.de/api/public/reporting/laendertabelle
1630419547,25253,20859,4394,1098,562,https://www.intensivregister.de/api/public/reporting/laendertabelle
1630423154,25253,20860,4393,1098,562,https://www.intensivregister.de/api/public/reporting/laendertabelle
1630426750,25253,20859,4394,1098,562,https://www.intensivregister.de/api/public/reporting/laendertabelle
1630441153,25253,20852,4401,1098,562,https://www.intensivregister.de/api/public/reporting/laendertabelle
1630444749,25253,20851,4402,1098,562,https://www.intensivregister.de/api/public/reporting/laendertabelle
1630448355,25253,20855,4398,1098,562,https://www.intensivregister.de/api/public/reporting/laendertabelle
1630451952,25253,20861,4392,1098,562,https://www.intensivregister.de/api/public/reporting/laendertabelle
1630455557,25253,20866,4387,1100,562,https://www.intensivregister.de/api/public/reporting/laendertabelle
1630459152,25252,20868,4384,1099,561,https://www.intensivregister.de/api/public/reporting/laendertabelle
1630462747,25251,20890,4361,1096,561,https://www.intensivregister.de/api/public/reporting/laendertabelle
1630466352,25267,20913,4354,1099,568,https://www.intensivregister.de/api/public/reporting/laendertabelle
1630469947,25266,20950,4316,1105,565,https://www.intensivregister.de/api/public/reporting/laendertabelle
1630473553,25290,21041,4249,1117,572,https://www.intensivregister.de/api/public/reporting/laendertabelle
1630477148,25294,21086,4208,1133,577,https://www.intensivregister.de/api/public/reporting/laendertabelle
1630480753,25301,21111,4190,1133,581,https://www.intensivregister.de/api/public/reporting/laendertabelle
1630484348,25307,21112,4195,1136,581,https://www.intensivregister.de/api/public/reporting/laendertabelle
1630487953,25307,21121,4186,1136,581,https://www.intensivregister.de/api/public/reporting/laendertabelle
1630491548,25307,21124,4183,1136,581,https://www.intensivregister.de/api/public/reporting/laendertabelle
1630495149,25306,21123,4183,1136,581,https://www.intensivregister.de/api/public/reporting/laendertabelle
1630498750,25306,21123,4183,1138,582,https://www.intensivregister.de/api/public/reporting/laendertabelle
1630502351,25306,21124,4182,1141,582,https://www.intensivregister.de/api/public/reporting/laendertabelle
1630505950,25306,21124,4182,1143,582,https://www.intensivregister.de/api/public/reporting/laendertabelle
1630509553,25306,21123,4183,1143,582,https://www.intensivregister.de/api/public/reporting/laendertabelle
1630527554,25308,21124,4184,1143,584,https://www.intensivregister.de/api/public/reporting/laendertabelle
1630531155,25308,21131,4177,1143,584,https://www.intensivregister.de/api/public/reporting/laendertabelle
1630534747,25310,21118,4192,1142,585,https://www.intensivregister.de/api/public/reporting/laendertabelle
1630538349,25310,21115,4195,1142,585,https://www.intensivregister.de/api/public/reporting/laendertabelle
1630541951,25314,21126,4188,1142,585,https://www.intensivregister.de/api/public/reporting/laendertabelle
1630545552,25311,21136,4175,1143,584,https://www.intensivregister.de/api/public/reporting/laendertabelle
1630549153,25317,21131,4186,1145,588,https://www.intensivregister.de/api/public/reporting/laendertabelle
1630552755,25308,21098,4210,1151,584,https://www.intensivregister.de/api/public/reporting/laendertabelle
1630556347,25297,21071,4226,1143,585,https://www.intensivregister.de/api/public/reporting/laendertabelle
1630559951,25291,21067,4224,1153,580,https://www.intensivregister.de/api/public/reporting/laendertabelle
1630563552,25288,21078,4210,1167,591,https://www.intensivregister.de/api/public/reporting/laendertabelle
1630567150,25459,21232,4227,1171,599,https://www.intensivregister.de/api/public/reporting/laendertabelle
1630570748,25459,21242,4217,1168,597,https://www.intensivregister.de/api/public/reporting/laendertabelle
1630574357,25460,21240,4220,1168,597,https://www.intensivregister.de/api/public/reporting/laendertabelle
1630577963,25460,21239,4221,1167,597,https://www.intensivregister.de/api/public/reporting/laendertabelle
1630581553,25459,21238,4221,1167,596,https://www.intensivregister.de/api/public/reporting/laendertabelle
1630585151,25459,21240,4219,1167,596,https://www.intensivregister.de/api/public/reporting/laendertabelle
1630592356,25459,21242,4217,1167,596,https://www.intensivregister.de/api/public/reporting/laendertabelle
1630599550,25459,21240,4219,1169,596,https://www.intensivregister.de/api/public/reporting/laendertabelle
1630610352,25459,21239,4220,1169,596,https://www.intensivregister.de/api/public/reporting/laendertabelle
1630613949,25459,21238,4221,1169,596,https://www.intensivregister.de/api/public/reporting/laendertabelle
1630617555,25455,21239,4216,1167,595,https://www.intensivregister.de/api/public/reporting/laendertabelle
1630621151,25457,21243,4214,1167,595,https://www.intensivregister.de/api/public/reporting/laendertabelle
1630624755,25459,21249,4210,1168,595,https://www.intensivregister.de/api/public/reporting/laendertabelle
1630628347,25458,21261,4197,1171,595,https://www.intensivregister.de/api/public/reporting/laendertabelle
1630631949,25459,21268,4191,1172,594,https://www.intensivregister.de/api/public/reporting/laendertabelle
1630635552,25461,21266,4195,1178,596,https://www.intensivregister.de/api/public/reporting/laendertabelle
1630639154,25454,21269,4185,1184,584,https://www.intensivregister.de/api/public/reporting/laendertabelle
1630642756,25445,21320,4125,1202,598,https://www.intensivregister.de/api/public/reporting/laendertabelle
1630646349,25442,21332,4110,1209,604,https://www.intensivregister.de/api/public/reporting/laendertabelle
1630649951,25438,21308,4130,1211,605,https://www.intensivregister.de/api/public/reporting/laendertabelle
1630653554,25437,21292,4145,1216,605,https://www.intensivregister.de/api/public/reporting/laendertabelle
1630657147,25434,21285,4149,1215,604,https://www.intensivregister.de/api/public/reporting/laendertabelle
1630660749,25434,21274,4160,1216,605,https://www.intensivregister.de/api/public/reporting/laendertabelle
1630664352,25442,21282,4160,1217,606,https://www.intensivregister.de/api/public/reporting/laendertabelle
1630667954,25442,21281,4161,1217,606,https://www.intensivregister.de/api/public/reporting/laendertabelle
1630671547,25442,21283,4159,1218,606,https://www.intensivregister.de/api/public/reporting/laendertabelle
1630675149,25442,21282,4160,1219,606,https://www.intensivregister.de/api/public/reporting/laendertabelle
1630678751,25442,21281,4161,1219,607,https://www.intensivregister.de/api/public/reporting/laendertabelle
1630682354,25442,21277,4165,1220,607,https://www.intensivregister.de/api/public/reporting/laendertabelle
1630693151,25442,21276,4166,1220,607,https://www.intensivregister.de/api/public/reporting/laendertabelle
1630696753,25442,21275,4167,1220,607,https://www.intensivregister.de/api/public/reporting/laendertabelle
1630700356,25446,21272,4174,1218,606,https://www.intensivregister.de/api/public/reporting/laendertabelle
1630707550,25446,21268,4178,1217,608,https://www.intensivregister.de/api/public/reporting/laendertabelle
1630711152,25445,21267,4178,1219,609,https://www.intensivregister.de/api/public/reporting/laendertabelle
1630714754,25443,21272,4171,1219,609,https://www.intensivregister.de/api/public/reporting/laendertabelle
1630718348,25441,21265,4176,1220,608,https://www.intensivregister.de/api/public/reporting/laendertabelle
1630721950,25440,21255,4185,1219,609,https://www.intensivregister.de/api/public/reporting/laendertabelle
1630725553,25430,21222,4208,1225,608,https://www.intensivregister.de/api/public/reporting/laendertabelle
1630729155,25332,21220,4112,1238,615,https://www.intensivregister.de/api/public/reporting/laendertabelle
1630732747,25213,21075,4138,1250,618,https://www.intensivregister.de/api/public/reporting/laendertabelle
1630736350,25174,21000,4174,1255,621,https://www.intensivregister.de/api/public/reporting/laendertabelle
1630739952,25145,20956,4189,1257,625,https://www.intensivregister.de/api/public/reporting/laendertabelle
1630743554,25145,20963,4182,1258,625,https://www.intensivregister.de/api/public/reporting/laendertabelle
1630747146,25145,20954,4191,1255,625,https://www.intensivregister.de/api/public/reporting/laendertabelle
1630750749,25143,20948,4195,1255,624,https://www.intensivregister.de/api/public/reporting/laendertabelle
1630754351,25142,20952,4190,1253,623,https://www.intensivregister.de/api/public/reporting/laendertabelle
1630757953,25141,20954,4187,1253,624,https://www.intensivregister.de/api/public/reporting/laendertabelle
1630765147,25131,20954,4177,1254,624,https://www.intensivregister.de/api/public/reporting/laendertabelle
1630768749,25129,20949,4180,1254,624,https://www.intensivregister.de/api/public/reporting/laendertabelle
1630772351,25130,20953,4177,1253,624,https://www.intensivregister.de/api/public/reporting/laendertabelle
1630775953,25130,20955,4175,1254,624,https://www.intensivregister.de/api/public/reporting/laendertabelle
1630779555,25131,20956,4175,1254,624,https://www.intensivregister.de/api/public/reporting/laendertabelle
1630783147,25131,20955,4176,1254,624,https://www.intensivregister.de/api/public/reporting/laendertabelle
1630786749,25129,20946,4183,1254,624,https://www.intensivregister.de/api/public/reporting/laendertabelle
1630790351,25129,20950,4179,1254,624,https://www.intensivregister.de/api/public/reporting/laendertabelle
1630793953,25129,20946,4183,1254,624,https://www.intensivregister.de/api/public/reporting/laendertabelle
1630797555,25131,20946,4185,1254,624,https://www.intensivregister.de/api/public/reporting/laendertabelle
1630801148,25133,20946,4187,1256,625,https://www.intensivregister.de/api/public/reporting/laendertabelle
1630804749,25125,20940,4185,1255,625,https://www.intensivregister.de/api/public/reporting/laendertabelle
1630808351,25123,20918,4205,1254,628,https://www.intensivregister.de/api/public/reporting/laendertabelle
1630811953,25122,20907,4215,1252,624,https://www.intensivregister.de/api/public/reporting/laendertabelle
1630815555,25113,20838,4275,1258,628,https://www.intensivregister.de/api/public/reporting/laendertabelle
1630819148,25107,20791,4316,1273,628,https://www.intensivregister.de/api/public/reporting/laendertabelle
1630822750,25095,20746,4349,1273,631,https://www.intensivregister.de/api/public/reporting/laendertabelle
1630826352,25090,20714,4376,1281,632,https://www.intensivregister.de/api/public/reporting/laendertabelle
1630829955,25090,20697,4393,1280,631,https://www.intensivregister.de/api/public/reporting/laendertabelle
1630833557,25091,20692,4399,1283,632,https://www.intensivregister.de/api/public/reporting/laendertabelle
1630837149,25092,20689,4403,1282,632,https://www.intensivregister.de/api/public/reporting/laendertabelle
1630844353,25093,20691,4402,1282,632,https://www.intensivregister.de/api/public/reporting/laendertabelle
1630851547,25093,20689,4404,1283,632,https://www.intensivregister.de/api/public/reporting/laendertabelle
1630855148,25093,20685,4408,1283,633,https://www.intensivregister.de/api/public/reporting/laendertabelle
1630858750,25093,20688,4405,1283,633,https://www.intensivregister.de/api/public/reporting/laendertabelle
1630862351,25093,20683,4410,1283,633,https://www.intensivregister.de/api/public/reporting/laendertabelle
1630873148,25093,20686,4407,1283,633,https://www.intensivregister.de/api/public/reporting/laendertabelle
1630876750,25092,20683,4409,1282,633,https://www.intensivregister.de/api/public/reporting/laendertabelle
1630880353,25091,20679,4412,1282,633,https://www.intensivregister.de/api/public/reporting/laendertabelle
1630883955,25090,20679,4411,1282,633,https://www.intensivregister.de/api/public/reporting/laendertabelle
1630887547,25090,20676,4414,1282,632,https://www.intensivregister.de/api/public/reporting/laendertabelle
1630891150,25102,20692,4410,1283,632,https://www.intensivregister.de/api/public/reporting/laendertabelle
1630894751,25118,20685,4433,1284,634,https://www.intensivregister.de/api/public/reporting/laendertabelle
1630898353,25177,20787,4390,1288,644,https://www.intensivregister.de/api/public/reporting/laendertabelle
1630901956,25228,20811,4417,1296,644,https://www.intensivregister.de/api/public/reporting/laendertabelle
1630905549,25300,20871,4429,1310,654,https://www.intensivregister.de/api/public/reporting/laendertabelle
1630909152,25338,20895,4443,1307,655,https://www.intensivregister.de/api/public/reporting/laendertabelle
1630912755,25344,20910,4434,1323,666,https://www.intensivregister.de/api/public/reporting/laendertabelle
1630916347,25348,20903,4445,1323,668,https://www.intensivregister.de/api/public/reporting/laendertabelle
1630919950,25346,20902,4444,1320,670,https://www.intensivregister.de/api/public/reporting/laendertabelle
1630923553,25349,20907,4442,1321,670,https://www.intensivregister.de/api/public/reporting/laendertabelle
1630927156,25349,20902,4447,1319,671,https://www.intensivregister.de/api/public/reporting/laendertabelle
1630930748,25349,20901,4448,1319,670,https://www.intensivregister.de/api/public/reporting/laendertabelle
1630937953,25349,20906,4443,1319,670,https://www.intensivregister.de/api/public/reporting/laendertabelle
1630941556,25349,20909,4440,1319,670,https://www.intensivregister.de/api/public/reporting/laendertabelle
1630952354,25349,20910,4439,1319,670,https://www.intensivregister.de/api/public/reporting/laendertabelle
1630959548,25349,20908,4441,1319,670,https://www.intensivregister.de/api/public/reporting/laendertabelle
1630963150,25347,20919,4428,1318,670,https://www.intensivregister.de/api/public/reporting/laendertabelle
1630966753,25347,20912,4435,1318,668,https://www.intensivregister.de/api/public/reporting/laendertabelle
1630970355,25347,20911,4436,1319,669,https://www.intensivregister.de/api/public/reporting/laendertabelle
1630973947,25351,20912,4439,1322,670,https://www.intensivregister.de/api/public/reporting/laendertabelle
1630977549,25352,20927,4425,1323,670,https://www.intensivregister.de/api/public/reporting/laendertabelle
1630981152,25359,20971,4388,1324,671,https://www.intensivregister.de/api/public/reporting/laendertabelle
1630984754,25365,21042,4323,1322,676,https://www.intensivregister.de/api/public/reporting/laendertabelle
1630988347,25391,21179,4212,1333,691,https://www.intensivregister.de/api/public/reporting/laendertabelle
1630991949,25387,21243,4144,1339,692,https://www.intensivregister.de/api/public/reporting/laendertabelle
1630995552,25401,21290,4111,1340,694,https://www.intensivregister.de/api/public/reporting/laendertabelle
1630999155,25414,21321,4093,1346,698,https://www.intensivregister.de/api/public/reporting/laendertabelle
1631002748,25420,21331,4089,1350,700,https://www.intensivregister.de/api/public/reporting/laendertabelle
1631006351,25420,21339,4081,1350,700,https://www.intensivregister.de/api/public/reporting/laendertabelle
1631009954,25417,21338,4079,1350,702,https://www.intensivregister.de/api/public/reporting/laendertabelle
1631013556,25417,21341,4076,1350,702,https://www.intensivregister.de/api/public/reporting/laendertabelle
1631017149,25417,21342,4075,1349,703,https://www.intensivregister.de/api/public/reporting/laendertabelle
1631020752,25417,21344,4073,1350,703,https://www.intensivregister.de/api/public/reporting/laendertabelle
1631024354,25417,21342,4075,1353,703,https://www.intensivregister.de/api/public/reporting/laendertabelle
1631027947,25417,21343,4074,1353,704,https://www.intensivregister.de/api/public/reporting/laendertabelle
1631031550,25420,21344,4076,1353,704,https://www.intensivregister.de/api/public/reporting/laendertabelle
1631042347,25420,21344,4076,1354,704,https://www.intensivregister.de/api/public/reporting/laendertabelle
1631045950,25420,21345,4075,1354,703,https://www.intensivregister.de/api/public/reporting/laendertabelle
1631049551,25420,21348,4072,1354,703,https://www.intensivregister.de/api/public/reporting/laendertabelle
1631056747,25420,21351,4069,1353,703,https://www.intensivregister.de/api/public/reporting/laendertabelle
1631060349,25420,21347,4073,1352,703,https://www.intensivregister.de/api/public/reporting/laendertabelle
1631063951,25423,21353,4070,1350,703,https://www.intensivregister.de/api/public/reporting/laendertabelle
1631067555,25432,21366,4066,1354,702,https://www.intensivregister.de/api/public/reporting/laendertabelle
1631071147,25454,21415,4039,1366,709,https://www.intensivregister.de/api/public/reporting/laendertabelle
1631074750,25440,21400,4040,1373,716,https://www.intensivregister.de/api/public/reporting/laendertabelle
1631078353,25446,21461,3985,1372,712,https://www.intensivregister.de/api/public/reporting/laendertabelle
1631081957,25447,21496,3951,1384,718,https://www.intensivregister.de/api/public/reporting/laendertabelle
1631085549,25448,21496,3952,1388,723,https://www.intensivregister.de/api/public/reporting/laendertabelle
1631089153,25435,21497,3938,1388,723,https://www.intensivregister.de/api/public/reporting/laendertabelle
1631092755,25435,21505,3930,1388,722,https://www.intensivregister.de/api/public/reporting/laendertabelle
1631096348,25438,21512,3926,1387,722,https://www.intensivregister.de/api/public/reporting/laendertabelle
1631099950,25438,21514,3924,1387,724,https://www.intensivregister.de/api/public/reporting/laendertabelle
1631103553,25439,21519,3920,1387,724,https://www.intensivregister.de/api/public/reporting/laendertabelle
1631107156,25439,21517,3922,1387,724,https://www.intensivregister.de/api/public/reporting/laendertabelle
1631110749,25439,21515,3924,1387,724,https://www.intensivregister.de/api/public/reporting/laendertabelle
1631114351,25439,21518,3921,1388,724,https://www.intensivregister.de/api/public/reporting/laendertabelle
1631121548,25439,21516,3923,1388,724,https://www.intensivregister.de/api/public/reporting/laendertabelle
1631132355,25439,21506,3933,1388,724,https://www.intensivregister.de/api/public/reporting/laendertabelle
1631135948,25434,21507,3927,1387,724,https://www.intensivregister.de/api/public/reporting/laendertabelle
1631139550,25434,21506,3928,1386,724,https://www.intensivregister.de/api/public/reporting/laendertabelle
1631143152,25436,21507,3929,1385,724,https://www.intensivregister.de/api/public/reporting/laendertabelle
1631146754,25436,21506,3930,1385,724,https://www.intensivregister.de/api/public/reporting/laendertabelle
1631150347,25436,21502,3934,1384,725,https://www.intensivregister.de/api/public/reporting/laendertabelle
1631153947,25426,21488,3938,1388,727,https://www.intensivregister.de/api/public/reporting/laendertabelle
1631157549,25407,21502,3905,1377,727,https://www.intensivregister.de/api/public/reporting/laendertabelle
1631161151,25424,21512,3912,1378,731,https://www.intensivregister.de/api/public/reporting/laendertabelle
1631164753,25418,21512,3906,1381,722,https://www.intensivregister.de/api/public/reporting/laendertabelle
1631168355,25447,21529,3918,1393,731,https://www.intensivregister.de/api/public/reporting/laendertabelle
1631171947,25430,21510,3920,1395,733,https://www.intensivregister.de/api/public/reporting/laendertabelle
1631175549,25430,21501,3929,1396,733,https://www.intensivregister.de/api/public/reporting/laendertabelle
1631179151,25431,21496,3935,1398,733,https://www.intensivregister.de/api/public/reporting/laendertabelle
1631182753,25431,21488,3943,1399,733,https://www.intensivregister.de/api/public/reporting/laendertabelle
1631186354,25431,21492,3939,1399,733,https://www.intensivregister.de/api/public/reporting/laendertabelle
1631189955,25429,21490,3939,1398,732,https://www.intensivregister.de/api/public/reporting/laendertabelle
1631193547,25429,21492,3937,1398,732,https://www.intensivregister.de/api/public/reporting/laendertabelle
1631200750,25428,21491,3937,1398,733,https://www.intensivregister.de/api/public/reporting/laendertabelle
1631215148,25428,21490,3938,1398,733,https://www.intensivregister.de/api/public/reporting/laendertabelle
1631218749,25424,21494,3930,1398,733,https://www.intensivregister.de/api/public/reporting/laendertabelle
1631222349,25424,21489,3935,1398,733,https://www.intensivregister.de/api/public/reporting/laendertabelle
1631225948,25425,21490,3935,1399,734,https://www.intensivregister.de/api/public/reporting/laendertabelle
1631229549,25425,21487,3938,1399,734,https://www.intensivregister.de/api/public/reporting/laendertabelle
1631233148,25427,21481,3946,1398,734,https://www.intensivregister.de/api/public/reporting/laendertabelle
1631236749,25424,21485,3939,1399,734,https://www.intensivregister.de/api/public/reporting/laendertabelle
1631240350,25415,21488,3927,1412,739,https://www.intensivregister.de/api/public/reporting/laendertabelle
1631243950,25401,21445,3956,1413,747,https://www.intensivregister.de/api/public/reporting/laendertabelle
1631247553,25390,21498,3892,1416,745,https://www.intensivregister.de/api/public/reporting/laendertabelle
1631251155,25385,21501,3884,1408,742,https://www.intensivregister.de/api/public/reporting/laendertabelle
1631254748,25398,21515,3883,1407,745,https://www.intensivregister.de/api/public/reporting/laendertabelle
1631258351,25395,21531,3864,1413,743,https://www.intensivregister.de/api/public/reporting/laendertabelle
1631261954,25402,21529,3873,1413,742,https://www.intensivregister.de/api/public/reporting/laendertabelle
1631265556,25399,21527,3872,1411,742,https://www.intensivregister.de/api/public/reporting/laendertabelle
1631269148,25401,21523,3878,1413,744,https://www.intensivregister.de/api/public/reporting/laendertabelle
1631272751,25399,21520,3879,1413,744,https://www.intensivregister.de/api/public/reporting/laendertabelle
1631279957,25399,21522,3877,1413,744,https://www.intensivregister.de/api/public/reporting/laendertabelle
1631287151,25399,21521,3878,1414,744,https://www.intensivregister.de/api/public/reporting/laendertabelle
1631297947,25397,21522,3875,1415,747,https://www.intensivregister.de/api/public/reporting/laendertabelle
1631305148,25395,21517,3878,1416,747,https://www.intensivregister.de/api/public/reporting/laendertabelle
1631308749,25395,21516,3879,1416,747,https://www.intensivregister.de/api/public/reporting/laendertabelle
1631312350,25395,21514,3881,1416,747,https://www.intensivregister.de/api/public/reporting/laendertabelle
1631315951,25395,21516,3879,1419,748,https://www.intensivregister.de/api/public/reporting/laendertabelle
1631319552,25396,21522,3874,1419,748,https://www.intensivregister.de/api/public/reporting/laendertabelle
1631323154,25395,21515,3880,1418,748,https://www.intensivregister.de/api/public/reporting/laendertabelle
1631326757,25384,21505,3879,1420,748,https://www.intensivregister.de/api/public/reporting/laendertabelle
1631330348,25358,21481,3877,1425,756,https://www.intensivregister.de/api/public/reporting/laendertabelle
1631333951,25327,21422,3905,1429,757,https://www.intensivregister.de/api/public/reporting/laendertabelle
1631337553,25288,21336,3952,1427,762,https://www.intensivregister.de/api/public/reporting/laendertabelle
1631341156,25241,21284,3957,1433,763,https://www.intensivregister.de/api/public/reporting/laendertabelle
1631344749,25210,21210,4000,1438,764,https://www.intensivregister.de/api/public/reporting/laendertabelle
1631348351,25205,21197,4008,1437,764,https://www.intensivregister.de/api/public/reporting/laendertabelle
1631351953,25200,21186,4014,1435,762,https://www.intensivregister.de/api/public/reporting/laendertabelle
1631355556,25204,21187,4017,1436,762,https://www.intensivregister.de/api/public/reporting/laendertabelle
1631359148,25204,21185,4019,1435,762,https://www.intensivregister.de/api/public/reporting/laendertabelle
1631362751,25201,21177,4024,1435,762,https://www.intensivregister.de/api/public/reporting/laendertabelle
1631366353,25201,21177,4024,1433,762,https://www.intensivregister.de/api/public/reporting/laendertabelle
1631369956,25201,21178,4023,1433,762,https://www.intensivregister.de/api/public/reporting/laendertabelle
1631373548,25201,21178,4023,1434,762,https://www.intensivregister.de/api/public/reporting/laendertabelle
1631377150,25203,21176,4027,1434,762,https://www.intensivregister.de/api/public/reporting/laendertabelle
1631380753,25201,21175,4026,1434,762,https://www.intensivregister.de/api/public/reporting/laendertabelle
1631387947,25201,21180,4021,1434,762,https://www.intensivregister.de/api/public/reporting/laendertabelle
1631395152,25201,21171,4030,1434,762,https://www.intensivregister.de/api/public/reporting/laendertabelle
1631402356,25201,21171,4030,1433,762,https://www.intensivregister.de/api/public/reporting/laendertabelle
1631405947,25201,21176,4025,1434,764,https://www.intensivregister.de/api/public/reporting/laendertabelle
1631409550,25201,21169,4032,1434,764,https://www.intensivregister.de/api/public/reporting/laendertabelle
1631413151,25185,21150,4035,1432,761,https://www.intensivregister.de/api/public/reporting/laendertabelle
1631416753,25183,21125,4058,1436,763,https://www.intensivregister.de/api/public/reporting/laendertabelle
1631420355,25165,21064,4101,1446,762,https://www.intensivregister.de/api/public/reporting/laendertabelle
1631423947,25140,20933,4207,1448,764,https://www.intensivregister.de/api/public/reporting/laendertabelle
1631427549,25124,20910,4214,1456,765,https://www.intensivregister.de/api/public/reporting/laendertabelle
1631431151,25090,20838,4252,1450,757,https://www.intensivregister.de/api/public/reporting/laendertabelle
1631434754,25091,20845,4246,1452,756,https://www.intensivregister.de/api/public/reporting/laendertabelle
1631438357,25089,20840,4249,1454,757,https://www.intensivregister.de/api/public/reporting/laendertabelle
1631449154,25089,20847,4242,1454,756,https://www.intensivregister.de/api/public/reporting/laendertabelle
1631452746,25089,20847,4242,1456,754,https://www.intensivregister.de/api/public/reporting/laendertabelle
1631459951,25089,20851,4238,1457,754,https://www.intensivregister.de/api/public/reporting/laendertabelle
1631463554,25089,20854,4235,1456,753,https://www.intensivregister.de/api/public/reporting/laendertabelle
1631467156,25089,20853,4236,1456,753,https://www.intensivregister.de/api/public/reporting/laendertabelle
1631474350,25088,20856,4232,1456,753,https://www.intensivregister.de/api/public/reporting/laendertabelle
1631477952,25086,20846,4240,1457,754,https://www.intensivregister.de/api/public/reporting/laendertabelle
1631481554,25088,20848,4240,1457,754,https://www.intensivregister.de/api/public/reporting/laendertabelle
1631485147,25088,20849,4239,1458,755,https://www.intensivregister.de/api/public/reporting/laendertabelle
1631488749,25088,20851,4237,1458,755,https://www.intensivregister.de/api/public/reporting/laendertabelle
1631492351,25088,20852,4236,1458,756,https://www.intensivregister.de/api/public/reporting/laendertabelle
1631495950,25087,20849,4238,1457,755,https://www.intensivregister.de/api/public/reporting/laendertabelle
1631499555,25113,20866,4247,1457,753,https://www.intensivregister.de/api/public/reporting/laendertabelle
1631503150,25155,20896,4259,1463,767,https://www.intensivregister.de/api/public/reporting/laendertabelle
1631506755,25211,20870,4341,1476,779,https://www.intensivregister.de/api/public/reporting/laendertabelle
1631510350,25284,20930,4354,1488,782,https://www.intensivregister.de/api/public/reporting/laendertabelle
1631513956,25340,20968,4372,1494,787,https://www.intensivregister.de/api/public/reporting/laendertabelle
1631517551,25362,20985,4377,1501,788,https://www.intensivregister.de/api/public/reporting/laendertabelle
1631521157,25365,21015,4350,1507,790,https://www.intensivregister.de/api/public/reporting/laendertabelle
1631524752,25365,21022,4343,1510,790,https://www.intensivregister.de/api/public/reporting/laendertabelle
1631528348,25367,21024,4343,1511,790,https://www.intensivregister.de/api/public/reporting/laendertabelle
1631531953,25367,21020,4347,1511,790,https://www.intensivregister.de/api/public/reporting/laendertabelle
1631535548,25367,21021,4346,1511,791,https://www.intensivregister.de/api/public/reporting/laendertabelle
1631542750,25367,21027,4340,1511,791,https://www.intensivregister.de/api/public/reporting/laendertabelle
1631546347,25370,21030,4340,1511,791,https://www.intensivregister.de/api/public/reporting/laendertabelle
1631549952,25370,21032,4338,1511,791,https://www.intensivregister.de/api/public/reporting/laendertabelle
1631553548,25372,21035,4337,1512,792,https://www.intensivregister.de/api/public/reporting/laendertabelle
1631560750,25372,21037,4335,1512,792,https://www.intensivregister.de/api/public/reporting/laendertabelle
1631564355,25371,21041,4330,1512,792,https://www.intensivregister.de/api/public/reporting/laendertabelle
1631567951,25369,21040,4329,1512,791,https://www.intensivregister.de/api/public/reporting/laendertabelle
1631571547,25372,21048,4324,1512,790,https://www.intensivregister.de/api/public/reporting/laendertabelle
1631575156,25373,21051,4322,1512,790,https://www.intensivregister.de/api/public/reporting/laendertabelle
1631578752,25372,21051,4321,1513,788,https://www.intensivregister.de/api/public/reporting/laendertabelle
1631582348,25364,21058,4306,1510,789,https://www.intensivregister.de/api/public/reporting/laendertabelle
1631585954,25385,21130,4255,1513,789,https://www.intensivregister.de/api/public/reporting/laendertabelle
1631589550,25421,21240,4181,1522,789,https://www.intensivregister.de/api/public/reporting/laendertabelle
1631593156,25440,21333,4107,1529,787,https://www.intensivregister.de/api/public/reporting/laendertabelle
1631596753,25469,21431,4038,1530,785,https://www.intensivregister.de/api/public/reporting/laendertabelle
1631600349,25484,21531,3953,1540,793,https://www.intensivregister.de/api/public/reporting/laendertabelle
1631603955,25479,21529,3950,1537,783,https://www.intensivregister.de/api/public/reporting/laendertabelle
1631607552,25480,21532,3948,1535,785,https://www.intensivregister.de/api/public/reporting/laendertabelle
1631611148,25480,21538,3942,1538,785,https://www.intensivregister.de/api/public/reporting/laendertabelle
1631614755,25480,21542,3938,1537,786,https://www.intensivregister.de/api/public/reporting/laendertabelle
1631618351,25479,21540,3939,1537,786,https://www.intensivregister.de/api/public/reporting/laendertabelle
1631621947,25479,21539,3940,1538,786,https://www.intensivregister.de/api/public/reporting/laendertabelle
1631625554,25479,21535,3944,1537,786,https://www.intensivregister.de/api/public/reporting/laendertabelle
1631629150,25479,21530,3949,1535,786,https://www.intensivregister.de/api/public/reporting/laendertabelle
1631632747,25479,21536,3943,1535,786,https://www.intensivregister.de/api/public/reporting/laendertabelle
1631636354,25468,21530,3938,1535,786,https://www.intensivregister.de/api/public/reporting/laendertabelle
1631639950,25468,21533,3935,1535,786,https://www.intensivregister.de/api/public/reporting/laendertabelle
1631650750,25470,21535,3935,1536,786,https://www.intensivregister.de/api/public/reporting/laendertabelle
1631654356,25468,21536,3932,1537,787,https://www.intensivregister.de/api/public/reporting/laendertabelle
1631657952,25468,21535,3933,1537,787,https://www.intensivregister.de/api/public/reporting/laendertabelle
1631665154,25475,21543,3932,1537,788,https://www.intensivregister.de/api/public/reporting/laendertabelle
1631668751,25474,21552,3922,1538,788,https://www.intensivregister.de/api/public/reporting/laendertabelle
1631672348,25476,21538,3938,1534,787,https://www.intensivregister.de/api/public/reporting/laendertabelle
1631675953,25467,21562,3905,1524,794,https://www.intensivregister.de/api/public/reporting/laendertabelle
1631679550,25454,21549,3905,1528,799,https://www.intensivregister.de/api/public/reporting/laendertabelle
1631683156,25437,21570,3867,1522,799,https://www.intensivregister.de/api/public/reporting/laendertabelle
1631686752,25450,21597,3853,1528,806,https://www.intensivregister.de/api/public/reporting/laendertabelle
1631690350,25450,21592,3858,1527,811,https://www.intensivregister.de/api/public/reporting/laendertabelle
1631693956,25450,21600,3850,1528,813,https://www.intensivregister.de/api/public/reporting/laendertabelle
1631697552,25449,21599,3850,1527,813,https://www.intensivregister.de/api/public/reporting/laendertabelle
1631701148,25450,21605,3845,1528,814,https://www.intensivregister.de/api/public/reporting/laendertabelle
1631704754,25450,21612,3838,1528,814,https://www.intensivregister.de/api/public/reporting/laendertabelle
1631708351,25450,21613,3837,1529,815,https://www.intensivregister.de/api/public/reporting/laendertabelle
1631711948,25450,21616,3834,1529,815,https://www.intensivregister.de/api/public/reporting/laendertabelle
1631722751,25448,21614,3834,1531,815,https://www.intensivregister.de/api/public/reporting/laendertabelle
1631737150,25448,21621,3827,1530,815,https://www.intensivregister.de/api/public/reporting/laendertabelle
1631740748,25447,21625,3822,1530,816,https://www.intensivregister.de/api/public/reporting/laendertabelle
1631744355,25447,21625,3822,1531,816,https://www.intensivregister.de/api/public/reporting/laendertabelle
1631747952,25452,21627,3825,1533,817,https://www.intensivregister.de/api/public/reporting/laendertabelle
1631751549,25452,21626,3826,1534,817,https://www.intensivregister.de/api/public/reporting/laendertabelle
1631755152,25450,21620,3830,1538,816,https://www.intensivregister.de/api/public/reporting/laendertabelle
1631758753,25440,21617,3823,1537,812,https://www.intensivregister.de/api/public/reporting/laendertabelle
1631762354,25446,21670,3776,1551,823,https://www.intensivregister.de/api/public/reporting/laendertabelle
1631765957,25418,21638,3780,1545,837,https://www.intensivregister.de/api/public/reporting/laendertabelle
1631769547,25420,21644,3776,1555,843,https://www.intensivregister.de/api/public/reporting/laendertabelle
1631773148,25392,21638,3754,1554,836,https://www.intensivregister.de/api/public/reporting/laendertabelle
1631776749,25384,21623,3761,1551,839,https://www.intensivregister.de/api/public/reporting/laendertabelle
1631780351,25386,21622,3764,1551,839,https://www.intensivregister.de/api/public/reporting/laendertabelle
1631783952,25386,21620,3766,1550,839,https://www.intensivregister.de/api/public/reporting/laendertabelle
1631787554,25386,21616,3770,1551,840,https://www.intensivregister.de/api/public/reporting/laendertabelle
1631791156,25386,21607,3779,1551,839,https://www.intensivregister.de/api/public/reporting/laendertabelle
1631798349,25386,21609,3777,1552,839,https://www.intensivregister.de/api/public/reporting/laendertabelle
1631805552,25386,21610,3776,1552,839,https://www.intensivregister.de/api/public/reporting/laendertabelle
1631809154,25386,21609,3777,1551,838,https://www.intensivregister.de/api/public/reporting/laendertabelle
1631819950,25394,21616,3778,1551,838,https://www.intensivregister.de/api/public/reporting/laendertabelle
1631823551,25396,21615,3781,1552,838,https://www.intensivregister.de/api/public/reporting/laendertabelle
1631827153,25394,21613,3781,1551,837,https://www.intensivregister.de/api/public/reporting/laendertabelle
1631830754,25393,21605,3788,1551,837,https://www.intensivregister.de/api/public/reporting/laendertabelle
1631834356,25393,21604,3789,1551,838,https://www.intensivregister.de/api/public/reporting/laendertabelle
1631837947,25395,21603,3792,1551,838,https://www.intensivregister.de/api/public/reporting/laendertabelle
1631841548,25394,21606,3788,1552,839,https://www.intensivregister.de/api/public/reporting/laendertabelle
1631845149,25384,21567,3817,1548,840,https://www.intensivregister.de/api/public/reporting/laendertabelle
1631848749,25359,21518,3841,1551,838,https://www.intensivregister.de/api/public/reporting/laendertabelle
1631852351,25314,21504,3810,1550,833,https://www.intensivregister.de/api/public/reporting/laendertabelle
1631855952,25287,21446,3841,1555,842,https://www.intensivregister.de/api/public/reporting/laendertabelle
1631859553,25263,21425,3838,1549,839,https://www.intensivregister.de/api/public/reporting/laendertabelle
1631863155,25275,21411,3864,1546,834,https://www.intensivregister.de/api/public/reporting/laendertabelle
1631866747,25278,21419,3859,1543,832,https://www.intensivregister.de/api/public/reporting/laendertabelle
1631870349,25278,21414,3864,1544,832,https://www.intensivregister.de/api/public/reporting/laendertabelle
1631873949,25273,21407,3866,1545,833,https://www.intensivregister.de/api/public/reporting/laendertabelle
1631877551,25278,21410,3868,1547,833,https://www.intensivregister.de/api/public/reporting/laendertabelle
1631884753,25274,21405,3869,1546,833,https://www.intensivregister.de/api/public/reporting/laendertabelle
1631888354,25274,21404,3870,1546,833,https://www.intensivregister.de/api/public/reporting/laendertabelle
1631895548,25274,21406,3868,1546,833,https://www.intensivregister.de/api/public/reporting/laendertabelle
1631909952,25275,21405,3870,1545,833,https://www.intensivregister.de/api/public/reporting/laendertabelle
1631913552,25274,21403,3871,1544,834,https://www.intensivregister.de/api/public/reporting/laendertabelle
1631917154,25274,21411,3863,1544,834,https://www.intensivregister.de/api/public/reporting/laendertabelle
1631920756,25272,21408,3864,1544,834,https://www.intensivregister.de/api/public/reporting/laendertabelle
1631924357,25272,21403,3869,1544,834,https://www.intensivregister.de/api/public/reporting/laendertabelle
1631927949,25268,21402,3866,1543,833,https://www.intensivregister.de/api/public/reporting/laendertabelle
1631931548,25257,21388,3869,1542,832,https://www.intensivregister.de/api/public/reporting/laendertabelle
1631935149,25232,21312,3920,1539,835,https://www.intensivregister.de/api/public/reporting/laendertabelle
1631938749,25204,21197,4007,1532,839,https://www.intensivregister.de/api/public/reporting/laendertabelle
1631942351,25125,21107,4018,1529,844,https://www.intensivregister.de/api/public/reporting/laendertabelle
1631945951,25084,21000,4084,1523,838,https://www.intensivregister.de/api/public/reporting/laendertabelle
1631949552,25070,20968,4102,1518,829,https://www.intensivregister.de/api/public/reporting/laendertabelle
1631953153,25067,20973,4094,1523,830,https://www.intensivregister.de/api/public/reporting/laendertabelle
1631956753,25066,20979,4087,1522,830,https://www.intensivregister.de/api/public/reporting/laendertabelle
1631960354,25056,20968,4088,1522,830,https://www.intensivregister.de/api/public/reporting/laendertabelle
1631963955,25058,20973,4085,1522,829,https://www.intensivregister.de/api/public/reporting/laendertabelle
1631967555,25050,20965,4085,1523,830,https://www.intensivregister.de/api/public/reporting/laendertabelle
1631971156,25050,20966,4084,1521,829,https://www.intensivregister.de/api/public/reporting/laendertabelle
1631974747,25050,20965,4085,1522,829,https://www.intensivregister.de/api/public/reporting/laendertabelle
1631978348,25050,20957,4093,1521,828,https://www.intensivregister.de/api/public/reporting/laendertabelle
1631981949,25050,20956,4094,1522,829,https://www.intensivregister.de/api/public/reporting/laendertabelle
1631985549,25051,20956,4095,1523,829,https://www.intensivregister.de/api/public/reporting/laendertabelle
1631996351,25051,20939,4112,1521,829,https://www.intensivregister.de/api/public/reporting/laendertabelle
1631999951,25052,20934,4118,1522,829,https://www.intensivregister.de/api/public/reporting/laendertabelle
1632003551,25052,20936,4116,1522,827,https://www.intensivregister.de/api/public/reporting/laendertabelle
1632007152,25053,20941,4112,1522,827,https://www.intensivregister.de/api/public/reporting/laendertabelle
1632010754,25053,20946,4107,1522,827,https://www.intensivregister.de/api/public/reporting/laendertabelle
1632014355,25054,20944,4110,1520,827,https://www.intensivregister.de/api/public/reporting/laendertabelle
1632017956,25045,20937,4108,1520,825,https://www.intensivregister.de/api/public/reporting/laendertabelle
1632021548,25030,20892,4138,1521,822,https://www.intensivregister.de/api/public/reporting/laendertabelle
1632025148,25023,20820,4203,1522,827,https://www.intensivregister.de/api/public/reporting/laendertabelle
1632028751,25000,20768,4232,1531,827,https://www.intensivregister.de/api/public/reporting/laendertabelle
1632032352,24979,20700,4279,1540,824,https://www.intensivregister.de/api/public/reporting/laendertabelle
1632035952,24966,20628,4338,1537,828,https://www.intensivregister.de/api/public/reporting/laendertabelle
1632039554,24959,20625,4334,1539,833,https://www.intensivregister.de/api/public/reporting/laendertabelle
1632043155,24957,20629,4328,1540,833,https://www.intensivregister.de/api/public/reporting/laendertabelle
1632046747,24957,20622,4335,1540,833,https://www.intensivregister.de/api/public/reporting/laendertabelle
1632050349,24961,20623,4338,1540,833,https://www.intensivregister.de/api/public/reporting/laendertabelle
1632053952,24960,20622,4338,1540,832,https://www.intensivregister.de/api/public/reporting/laendertabelle
1632057551,24960,20620,4340,1540,832,https://www.intensivregister.de/api/public/reporting/laendertabelle
1632061153,24960,20617,4343,1539,831,https://www.intensivregister.de/api/public/reporting/laendertabelle
1632075548,24960,20616,4344,1537,828,https://www.intensivregister.de/api/public/reporting/laendertabelle
1632079149,24960,20617,4343,1537,828,https://www.intensivregister.de/api/public/reporting/laendertabelle
1632082751,24959,20618,4341,1537,828,https://www.intensivregister.de/api/public/reporting/laendertabelle
1632086352,24959,20623,4336,1538,828,https://www.intensivregister.de/api/public/reporting/laendertabelle
1632089954,24958,20623,4335,1538,828,https://www.intensivregister.de/api/public/reporting/laendertabelle
1632093556,24958,20626,4332,1540,828,https://www.intensivregister.de/api/public/reporting/laendertabelle
1632097156,24960,20621,4339,1540,828,https://www.intensivregister.de/api/public/reporting/laendertabelle
1632100748,24963,20620,4343,1538,825,https://www.intensivregister.de/api/public/reporting/laendertabelle
1632104350,24981,20619,4362,1538,826,https://www.intensivregister.de/api/public/reporting/laendertabelle
1632107952,25046,20654,4392,1533,831,https://www.intensivregister.de/api/public/reporting/laendertabelle
1632111554,25133,20695,4438,1529,830,https://www.intensivregister.de/api/public/reporting/laendertabelle
1632115156,25124,20715,4409,1535,835,https://www.intensivregister.de/api/public/reporting/laendertabelle
1632118748,25160,20740,4420,1531,829,https://www.intensivregister.de/api/public/reporting/laendertabelle
1632122350,25161,20734,4427,1541,831,https://www.intensivregister.de/api/public/reporting/laendertabelle
1632125954,25186,20765,4421,1539,832,https://www.intensivregister.de/api/public/reporting/laendertabelle
1632129555,25187,20766,4421,1536,832,https://www.intensivregister.de/api/public/reporting/laendertabelle
1632133148,25187,20770,4417,1535,835,https://www.intensivregister.de/api/public/reporting/laendertabelle
1632136750,25195,20772,4423,1536,835,https://www.intensivregister.de/api/public/reporting/laendertabelle
1632140353,25194,20771,4423,1536,835,https://www.intensivregister.de/api/public/reporting/laendertabelle
1632143955,25194,20769,4425,1536,834,https://www.intensivregister.de/api/public/reporting/laendertabelle
1632161956,25199,20777,4422,1536,834,https://www.intensivregister.de/api/public/reporting/laendertabelle
1632169152,25202,20779,4423,1536,834,https://www.intensivregister.de/api/public/reporting/laendertabelle
1632172754,25202,20781,4421,1534,834,https://www.intensivregister.de/api/public/reporting/laendertabelle
1632176355,25200,20782,4418,1534,834,https://www.intensivregister.de/api/public/reporting/laendertabelle
1632179948,25200,20775,4425,1532,834,https://www.intensivregister.de/api/public/reporting/laendertabelle
1632183550,25203,20782,4421,1531,833,https://www.intensivregister.de/api/public/reporting/laendertabelle
1632187155,25208,20803,4405,1532,835,https://www.intensivregister.de/api/public/reporting/laendertabelle
1632190755,25221,20839,4382,1521,837,https://www.intensivregister.de/api/public/reporting/laendertabelle
1632194347,25247,20969,4278,1516,836,https://www.intensivregister.de/api/public/reporting/laendertabelle
1632197947,25255,21058,4197,1508,835,https://www.intensivregister.de/api/public/reporting/laendertabelle
1632201549,25284,21142,4142,1505,823,https://www.intensivregister.de/api/public/reporting/laendertabelle
1632205150,25283,21183,4100,1508,824,https://www.intensivregister.de/api/public/reporting/laendertabelle
1632208751,25298,21202,4096,1504,824,https://www.intensivregister.de/api/public/reporting/laendertabelle
1632212353,25297,21203,4094,1506,824,https://www.intensivregister.de/api/public/reporting/laendertabelle
1632215953,25291,21211,4080,1508,827,https://www.intensivregister.de/api/public/reporting/laendertabelle
1632219554,25289,21215,4074,1507,826,https://www.intensivregister.de/api/public/reporting/laendertabelle
1632223156,25289,21216,4073,1507,826,https://www.intensivregister.de/api/public/reporting/laendertabelle
1632226756,25290,21219,4071,1507,825,https://www.intensivregister.de/api/public/reporting/laendertabelle
1632230347,25290,21218,4072,1506,825,https://www.intensivregister.de/api/public/reporting/laendertabelle
1632233948,25290,21217,4073,1506,825,https://www.intensivregister.de/api/public/reporting/laendertabelle
1632237549,25290,21220,4070,1506,825,https://www.intensivregister.de/api/public/reporting/laendertabelle
1632241150,25290,21222,4068,1506,825,https://www.intensivregister.de/api/public/reporting/laendertabelle
1632244750,25290,21223,4067,1506,825,https://www.intensivregister.de/api/public/reporting/laendertabelle
1632251952,25290,21224,4066,1506,825,https://www.intensivregister.de/api/public/reporting/laendertabelle
1632255553,25291,21224,4067,1506,825,https://www.intensivregister.de/api/public/reporting/laendertabelle
1632259154,25292,21224,4068,1506,825,https://www.intensivregister.de/api/public/reporting/laendertabelle
1632262754,25302,21231,4071,1506,825,https://www.intensivregister.de/api/public/reporting/laendertabelle
1632266355,25302,21232,4070,1506,825,https://www.intensivregister.de/api/public/reporting/laendertabelle
1632269956,25307,21236,4071,1507,825,https://www.intensivregister.de/api/public/reporting/laendertabelle
1632273552,25307,21233,4074,1512,826,https://www.intensivregister.de/api/public/reporting/laendertabelle
1632277150,25315,21286,4029,1504,827,https://www.intensivregister.de/api/public/reporting/laendertabelle
1632280747,25348,21332,4016,1502,821,https://www.intensivregister.de/api/public/reporting/laendertabelle
1632284354,25356,21377,3979,1495,820,https://www.intensivregister.de/api/public/reporting/laendertabelle
1632287952,25352,21414,3938,1502,826,https://www.intensivregister.de/api/public/reporting/laendertabelle
1632291549,25345,21408,3937,1496,822,https://www.intensivregister.de/api/public/reporting/laendertabelle
1632295147,25338,21448,3890,1501,823,https://www.intensivregister.de/api/public/reporting/laendertabelle
1632298755,25340,21432,3908,1500,825,https://www.intensivregister.de/api/public/reporting/laendertabelle
1632302353,25340,21435,3905,1500,825,https://www.intensivregister.de/api/public/reporting/laendertabelle
1632305950,25340,21433,3907,1498,824,https://www.intensivregister.de/api/public/reporting/laendertabelle
1632309548,25340,21432,3908,1497,824,https://www.intensivregister.de/api/public/reporting/laendertabelle
1632313155,25354,21444,3910,1497,824,https://www.intensivregister.de/api/public/reporting/laendertabelle
1632327556,25353,21441,3912,1497,825,https://www.intensivregister.de/api/public/reporting/laendertabelle
1632341954,25353,21436,3917,1497,825,https://www.intensivregister.de/api/public/reporting/laendertabelle
1632345551,25352,21437,3915,1498,825,https://www.intensivregister.de/api/public/reporting/laendertabelle
1632349148,25350,21432,3918,1499,825,https://www.intensivregister.de/api/public/reporting/laendertabelle
1632356354,25348,21429,3919,1502,825,https://www.intensivregister.de/api/public/reporting/laendertabelle
1632359951,25344,21426,3918,1503,826,https://www.intensivregister.de/api/public/reporting/laendertabelle
1632363548,25335,21431,3904,1501,826,https://www.intensivregister.de/api/public/reporting/laendertabelle
1632367155,25348,21437,3911,1489,827,https://www.intensivregister.de/api/public/reporting/laendertabelle
1632370752,25311,21388,3923,1476,826,https://www.intensivregister.de/api/public/reporting/laendertabelle
1632374349,25304,21396,3908,1469,831,https://www.intensivregister.de/api/public/reporting/laendertabelle
1632377947,25324,21399,3925,1467,832,https://www.intensivregister.de/api/public/reporting/laendertabelle
1632381555,25325,21381,3944,1460,831,https://www.intensivregister.de/api/public/reporting/laendertabelle
1632385153,25331,21383,3948,1458,831,https://www.intensivregister.de/api/public/reporting/laendertabelle
1632388750,25328,21372,3956,1456,831,https://www.intensivregister.de/api/public/reporting/laendertabelle
1632392348,25328,21369,3959,1451,829,https://www.intensivregister.de/api/public/reporting/laendertabelle
1632395955,25328,21365,3963,1451,830,https://www.intensivregister.de/api/public/reporting/laendertabelle
1632399552,25326,21366,3960,1452,830,https://www.intensivregister.de/api/public/reporting/laendertabelle
1632406748,25326,21367,3959,1452,830,https://www.intensivregister.de/api/public/reporting/laendertabelle
1632410356,25326,21366,3960,1453,831,https://www.intensivregister.de/api/public/reporting/laendertabelle
1632413953,25326,21364,3962,1453,831,https://www.intensivregister.de/api/public/reporting/laendertabelle
1632417550,25326,21363,3963,1453,831,https://www.intensivregister.de/api/public/reporting/laendertabelle
1632428354,25326,21360,3966,1453,831,https://www.intensivregister.de/api/public/reporting/laendertabelle
1632431952,25326,21364,3962,1453,831,https://www.intensivregister.de/api/public/reporting/laendertabelle
1632435550,25328,21367,3961,1451,830,https://www.intensivregister.de/api/public/reporting/laendertabelle
1632439156,25327,21369,3958,1451,831,https://www.intensivregister.de/api/public/reporting/laendertabelle
1632442756,25328,21375,3953,1452,831,https://www.intensivregister.de/api/public/reporting/laendertabelle
1632446353,25328,21369,3959,1451,831,https://www.intensivregister.de/api/public/reporting/laendertabelle
1632449953,25326,21358,3968,1448,829,https://www.intensivregister.de/api/public/reporting/laendertabelle
1632453554,25317,21376,3941,1442,826,https://www.intensivregister.de/api/public/reporting/laendertabelle
1632457154,25286,21357,3929,1432,826,https://www.intensivregister.de/api/public/reporting/laendertabelle
1632460755,25269,21344,3925,1439,825,https://www.intensivregister.de/api/public/reporting/laendertabelle
1632464347,25270,21326,3944,1437,826,https://www.intensivregister.de/api/public/reporting/laendertabelle
1632467947,25262,21310,3952,1434,825,https://www.intensivregister.de/api/public/reporting/laendertabelle
1632471548,25257,21306,3951,1430,823,https://www.intensivregister.de/api/public/reporting/laendertabelle
1632475149,25258,21302,3956,1431,823,https://www.intensivregister.de/api/public/reporting/laendertabelle
1632478751,25259,21304,3955,1432,822,https://www.intensivregister.de/api/public/reporting/laendertabelle
1632482352,25260,21306,3954,1431,821,https://www.intensivregister.de/api/public/reporting/laendertabelle
1632485952,25258,21304,3954,1431,822,https://www.intensivregister.de/api/public/reporting/laendertabelle
1632489553,25252,21296,3956,1432,822,https://www.intensivregister.de/api/public/reporting/laendertabelle
1632493155,25252,21297,3955,1432,822,https://www.intensivregister.de/api/public/reporting/laendertabelle
1632500356,25252,21300,3952,1432,822,https://www.intensivregister.de/api/public/reporting/laendertabelle
1632503947,25252,21298,3954,1432,822,https://www.intensivregister.de/api/public/reporting/laendertabelle
1632514754,25250,21291,3959,1432,822,https://www.intensivregister.de/api/public/reporting/laendertabelle
1632518355,25250,21289,3961,1433,822,https://www.intensivregister.de/api/public/reporting/laendertabelle
1632521956,25246,21289,3957,1435,821,https://www.intensivregister.de/api/public/reporting/laendertabelle
1632525555,25246,21291,3955,1435,821,https://www.intensivregister.de/api/public/reporting/laendertabelle
1632529152,25246,21290,3956,1436,820,https://www.intensivregister.de/api/public/reporting/laendertabelle
1632532751,25245,21301,3944,1436,820,https://www.intensivregister.de/api/public/reporting/laendertabelle
1632536349,25239,21292,3947,1431,820,https://www.intensivregister.de/api/public/reporting/laendertabelle
1632539947,25199,21254,3945,1431,823,https://www.intensivregister.de/api/public/reporting/laendertabelle
1632543555,25239,21175,4064,1430,818,https://www.intensivregister.de/api/public/reporting/laendertabelle
1632547153,25208,21090,4118,1442,823,https://www.intensivregister.de/api/public/reporting/laendertabelle
1632550752,25182,21032,4150,1435,821,https://www.intensivregister.de/api/public/reporting/laendertabelle
1632554350,25168,21007,4161,1435,824,https://www.intensivregister.de/api/public/reporting/laendertabelle
1632557949,25167,20996,4171,1438,825,https://www.intensivregister.de/api/public/reporting/laendertabelle
1632561547,25168,20988,4180,1439,824,https://www.intensivregister.de/api/public/reporting/laendertabelle
1632565155,25171,20987,4184,1438,823,https://www.intensivregister.de/api/public/reporting/laendertabelle
1632568753,25171,20989,4182,1438,823,https://www.intensivregister.de/api/public/reporting/laendertabelle
1632572351,25171,20993,4178,1438,823,https://www.intensivregister.de/api/public/reporting/laendertabelle
1632575949,25166,20988,4178,1439,823,https://www.intensivregister.de/api/public/reporting/laendertabelle
1632579547,25167,20989,4178,1440,824,https://www.intensivregister.de/api/public/reporting/laendertabelle
1632583156,25167,20990,4177,1440,824,https://www.intensivregister.de/api/public/reporting/laendertabelle
1632590351,25167,20988,4179,1440,824,https://www.intensivregister.de/api/public/reporting/laendertabelle
1632593950,25167,20987,4180,1440,824,https://www.intensivregister.de/api/public/reporting/laendertabelle
1632601147,25165,20992,4173,1438,824,https://www.intensivregister.de/api/public/reporting/laendertabelle
1632604755,25162,20985,4177,1437,824,https://www.intensivregister.de/api/public/reporting/laendertabelle
1632608353,25158,20980,4178,1436,823,https://www.intensivregister.de/api/public/reporting/laendertabelle
1632611951,25156,20971,4185,1437,824,https://www.intensivregister.de/api/public/reporting/laendertabelle
1632615549,25156,20964,4192,1438,824,https://www.intensivregister.de/api/public/reporting/laendertabelle
1632619147,25154,20960,4194,1436,824,https://www.intensivregister.de/api/public/reporting/laendertabelle
1632622755,25146,20934,4212,1437,824,https://www.intensivregister.de/api/public/reporting/laendertabelle
1632626353,25131,20870,4261,1435,823,https://www.intensivregister.de/api/public/reporting/laendertabelle
1632629951,24994,20798,4196,1434,822,https://www.intensivregister.de/api/public/reporting/laendertabelle
1632633549,24977,20746,4231,1427,821,https://www.intensivregister.de/api/public/reporting/laendertabelle
1632637147,24975,20734,4241,1432,821,https://www.intensivregister.de/api/public/reporting/laendertabelle
1632640755,24964,20727,4237,1431,821,https://www.intensivregister.de/api/public/reporting/laendertabelle
1632644354,24962,20725,4237,1437,824,https://www.intensivregister.de/api/public/reporting/laendertabelle
1632647954,24962,20716,4246,1439,826,https://www.intensivregister.de/api/public/reporting/laendertabelle
1632655149,24963,20714,4249,1438,824,https://www.intensivregister.de/api/public/reporting/laendertabelle
1632658756,24963,20715,4248,1438,824,https://www.intensivregister.de/api/public/reporting/laendertabelle
1632665951,24963,20713,4250,1438,824,https://www.intensivregister.de/api/public/reporting/laendertabelle
1632673148,24959,20707,4252,1438,824,https://www.intensivregister.de/api/public/reporting/laendertabelle
1632676747,24959,20708,4251,1438,824,https://www.intensivregister.de/api/public/reporting/laendertabelle
1632680355,24959,20710,4249,1438,824,https://www.intensivregister.de/api/public/reporting/laendertabelle
1632683954,24959,20710,4249,1439,824,https://www.intensivregister.de/api/public/reporting/laendertabelle
1632687552,24959,20715,4244,1439,824,https://www.intensivregister.de/api/public/reporting/laendertabelle
1632691150,24959,20713,4246,1440,824,https://www.intensivregister.de/api/public/reporting/laendertabelle
1632694748,24959,20715,4244,1440,824,https://www.intensivregister.de/api/public/reporting/laendertabelle
1632698356,24958,20716,4242,1440,824,https://www.intensivregister.de/api/public/reporting/laendertabelle
1632701954,24958,20714,4244,1440,824,https://www.intensivregister.de/api/public/reporting/laendertabelle
1632705553,24967,20728,4239,1438,823,https://www.intensivregister.de/api/public/reporting/laendertabelle
1632709151,25001,20734,4267,1442,821,https://www.intensivregister.de/api/public/reporting/laendertabelle
1632712750,25046,20750,4296,1446,824,https://www.intensivregister.de/api/public/reporting/laendertabelle
1632716349,25105,20788,4317,1436,822,https://www.intensivregister.de/api/public/reporting/laendertabelle
1632719948,25141,20875,4266,1434,822,https://www.intensivregister.de/api/public/reporting/laendertabelle
1632723548,25160,20895,4265,1429,813,https://www.intensivregister.de/api/public/reporting/laendertabelle
1632727147,25192,20918,4274,1431,811,https://www.intensivregister.de/api/public/reporting/laendertabelle
1632730756,25196,20908,4288,1431,811,https://www.intensivregister.de/api/public/reporting/laendertabelle
1632734356,25197,20897,4300,1432,813,https://www.intensivregister.de/api/public/reporting/laendertabelle
1632737955,25207,20904,4303,1432,813,https://www.intensivregister.de/api/public/reporting/laendertabelle
1632745155,25212,20908,4304,1433,813,https://www.intensivregister.de/api/public/reporting/laendertabelle
1632748754,25211,20908,4303,1433,813,https://www.intensivregister.de/api/public/reporting/laendertabelle
1632752353,25211,20907,4304,1433,813,https://www.intensivregister.de/api/public/reporting/laendertabelle
1632759550,25211,20903,4308,1434,812,https://www.intensivregister.de/api/public/reporting/laendertabelle
1632773956,25210,20901,4309,1433,812,https://www.intensivregister.de/api/public/reporting/laendertabelle
1632777554,25211,20901,4310,1433,812,https://www.intensivregister.de/api/public/reporting/laendertabelle
1632781154,25214,20907,4307,1433,812,https://www.intensivregister.de/api/public/reporting/laendertabelle
1632784753,25216,20906,4310,1432,812,https://www.intensivregister.de/api/public/reporting/laendertabelle
1632788352,25217,20912,4305,1432,813,https://www.intensivregister.de/api/public/reporting/laendertabelle
1632791950,25220,20931,4289,1430,812,https://www.intensivregister.de/api/public/reporting/laendertabelle
1632795548,25232,20962,4270,1423,807,https://www.intensivregister.de/api/public/reporting/laendertabelle
1632799155,25263,21050,4213,1419,805,https://www.intensivregister.de/api/public/reporting/laendertabelle
1632802753,25335,21245,4090,1413,803,https://www.intensivregister.de/api/public/reporting/laendertabelle
1632806350,25328,21315,4013,1412,804,https://www.intensivregister.de/api/public/reporting/laendertabelle
1632809947,25341,21371,3970,1416,804,https://www.intensivregister.de/api/public/reporting/laendertabelle
1632813554,25343,21371,3972,1414,806,https://www.intensivregister.de/api/public/reporting/laendertabelle
1632817152,25343,21379,3964,1416,806,https://www.intensivregister.de/api/public/reporting/laendertabelle
1632820751,25346,21374,3972,1417,806,https://www.intensivregister.de/api/public/reporting/laendertabelle
1632824348,25356,21385,3971,1420,806,https://www.intensivregister.de/api/public/reporting/laendertabelle
1632827956,25357,21384,3973,1420,806,https://www.intensivregister.de/api/public/reporting/laendertabelle
1632831554,25357,21384,3973,1421,805,https://www.intensivregister.de/api/public/reporting/laendertabelle
1632835152,25357,21385,3972,1422,805,https://www.intensivregister.de/api/public/reporting/laendertabelle
1632845954,25357,21384,3973,1422,805,https://www.intensivregister.de/api/public/reporting/laendertabelle
1632849552,25357,21385,3972,1423,805,https://www.intensivregister.de/api/public/reporting/laendertabelle
1632860353,25358,21392,3966,1423,805,https://www.intensivregister.de/api/public/reporting/laendertabelle
1632863950,25358,21391,3967,1423,805,https://www.intensivregister.de/api/public/reporting/laendertabelle
1632867548,25357,21386,3971,1423,806,https://www.intensivregister.de/api/public/reporting/laendertabelle
1632871156,25357,21385,3972,1423,806,https://www.intensivregister.de/api/public/reporting/laendertabelle
1632874752,25357,21383,3974,1424,807,https://www.intensivregister.de/api/public/reporting/laendertabelle
1632878354,25357,21377,3980,1425,809,https://www.intensivregister.de/api/public/reporting/laendertabelle
1632881955,25349,21426,3923,1423,809,https://www.intensivregister.de/api/public/reporting/laendertabelle
1632885555,25346,21416,3930,1416,803,https://www.intensivregister.de/api/public/reporting/laendertabelle
1632889155,25374,21482,3892,1388,793,https://www.intensivregister.de/api/public/reporting/laendertabelle
1632892756,25387,21475,3912,1364,782,https://www.intensivregister.de/api/public/reporting/laendertabelle
1632896346,25414,21537,3877,1364,783,https://www.intensivregister.de/api/public/reporting/laendertabelle
1632899948,25422,21554,3868,1366,787,https://www.intensivregister.de/api/public/reporting/laendertabelle
1632903549,25421,21544,3877,1364,788,https://www.intensivregister.de/api/public/reporting/laendertabelle
1632907148,25421,21544,3877,1366,789,https://www.intensivregister.de/api/public/reporting/laendertabelle
1632910749,25421,21541,3880,1366,789,https://www.intensivregister.de/api/public/reporting/laendertabelle
1632977916,25415,21628,3787,1363,787,https://www.intensivregister.de/api/public/reporting/laendertabelle
1632979155,25264,21470,3794,1366,788,https://www.intensivregister.de/api/public/reporting/laendertabelle
1632982747,25258,21452,3806,1365,783,https://www.intensivregister.de/api/public/reporting/laendertabelle
1632986349,25248,21471,3777,1357,782,https://www.intensivregister.de/api/public/reporting/laendertabelle
1632989950,25247,21473,3774,1356,783,https://www.intensivregister.de/api/public/reporting/laendertabelle
1632993552,25249,21463,3786,1357,784,https://www.intensivregister.de/api/public/reporting/laendertabelle
1632997154,25236,21452,3784,1357,784,https://www.intensivregister.de/api/public/reporting/laendertabelle
1633000756,25236,21449,3787,1357,783,https://www.intensivregister.de/api/public/reporting/laendertabelle
1633000756,25236,21450,3786,1357,783,https://www.intensivregister.de/api/public/reporting/laendertabelle
1633000756,25236,21451,3785,1357,783,https://www.intensivregister.de/api/public/reporting/laendertabelle
1633000756,25232,21441,3791,1356,783,https://www.intensivregister.de/api/public/reporting/laendertabelle
1633000756,25231,21442,3789,1357,783,https://www.intensivregister.de/api/public/reporting/laendertabelle
1633000756,25231,21442,3789,1356,783,https://www.intensivregister.de/api/public/reporting/laendertabelle
1633000756,25231,21443,3788,1355,783,https://www.intensivregister.de/api/public/reporting/laendertabelle
1633000756,25233,21457,3776,1355,783,https://www.intensivregister.de/api/public/reporting/laendertabelle
1633000756,25228,21457,3771,1356,783,https://www.intensivregister.de/api/public/reporting/laendertabelle
1633000756,25215,21462,3753,1352,783,https://www.intensivregister.de/api/public/reporting/laendertabelle
1633000756,25193,21472,3721,1356,786,https://www.intensivregister.de/api/public/reporting/laendertabelle
1633062783,25131,21410,3721,1367,788,https://www.intensivregister.de/api/public/reporting/laendertabelle
1633062783,25120,21373,3747,1373,786,https://www.intensivregister.de/api/public/reporting/laendertabelle
1633070548,25118,21328,3790,1370,787,https://www.intensivregister.de/api/public/reporting/laendertabelle
1633072516,25115,21312,3803,1364,785,https://www.intensivregister.de/api/public/reporting/laendertabelle
1633076115,25114,21314,3800,1364,785,https://www.intensivregister.de/api/public/reporting/laendertabelle
1633079713,25109,21318,3791,1361,783,https://www.intensivregister.de/api/public/reporting/laendertabelle
1633083311,25099,21309,3790,1361,784,https://www.intensivregister.de/api/public/reporting/laendertabelle
1633086910,25099,21310,3789,1361,784,https://www.intensivregister.de/api/public/reporting/laendertabelle
1633086910,25098,21307,3791,1361,784,https://www.intensivregister.de/api/public/reporting/laendertabelle
1633094115,25098,21309,3789,1361,784,https://www.intensivregister.de/api/public/reporting/laendertabelle
1633097713,25096,21306,3790,1360,784,https://www.intensivregister.de/api/public/reporting/laendertabelle
1633101309,25093,21306,3787,1359,784,https://www.intensivregister.de/api/public/reporting/laendertabelle
1633101309,25093,21307,3786,1357,785,https://www.intensivregister.de/api/public/reporting/laendertabelle
1633115709,25093,21312,3781,1357,785,https://www.intensivregister.de/api/public/reporting/laendertabelle
1633119316,25084,21304,3780,1357,787,https://www.intensivregister.de/api/public/reporting/laendertabelle
1633122912,25080,21302,3778,1356,786,https://www.intensivregister.de/api/public/reporting/laendertabelle
1633126508,25075,21292,3783,1356,786,https://www.intensivregister.de/api/public/reporting/laendertabelle
1633130115,25074,21291,3783,1356,786,https://www.intensivregister.de/api/public/reporting/laendertabelle
1633133713,25071,21290,3781,1355,787,https://www.intensivregister.de/api/public/reporting/laendertabelle
1633137310,25068,21276,3792,1355,787,https://www.intensivregister.de/api/public/reporting/laendertabelle
1633140918,25064,21249,3815,1351,785,https://www.intensivregister.de/api/public/reporting/laendertabelle
1633144513,25032,21206,3826,1357,790,https://www.intensivregister.de/api/public/reporting/laendertabelle
1633148110,24990,21116,3874,1344,790,https://www.intensivregister.de/api/public/reporting/laendertabelle
1633148110,24935,21062,3873,1346,790,https://www.intensivregister.de/api/public/reporting/laendertabelle
1633155309,24885,20954,3931,1342,792,https://www.intensivregister.de/api/public/reporting/laendertabelle
1633158911,24858,20931,3927,1335,793,https://www.intensivregister.de/api/public/reporting/laendertabelle
1633162514,24845,20921,3924,1334,791,https://www.intensivregister.de/api/public/reporting/laendertabelle
1633166115,24849,20927,3922,1335,792,https://www.intensivregister.de/api/public/reporting/laendertabelle
1633169714,24849,20916,3933,1333,791,https://www.intensivregister.de/api/public/reporting/laendertabelle
1633173315,24847,20915,3932,1333,791,https://www.intensivregister.de/api/public/reporting/laendertabelle
1633176916,24849,20908,3941,1333,791,https://www.intensivregister.de/api/public/reporting/laendertabelle
1633184110,24847,20905,3942,1332,791,https://www.intensivregister.de/api/public/reporting/laendertabelle
1633187712,24847,20905,3942,1334,792,https://www.intensivregister.de/api/public/reporting/laendertabelle
1633191312,24847,20904,3943,1334,792,https://www.intensivregister.de/api/public/reporting/laendertabelle
1633194914,24847,20907,3940,1335,792,https://www.intensivregister.de/api/public/reporting/laendertabelle
1633198515,24847,20910,3937,1335,792,https://www.intensivregister.de/api/public/reporting/laendertabelle
1633205708,24848,20880,3968,1335,792,https://www.intensivregister.de/api/public/reporting/laendertabelle
1633209309,24844,20878,3966,1335,793,https://www.intensivregister.de/api/public/reporting/laendertabelle
1633212910,24844,20882,3962,1335,793,https://www.intensivregister.de/api/public/reporting/laendertabelle
1633216515,24844,20887,3957,1334,792,https://www.intensivregister.de/api/public/reporting/laendertabelle
1633223714,24847,20879,3968,1335,793,https://www.intensivregister.de/api/public/reporting/laendertabelle
1633227316,24848,20876,3972,1329,790,https://www.intensivregister.de/api/public/reporting/laendertabelle
1633230908,24834,20816,4018,1325,792,https://www.intensivregister.de/api/public/reporting/laendertabelle
1633234512,24824,20749,4075,1331,790,https://www.intensivregister.de/api/public/reporting/laendertabelle
1633238114,24800,20680,4120,1332,792,https://www.intensivregister.de/api/public/reporting/laendertabelle
1633241714,24791,20631,4160,1338,795,https://www.intensivregister.de/api/public/reporting/laendertabelle
1633245313,24786,20620,4166,1335,795,https://www.intensivregister.de/api/public/reporting/laendertabelle
1633248915,24788,20614,4174,1337,792,https://www.intensivregister.de/api/public/reporting/laendertabelle
1633252513,24790,20606,4184,1335,791,https://www.intensivregister.de/api/public/reporting/laendertabelle
1633256113,24791,20606,4185,1335,791,https://www.intensivregister.de/api/public/reporting/laendertabelle
1633259714,24791,20605,4186,1336,791,https://www.intensivregister.de/api/public/reporting/laendertabelle
1633263312,24791,20605,4186,1335,791,https://www.intensivregister.de/api/public/reporting/laendertabelle
1633266912,24791,20602,4189,1335,792,https://www.intensivregister.de/api/public/reporting/laendertabelle
1633270512,24791,20602,4189,1333,792,https://www.intensivregister.de/api/public/reporting/laendertabelle
1633274110,24792,20602,4190,1333,792,https://www.intensivregister.de/api/public/reporting/laendertabelle
1633281310,24794,20608,4186,1335,792,https://www.intensivregister.de/api/public/reporting/laendertabelle
1633292108,24791,20603,4188,1335,793,https://www.intensivregister.de/api/public/reporting/laendertabelle
1633295708,24789,20607,4182,1336,793,https://www.intensivregister.de/api/public/reporting/laendertabelle
1633299315,24790,20607,4183,1336,793,https://www.intensivregister.de/api/public/reporting/laendertabelle
1633302913,24790,20601,4189,1336,793,https://www.intensivregister.de/api/public/reporting/laendertabelle
1633306512,24791,20610,4181,1334,791,https://www.intensivregister.de/api/public/reporting/laendertabelle
1633310113,24790,20617,4173,1333,787,https://www.intensivregister.de/api/public/reporting/laendertabelle
1633313709,24818,20609,4209,1333,784,https://www.intensivregister.de/api/public/reporting/laendertabelle
1633317313,24868,20645,4223,1342,786,https://www.intensivregister.de/api/public/reporting/laendertabelle
1633320911,24956,20687,4269,1346,791,https://www.intensivregister.de/api/public/reporting/laendertabelle
1633324514,24998,20706,4292,1350,788,https://www.intensivregister.de/api/public/reporting/laendertabelle
1633328110,25027,20720,4307,1347,791,https://www.intensivregister.de/api/public/reporting/laendertabelle
1633328110,25038,20738,4300,1348,795,https://www.intensivregister.de/api/public/reporting/laendertabelle
1633335315,25042,20737,4305,1350,795,https://www.intensivregister.de/api/public/reporting/laendertabelle
1633338911,25042,20737,4305,1351,795,https://www.intensivregister.de/api/public/reporting/laendertabelle
1633338911,25041,20731,4310,1351,795,https://www.intensivregister.de/api/public/reporting/laendertabelle
1633346114,25041,20731,4310,1352,795,https://www.intensivregister.de/api/public/reporting/laendertabelle
1633349710,25042,20732,4310,1352,795,https://www.intensivregister.de/api/public/reporting/laendertabelle
1633353317,25041,20734,4307,1352,795,https://www.intensivregister.de/api/public/reporting/laendertabelle
1633360510,25041,20734,4307,1353,795,https://www.intensivregister.de/api/public/reporting/laendertabelle
1633364116,25041,20735,4306,1353,795,https://www.intensivregister.de/api/public/reporting/laendertabelle
1633378511,25041,20736,4305,1353,795,https://www.intensivregister.de/api/public/reporting/laendertabelle
1633382108,25043,20743,4300,1352,794,https://www.intensivregister.de/api/public/reporting/laendertabelle
1633385713,25043,20745,4298,1352,794,https://www.intensivregister.de/api/public/reporting/laendertabelle
1633385713,25045,20743,4302,1352,794,https://www.intensivregister.de/api/public/reporting/laendertabelle
1633392910,25049,20745,4304,1351,795,https://www.intensivregister.de/api/public/reporting/laendertabelle
1633396515,25050,20751,4299,1352,796,https://www.intensivregister.de/api/public/reporting/laendertabelle
1633400109,25062,20806,4256,1355,801,https://www.intensivregister.de/api/public/reporting/laendertabelle
1633403714,25069,20870,4199,1356,802,https://www.intensivregister.de/api/public/reporting/laendertabelle
1633407313,25089,21012,4077,1367,799,https://www.intensivregister.de/api/public/reporting/laendertabelle
1633410908,25121,21161,3960,1362,795,https://www.intensivregister.de/api/public/reporting/laendertabelle
1633414513,25130,21220,3910,1362,795,https://www.intensivregister.de/api/public/reporting/laendertabelle
1633414513,25133,21266,3867,1359,790,https://www.intensivregister.de/api/public/reporting/laendertabelle
1633421712,25137,21273,3864,1361,790,https://www.intensivregister.de/api/public/reporting/laendertabelle
1633425308,25135,21285,3850,1363,790,https://www.intensivregister.de/api/public/reporting/laendertabelle
1633428913,25136,21281,3855,1361,789,https://www.intensivregister.de/api/public/reporting/laendertabelle
1633432510,25136,21283,3853,1364,788,https://www.intensivregister.de/api/public/reporting/laendertabelle
1633436115,25136,21284,3852,1363,788,https://www.intensivregister.de/api/public/reporting/laendertabelle
1633439711,25138,21283,3855,1363,788,https://www.intensivregister.de/api/public/reporting/laendertabelle
1633443318,25138,21283,3855,1362,788,https://www.intensivregister.de/api/public/reporting/laendertabelle
1633446911,25138,21284,3854,1362,788,https://www.intensivregister.de/api/public/reporting/laendertabelle
1633454110,25138,21288,3850,1362,788,https://www.intensivregister.de/api/public/reporting/laendertabelle
1633457715,25138,21290,3848,1362,788,https://www.intensivregister.de/api/public/reporting/laendertabelle
1633464914,25144,21277,3867,1363,789,https://www.intensivregister.de/api/public/reporting/laendertabelle
1633468509,25145,21281,3864,1362,789,https://www.intensivregister.de/api/public/reporting/laendertabelle
1633472114,25142,21286,3856,1363,789,https://www.intensivregister.de/api/public/reporting/laendertabelle
1633475709,25141,21283,3858,1363,789,https://www.intensivregister.de/api/public/reporting/laendertabelle
1633479313,25145,21283,3862,1361,789,https://www.intensivregister.de/api/public/reporting/laendertabelle
1633482913,25146,21293,3853,1361,791,https://www.intensivregister.de/api/public/reporting/laendertabelle
1633486511,25143,21284,3859,1359,788,https://www.intensivregister.de/api/public/reporting/laendertabelle
1633490109,25144,21322,3822,1358,782,https://www.intensivregister.de/api/public/reporting/laendertabelle
1633493718,25194,21354,3840,1355,786,https://www.intensivregister.de/api/public/reporting/laendertabelle
1633497310,25194,21380,3814,1358,782,https://www.intensivregister.de/api/public/reporting/laendertabelle
1633500908,25191,21421,3770,1359,784,https://www.intensivregister.de/api/public/reporting/laendertabelle
1633504515,25195,21403,3792,1356,783,https://www.intensivregister.de/api/public/reporting/laendertabelle
1633508111,25193,21402,3791,1356,781,https://www.intensivregister.de/api/public/reporting/laendertabelle
1633511708,25193,21400,3793,1355,781,https://www.intensivregister.de/api/public/reporting/laendertabelle
1633515314,25206,21407,3799,1354,779,https://www.intensivregister.de/api/public/reporting/laendertabelle
1633518910,25213,21411,3802,1355,779,https://www.intensivregister.de/api/public/reporting/laendertabelle
1633522516,25209,21403,3806,1357,780,https://www.intensivregister.de/api/public/reporting/laendertabelle
1633526113,25209,21406,3803,1358,780,https://www.intensivregister.de/api/public/reporting/laendertabelle
1633529708,25210,21407,3803,1358,780,https://www.intensivregister.de/api/public/reporting/laendertabelle
1633536911,25210,21408,3802,1358,780,https://www.intensivregister.de/api/public/reporting/laendertabelle
1633547709,25210,21406,3804,1358,780,https://www.intensivregister.de/api/public/reporting/laendertabelle
1633551315,25210,21391,3819,1358,779,https://www.intensivregister.de/api/public/reporting/laendertabelle
1633554911,25211,21392,3819,1358,779,https://www.intensivregister.de/api/public/reporting/laendertabelle
1633558508,25211,21396,3815,1358,779,https://www.intensivregister.de/api/public/reporting/laendertabelle
1633562113,25212,21396,3816,1358,779,https://www.intensivregister.de/api/public/reporting/laendertabelle
1633565709,25212,21398,3814,1362,780,https://www.intensivregister.de/api/public/reporting/laendertabelle
1633569315,25211,21402,3809,1365,781,https://www.intensivregister.de/api/public/reporting/laendertabelle
1633572912,25206,21385,3821,1375,780,https://www.intensivregister.de/api/public/reporting/laendertabelle
1633576508,25202,21372,3830,1367,771,https://www.intensivregister.de/api/public/reporting/laendertabelle
1633580117,25201,21395,3806,1375,761,https://www.intensivregister.de/api/public/reporting/laendertabelle
1633583712,25196,21436,3760,1374,761,https://www.intensivregister.de/api/public/reporting/laendertabelle
1633587309,25184,21437,3747,1380,760,https://www.intensivregister.de/api/public/reporting/laendertabelle
1633590915,25190,21446,3744,1373,756,https://www.intensivregister.de/api/public/reporting/laendertabelle
1633594513,25189,21450,3739,1376,757,https://www.intensivregister.de/api/public/reporting/laendertabelle
1633598110,25191,21455,3736,1375,758,https://www.intensivregister.de/api/public/reporting/laendertabelle
1633601717,25191,21464,3727,1374,758,https://www.intensivregister.de/api/public/reporting/laendertabelle
1633605314,25191,21463,3728,1374,758,https://www.intensivregister.de/api/public/reporting/laendertabelle
1633608910,25186,21457,3729,1374,758,https://www.intensivregister.de/api/public/reporting/laendertabelle
1633612516,25186,21466,3720,1375,759,https://www.intensivregister.de/api/public/reporting/laendertabelle
1633616113,25186,21467,3719,1375,759,https://www.intensivregister.de/api/public/reporting/laendertabelle
1633630509,25187,21465,3722,1376,759,https://www.intensivregister.de/api/public/reporting/laendertabelle
1633634115,25186,21461,3725,1376,759,https://www.intensivregister.de/api/public/reporting/laendertabelle
1633637712,25186,21460,3726,1376,759,https://www.intensivregister.de/api/public/reporting/laendertabelle
1633641308,25186,21457,3729,1377,759,https://www.intensivregister.de/api/public/reporting/laendertabelle
1633648511,25185,21461,3724,1382,759,https://www.intensivregister.de/api/public/reporting/laendertabelle
1633652109,25182,21454,3728,1383,760,https://www.intensivregister.de/api/public/reporting/laendertabelle
1633655717,25183,21459,3724,1383,760,https://www.intensivregister.de/api/public/reporting/laendertabelle
1633659314,25177,21471,3706,1378,759,https://www.intensivregister.de/api/public/reporting/laendertabelle
1633662911,25182,21487,3695,1372,756,https://www.intensivregister.de/api/public/reporting/laendertabelle
1633666511,25160,21424,3736,1369,752,https://www.intensivregister.de/api/public/reporting/laendertabelle
1633666511,25132,21421,3711,1357,748,https://www.intensivregister.de/api/public/reporting/laendertabelle
1633673715,25127,21400,3727,1357,749,https://www.intensivregister.de/api/public/reporting/laendertabelle
1633677313,25087,21348,3739,1351,747,https://www.intensivregister.de/api/public/reporting/laendertabelle
1633680911,25082,21345,3737,1352,745,https://www.intensivregister.de/api/public/reporting/laendertabelle
1633684512,25082,21346,3736,1354,746,https://www.intensivregister.de/api/public/reporting/laendertabelle
1633688108,25080,21349,3731,1353,748,https://www.intensivregister.de/api/public/reporting/laendertabelle
1633691717,25081,21343,3738,1352,748,https://www.intensivregister.de/api/public/reporting/laendertabelle
1633695313,25081,21344,3737,1352,748,https://www.intensivregister.de/api/public/reporting/laendertabelle
1633698910,25081,21348,3733,1353,748,https://www.intensivregister.de/api/public/reporting/laendertabelle
1633720516,25081,21351,3730,1354,748,https://www.intensivregister.de/api/public/reporting/laendertabelle
1633724115,25076,21345,3731,1353,746,https://www.intensivregister.de/api/public/reporting/laendertabelle
1633727713,25074,21339,3735,1352,746,https://www.intensivregister.de/api/public/reporting/laendertabelle
1633731311,25074,21336,3738,1353,745,https://www.intensivregister.de/api/public/reporting/laendertabelle
1633734908,25074,21334,3740,1353,745,https://www.intensivregister.de/api/public/reporting/laendertabelle
1633738515,25073,21333,3740,1352,745,https://www.intensivregister.de/api/public/reporting/laendertabelle
1633742112,25070,21327,3743,1350,745,https://www.intensivregister.de/api/public/reporting/laendertabelle
1633745710,25064,21315,3749,1346,743,https://www.intensivregister.de/api/public/reporting/laendertabelle
1633745710,25045,21252,3793,1341,742,https://www.intensivregister.de/api/public/reporting/laendertabelle
1633752918,24981,21155,3826,1340,743,https://www.intensivregister.de/api/public/reporting/laendertabelle
1633756512,24930,21053,3877,1345,739,https://www.intensivregister.de/api/public/reporting/laendertabelle
1633760110,24894,21029,3865,1338,734,https://www.intensivregister.de/api/public/reporting/laendertabelle
1633763708,24858,20981,3877,1345,734,https://www.intensivregister.de/api/public/reporting/laendertabelle
1633767315,24847,20969,3878,1346,734,https://www.intensivregister.de/api/public/reporting/laendertabelle
1633770913,24845,20969,3876,1347,734,https://www.intensivregister.de/api/public/reporting/laendertabelle
1633774510,24843,20953,3890,1347,736,https://www.intensivregister.de/api/public/reporting/laendertabelle
1633778108,24846,20950,3896,1348,736,https://www.intensivregister.de/api/public/reporting/laendertabelle
1633781716,24845,20943,3902,1345,735,https://www.intensivregister.de/api/public/reporting/laendertabelle
1633785314,24845,20940,3905,1346,735,https://www.intensivregister.de/api/public/reporting/laendertabelle
1633792509,24845,20941,3904,1346,735,https://www.intensivregister.de/api/public/reporting/laendertabelle
1633796116,24845,20938,3907,1346,735,https://www.intensivregister.de/api/public/reporting/laendertabelle
1633803311,24845,20939,3906,1346,735,https://www.intensivregister.de/api/public/reporting/laendertabelle
1633806909,24844,20934,3910,1343,735,https://www.intensivregister.de/api/public/reporting/laendertabelle
1633810509,24843,20929,3914,1341,734,https://www.intensivregister.de/api/public/reporting/laendertabelle
1633814116,24845,20925,3920,1341,734,https://www.intensivregister.de/api/public/reporting/laendertabelle
1633817713,24845,20921,3924,1341,734,https://www.intensivregister.de/api/public/reporting/laendertabelle
1633821312,24845,20917,3928,1342,734,https://www.intensivregister.de/api/public/reporting/laendertabelle
1633824908,24846,20934,3912,1342,734,https://www.intensivregister.de/api/public/reporting/laendertabelle
1633828514,24852,20943,3909,1342,735,https://www.intensivregister.de/api/public/reporting/laendertabelle
1633832111,24853,20916,3937,1344,735,https://www.intensivregister.de/api/public/reporting/laendertabelle
1633835708,24844,20870,3974,1341,739,https://www.intensivregister.de/api/public/reporting/laendertabelle
1633839321,24824,20814,4010,1347,743,https://www.intensivregister.de/api/public/reporting/laendertabelle
1633842911,24806,20753,4053,1356,743,https://www.intensivregister.de/api/public/reporting/laendertabelle
1633846508,24800,20682,4118,1347,746,https://www.intensivregister.de/api/public/reporting/laendertabelle
1633850115,24799,20657,4142,1345,751,https://www.intensivregister.de/api/public/reporting/laendertabelle
1633853712,24795,20659,4136,1342,751,https://www.intensivregister.de/api/public/reporting/laendertabelle
1633857309,24794,20649,4145,1342,752,https://www.intensivregister.de/api/public/reporting/laendertabelle
1633860914,24790,20643,4147,1341,752,https://www.intensivregister.de/api/public/reporting/laendertabelle
1633864511,24790,20641,4149,1341,753,https://www.intensivregister.de/api/public/reporting/laendertabelle
1633864511,24790,20640,4150,1341,754,https://www.intensivregister.de/api/public/reporting/laendertabelle
1633871713,24787,20636,4151,1340,755,https://www.intensivregister.de/api/public/reporting/laendertabelle
1633875309,24788,20637,4151,1340,755,https://www.intensivregister.de/api/public/reporting/laendertabelle
1633878916,24788,20637,4151,1341,755,https://www.intensivregister.de/api/public/reporting/laendertabelle
1633882513,24788,20639,4149,1341,755,https://www.intensivregister.de/api/public/reporting/laendertabelle
1633886110,24788,20635,4153,1341,755,https://www.intensivregister.de/api/public/reporting/laendertabelle
1633896909,24783,20640,4143,1341,755,https://www.intensivregister.de/api/public/reporting/laendertabelle
1633900516,24782,20639,4143,1341,755,https://www.intensivregister.de/api/public/reporting/laendertabelle
1633904113,24782,20640,4142,1341,755,https://www.intensivregister.de/api/public/reporting/laendertabelle
1633907709,24784,20646,4138,1340,755,https://www.intensivregister.de/api/public/reporting/laendertabelle
1633911315,24782,20642,4140,1340,755,https://www.intensivregister.de/api/public/reporting/laendertabelle
1633914910,24791,20640,4151,1340,755,https://www.intensivregister.de/api/public/reporting/laendertabelle
1633914910,24791,20652,4139,1339,754,https://www.intensivregister.de/api/public/reporting/laendertabelle
1633922114,24853,20697,4156,1329,748,https://www.intensivregister.de/api/public/reporting/laendertabelle
1633925713,24893,20677,4216,1335,754,https://www.intensivregister.de/api/public/reporting/laendertabelle
1633929308,24901,20734,4167,1347,753,https://www.intensivregister.de/api/public/reporting/laendertabelle
1633932915,24936,20802,4134,1351,754,https://www.intensivregister.de/api/public/reporting/laendertabelle
1633936513,24941,20815,4126,1354,763,https://www.intensivregister.de/api/public/reporting/laendertabelle
1633940109,24942,20809,4133,1352,759,https://www.intensivregister.de/api/public/reporting/laendertabelle
1633940109,24942,20809,4133,1354,759,https://www.intensivregister.de/api/public/reporting/laendertabelle
1633947315,24944,20817,4127,1355,759,https://www.intensivregister.de/api/public/reporting/laendertabelle
1633950911,24944,20833,4111,1356,759,https://www.intensivregister.de/api/public/reporting/laendertabelle
1633961712,24944,20836,4108,1356,758,https://www.intensivregister.de/api/public/reporting/laendertabelle
1633983309,24953,20848,4105,1357,758,https://www.intensivregister.de/api/public/reporting/laendertabelle
1633986916,24954,20857,4097,1359,758,https://www.intensivregister.de/api/public/reporting/laendertabelle
1633990510,24954,20860,4094,1359,758,https://www.intensivregister.de/api/public/reporting/laendertabelle
1633990510,24957,20861,4096,1359,758,https://www.intensivregister.de/api/public/reporting/laendertabelle
1633997713,24961,20867,4094,1359,757,https://www.intensivregister.de/api/public/reporting/laendertabelle
1634001309,24961,20870,4091,1359,757,https://www.intensivregister.de/api/public/reporting/laendertabelle
1634004915,24969,20935,4034,1352,755,https://www.intensivregister.de/api/public/reporting/laendertabelle
1634008511,25000,21026,3974,1364,758,https://www.intensivregister.de/api/public/reporting/laendertabelle
1634012114,25050,21146,3904,1373,765,https://www.intensivregister.de/api/public/reporting/laendertabelle
1634015715,25066,21239,3827,1381,771,https://www.intensivregister.de/api/public/reporting/laendertabelle
1634019312,25093,21282,3811,1388,769,https://www.intensivregister.de/api/public/reporting/laendertabelle
1634022909,25086,21279,3807,1383,768,https://www.intensivregister.de/api/public/reporting/laendertabelle
1634026517,25084,21282,3802,1380,767,https://www.intensivregister.de/api/public/reporting/laendertabelle
1634030113,25084,21281,3803,1380,767,https://www.intensivregister.de/api/public/reporting/laendertabelle
1634033709,25083,21283,3800,1379,767,https://www.intensivregister.de/api/public/reporting/laendertabelle
1634037316,25083,21284,3799,1379,767,https://www.intensivregister.de/api/public/reporting/laendertabelle
1634040912,25075,21282,3793,1379,768,https://www.intensivregister.de/api/public/reporting/laendertabelle
1634044509,25077,21284,3793,1379,768,https://www.intensivregister.de/api/public/reporting/laendertabelle
1634048116,25077,21283,3794,1379,769,https://www.intensivregister.de/api/public/reporting/laendertabelle
1634051713,25077,21284,3793,1379,769,https://www.intensivregister.de/api/public/reporting/laendertabelle
1634058916,25077,21285,3792,1381,770,https://www.intensivregister.de/api/public/reporting/laendertabelle
1634069714,25080,21283,3797,1382,770,https://www.intensivregister.de/api/public/reporting/laendertabelle
1634073311,25080,21285,3795,1382,770,https://www.intensivregister.de/api/public/reporting/laendertabelle
1634073311,25079,21290,3789,1382,770,https://www.intensivregister.de/api/public/reporting/laendertabelle
1634080513,25079,21292,3787,1382,770,https://www.intensivregister.de/api/public/reporting/laendertabelle
1634084110,25077,21291,3786,1381,770,https://www.intensivregister.de/api/public/reporting/laendertabelle
1634087738,25074,21291,3783,1384,771,https://www.intensivregister.de/api/public/reporting/laendertabelle
1634091310,25087,21332,3755,1388,776,https://www.intensivregister.de/api/public/reporting/laendertabelle
1634094916,25079,21407,3672,1383,768,https://www.intensivregister.de/api/public/reporting/laendertabelle
1634098515,25088,21386,3702,1384,771,https://www.intensivregister.de/api/public/reporting/laendertabelle
1634102114,25076,21426,3650,1395,772,https://www.intensivregister.de/api/public/reporting/laendertabelle
1634105713,25070,21433,3637,1396,776,https://www.intensivregister.de/api/public/reporting/laendertabelle
1634105713,25070,21425,3645,1400,774,https://www.intensivregister.de/api/public/reporting/laendertabelle
1634112913,25070,21423,3647,1401,774,https://www.intensivregister.de/api/public/reporting/laendertabelle
1634116508,25070,21422,3648,1398,771,https://www.intensivregister.de/api/public/reporting/laendertabelle
1634120115,25068,21429,3639,1399,771,https://www.intensivregister.de/api/public/reporting/laendertabelle
1634123712,25068,21427,3641,1399,771,https://www.intensivregister.de/api/public/reporting/laendertabelle
1634127308,25065,21424,3641,1399,771,https://www.intensivregister.de/api/public/reporting/laendertabelle
1634130916,25065,21423,3642,1399,771,https://www.intensivregister.de/api/public/reporting/laendertabelle
1634134511,25065,21423,3642,1400,772,https://www.intensivregister.de/api/public/reporting/laendertabelle
1634156115,25061,21417,3644,1397,772,https://www.intensivregister.de/api/public/reporting/laendertabelle
1634159710,25061,21418,3643,1396,772,https://www.intensivregister.de/api/public/reporting/laendertabelle
1634163315,25058,21417,3641,1396,772,https://www.intensivregister.de/api/public/reporting/laendertabelle
1634166911,25058,21416,3642,1396,772,https://www.intensivregister.de/api/public/reporting/laendertabelle
1634170517,25058,21414,3644,1396,772,https://www.intensivregister.de/api/public/reporting/laendertabelle
1634174112,25054,21422,3632,1399,771,https://www.intensivregister.de/api/public/reporting/laendertabelle
1634177708,25035,21372,3663,1399,778,https://www.intensivregister.de/api/public/reporting/laendertabelle
1634181313,25025,21326,3699,1401,774,https://www.intensivregister.de/api/public/reporting/laendertabelle
1634184912,25008,21316,3692,1395,770,https://www.intensivregister.de/api/public/reporting/laendertabelle
1634184912,25023,21316,3707,1384,765,https://www.intensivregister.de/api/public/reporting/laendertabelle
1634192113,25020,21318,3702,1393,768,https://www.intensivregister.de/api/public/reporting/laendertabelle
1634195710,25002,21312,3690,1397,767,https://www.intensivregister.de/api/public/reporting/laendertabelle
1634199314,25001,21310,3691,1397,767,https://www.intensivregister.de/api/public/reporting/laendertabelle
1634202909,25002,21312,3690,1396,767,https://www.intensivregister.de/api/public/reporting/laendertabelle
1634206516,25001,21313,3688,1396,767,https://www.intensivregister.de/api/public/reporting/laendertabelle
1634210112,25001,21317,3684,1397,768,https://www.intensivregister.de/api/public/reporting/laendertabelle
1634213708,25000,21315,3685,1397,768,https://www.intensivregister.de/api/public/reporting/laendertabelle
1634217314,25000,21305,3695,1396,767,https://www.intensivregister.de/api/public/reporting/laendertabelle
1634220910,25000,21306,3694,1396,767,https://www.intensivregister.de/api/public/reporting/laendertabelle
1634224516,25001,21306,3695,1396,767,https://www.intensivregister.de/api/public/reporting/laendertabelle
1634231717,25001,21305,3696,1396,767,https://www.intensivregister.de/api/public/reporting/laendertabelle
1634238916,25001,21305,3696,1397,767,https://www.intensivregister.de/api/public/reporting/laendertabelle
1634242510,25002,21307,3695,1400,767,https://www.intensivregister.de/api/public/reporting/laendertabelle
1634246115,25003,21305,3698,1400,767,https://www.intensivregister.de/api/public/reporting/laendertabelle
1634249710,25003,21303,3700,1400,767,https://www.intensivregister.de/api/public/reporting/laendertabelle
1634253314,25004,21304,3700,1400,767,https://www.intensivregister.de/api/public/reporting/laendertabelle
1634256910,25003,21304,3699,1402,769,https://www.intensivregister.de/api/public/reporting/laendertabelle
1634260515,25002,21303,3699,1402,768,https://www.intensivregister.de/api/public/reporting/laendertabelle
1634264110,24992,21301,3691,1401,775,https://www.intensivregister.de/api/public/reporting/laendertabelle
1634267716,24968,21268,3700,1409,776,https://www.intensivregister.de/api/public/reporting/laendertabelle
1634271315,24957,21261,3696,1404,772,https://www.intensivregister.de/api/public/reporting/laendertabelle
1634274908,24909,21232,3677,1397,774,https://www.intensivregister.de/api/public/reporting/laendertabelle
1634278513,24883,21245,3638,1400,774,https://www.intensivregister.de/api/public/reporting/laendertabelle
1634282110,24884,21228,3656,1401,774,https://www.intensivregister.de/api/public/reporting/laendertabelle
1634285716,24883,21227,3656,1402,774,https://www.intensivregister.de/api/public/reporting/laendertabelle
1634289314,24883,21219,3664,1403,775,https://www.intensivregister.de/api/public/reporting/laendertabelle
1634292911,24881,21216,3665,1402,774,https://www.intensivregister.de/api/public/reporting/laendertabelle
1634296517,24878,21210,3668,1401,773,https://www.intensivregister.de/api/public/reporting/laendertabelle
1634300114,24878,21213,3665,1399,773,https://www.intensivregister.de/api/public/reporting/laendertabelle
1634303711,24879,21218,3661,1398,772,https://www.intensivregister.de/api/public/reporting/laendertabelle
1634307308,24876,21219,3657,1399,773,https://www.intensivregister.de/api/public/reporting/laendertabelle
1634325315,24877,21219,3658,1399,773,https://www.intensivregister.de/api/public/reporting/laendertabelle
1634328913,24900,21240,3660,1401,775,https://www.intensivregister.de/api/public/reporting/laendertabelle
1634332512,24901,21237,3664,1400,775,https://www.intensivregister.de/api/public/reporting/laendertabelle
1634336109,24902,21234,3668,1400,775,https://www.intensivregister.de/api/public/reporting/laendertabelle
1634343314,24898,21227,3671,1400,775,https://www.intensivregister.de/api/public/reporting/laendertabelle
1634346913,24898,21226,3672,1401,775,https://www.intensivregister.de/api/public/reporting/laendertabelle
1634350513,24885,21198,3687,1398,774,https://www.intensivregister.de/api/public/reporting/laendertabelle
1634354113,24854,21132,3722,1401,780,https://www.intensivregister.de/api/public/reporting/laendertabelle
1634357716,24829,21046,3783,1407,775,https://www.intensivregister.de/api/public/reporting/laendertabelle
1634361312,24779,20974,3805,1411,770,https://www.intensivregister.de/api/public/reporting/laendertabelle
1634364912,24747,20861,3886,1414,779,https://www.intensivregister.de/api/public/reporting/laendertabelle
1634368512,24720,20832,3888,1411,779,https://www.intensivregister.de/api/public/reporting/laendertabelle
1634372111,24715,20824,3891,1411,779,https://www.intensivregister.de/api/public/reporting/laendertabelle
1634375711,24713,20818,3895,1410,779,https://www.intensivregister.de/api/public/reporting/laendertabelle
1634379310,24707,20804,3903,1409,779,https://www.intensivregister.de/api/public/reporting/laendertabelle
1634382909,24707,20803,3904,1409,779,https://www.intensivregister.de/api/public/reporting/laendertabelle
1634386509,24710,20805,3905,1409,779,https://www.intensivregister.de/api/public/reporting/laendertabelle
1634390108,24712,20808,3904,1408,780,https://www.intensivregister.de/api/public/reporting/laendertabelle
1634393708,24712,20809,3903,1407,779,https://www.intensivregister.de/api/public/reporting/laendertabelle
1634397316,24708,20804,3904,1407,779,https://www.intensivregister.de/api/public/reporting/laendertabelle
1634408115,24705,20800,3905,1407,779,https://www.intensivregister.de/api/public/reporting/laendertabelle
1634411715,24705,20801,3904,1407,779,https://www.intensivregister.de/api/public/reporting/laendertabelle
1634415314,24703,20787,3916,1407,778,https://www.intensivregister.de/api/public/reporting/laendertabelle
1634418914,24703,20796,3907,1407,778,https://www.intensivregister.de/api/public/reporting/laendertabelle
1634422513,24703,20794,3909,1407,778,https://www.intensivregister.de/api/public/reporting/laendertabelle
1634426114,24703,20796,3907,1407,778,https://www.intensivregister.de/api/public/reporting/laendertabelle
1634429714,24700,20791,3909,1406,778,https://www.intensivregister.de/api/public/reporting/laendertabelle
1634433315,24705,20802,3903,1406,778,https://www.intensivregister.de/api/public/reporting/laendertabelle
1634436914,24712,20800,3912,1408,777,https://www.intensivregister.de/api/public/reporting/laendertabelle
1634440513,24712,20757,3955,1414,778,https://www.intensivregister.de/api/public/reporting/laendertabelle
1634444117,24662,20698,3964,1422,779,https://www.intensivregister.de/api/public/reporting/laendertabelle
1634447714,24629,20649,3980,1421,783,https://www.intensivregister.de/api/public/reporting/laendertabelle
1634451314,24613,20619,3994,1420,791,https://www.intensivregister.de/api/public/reporting/laendertabelle
1634454914,24616,20608,4008,1420,791,https://www.intensivregister.de/api/public/reporting/laendertabelle
1634458514,24611,20601,4010,1419,788,https://www.intensivregister.de/api/public/reporting/laendertabelle
1634462113,24611,20603,4008,1420,788,https://www.intensivregister.de/api/public/reporting/laendertabelle
1634465714,24605,20593,4012,1419,790,https://www.intensivregister.de/api/public/reporting/laendertabelle
1634472913,24606,20598,4008,1419,791,https://www.intensivregister.de/api/public/reporting/laendertabelle
1634476513,24606,20594,4012,1420,793,https://www.intensivregister.de/api/public/reporting/laendertabelle
1634480113,24606,20595,4011,1419,793,https://www.intensivregister.de/api/public/reporting/laendertabelle
1634483714,24606,20597,4009,1420,793,https://www.intensivregister.de/api/public/reporting/laendertabelle
1634487313,24604,20595,4009,1421,793,https://www.intensivregister.de/api/public/reporting/laendertabelle
1634490914,24604,20593,4011,1421,793,https://www.intensivregister.de/api/public/reporting/laendertabelle
1634501714,24606,20582,4024,1421,793,https://www.intensivregister.de/api/public/reporting/laendertabelle
1634505314,24606,20588,4018,1421,793,https://www.intensivregister.de/api/public/reporting/laendertabelle
1634508914,24603,20589,4014,1420,793,https://www.intensivregister.de/api/public/reporting/laendertabelle
1634512514,24603,20586,4017,1420,792,https://www.intensivregister.de/api/public/reporting/laendertabelle
1634516114,24604,20586,4018,1420,792,https://www.intensivregister.de/api/public/reporting/laendertabelle
1634519713,24612,20598,4014,1421,793,https://www.intensivregister.de/api/public/reporting/laendertabelle
1634523312,24643,20597,4046,1422,792,https://www.intensivregister.de/api/public/reporting/laendertabelle
1634526911,24674,20663,4011,1434,791,https://www.intensivregister.de/api/public/reporting/laendertabelle
1634530515,24752,20692,4060,1443,794,https://www.intensivregister.de/api/public/reporting/laendertabelle
1634534112,24794,20700,4094,1448,789,https://www.intensivregister.de/api/public/reporting/laendertabelle
1634537711,24841,20745,4096,1453,793,https://www.intensivregister.de/api/public/reporting/laendertabelle
1634541310,24882,20802,4080,1456,794,https://www.intensivregister.de/api/public/reporting/laendertabelle
1634544911,24884,20804,4080,1456,793,https://www.intensivregister.de/api/public/reporting/laendertabelle
1634548512,24884,20808,4076,1454,792,https://www.intensivregister.de/api/public/reporting/laendertabelle
1634552113,24886,20810,4076,1455,792,https://www.intensivregister.de/api/public/reporting/laendertabelle
1634555714,24888,20814,4074,1457,792,https://www.intensivregister.de/api/public/reporting/laendertabelle
1634559315,24887,20818,4069,1459,793,https://www.intensivregister.de/api/public/reporting/laendertabelle
1634562915,24889,20819,4070,1458,793,https://www.intensivregister.de/api/public/reporting/laendertabelle
1634566516,24897,20823,4074,1458,793,https://www.intensivregister.de/api/public/reporting/laendertabelle
1634573717,24897,20822,4075,1458,793,https://www.intensivregister.de/api/public/reporting/laendertabelle
1634584516,24898,20823,4075,1458,793,https://www.intensivregister.de/api/public/reporting/laendertabelle
1634588115,24898,20819,4079,1458,793,https://www.intensivregister.de/api/public/reporting/laendertabelle
1634591714,24898,20827,4071,1458,795,https://www.intensivregister.de/api/public/reporting/laendertabelle
1634595314,24896,20825,4071,1458,795,https://www.intensivregister.de/api/public/reporting/laendertabelle
1634598913,24895,20824,4071,1459,796,https://www.intensivregister.de/api/public/reporting/laendertabelle
1634602512,24892,20832,4060,1459,796,https://www.intensivregister.de/api/public/reporting/laendertabelle
1634606114,24909,20841,4068,1458,797,https://www.intensivregister.de/api/public/reporting/laendertabelle
1634609713,24902,20917,3985,1472,803,https://www.intensivregister.de/api/public/reporting/laendertabelle
1634613312,24928,20986,3942,1462,809,https://www.intensivregister.de/api/public/reporting/laendertabelle
1634616915,24910,21092,3818,1466,806,https://www.intensivregister.de/api/public/reporting/laendertabelle
1634620512,24922,21172,3750,1469,795,https://www.intensivregister.de/api/public/reporting/laendertabelle
1634624114,24951,21218,3733,1477,800,https://www.intensivregister.de/api/public/reporting/laendertabelle
1634627714,24966,21270,3696,1475,796,https://www.intensivregister.de/api/public/reporting/laendertabelle
1634631315,24967,21267,3700,1474,796,https://www.intensivregister.de/api/public/reporting/laendertabelle
1634634915,24967,21272,3695,1475,796,https://www.intensivregister.de/api/public/reporting/laendertabelle
1634638516,24954,21261,3693,1471,794,https://www.intensivregister.de/api/public/reporting/laendertabelle
1634642115,24955,21265,3690,1471,794,https://www.intensivregister.de/api/public/reporting/laendertabelle
1634645716,24957,21265,3692,1470,794,https://www.intensivregister.de/api/public/reporting/laendertabelle
1634645716,24957,21266,3691,1470,794,https://www.intensivregister.de/api/public/reporting/laendertabelle
1634652908,24957,21266,3691,1471,795,https://www.intensivregister.de/api/public/reporting/laendertabelle
1634670907,24957,21266,3691,1472,795,https://www.intensivregister.de/api/public/reporting/laendertabelle
1634670907,24953,21250,3703,1475,795,https://www.intensivregister.de/api/public/reporting/laendertabelle
1634670907,24954,21251,3703,1474,795,https://www.intensivregister.de/api/public/reporting/laendertabelle
1634670907,24954,21249,3705,1474,795,https://www.intensivregister.de/api/public/reporting/laendertabelle
1634670907,24955,21249,3706,1475,795,https://www.intensivregister.de/api/public/reporting/laendertabelle
1634688908,24956,21252,3704,1475,795,https://www.intensivregister.de/api/public/reporting/laendertabelle
1634692508,24950,21248,3702,1472,796,https://www.intensivregister.de/api/public/reporting/laendertabelle
1634696114,24952,21282,3670,1477,803,https://www.intensivregister.de/api/public/reporting/laendertabelle
1634699711,24961,21333,3628,1486,802,https://www.intensivregister.de/api/public/reporting/laendertabelle
1634703311,24961,21388,3573,1489,811,https://www.intensivregister.de/api/public/reporting/laendertabelle
1634706915,24989,21375,3614,1481,809,https://www.intensivregister.de/api/public/reporting/laendertabelle
1634710513,24986,21393,3593,1482,813,https://www.intensivregister.de/api/public/reporting/laendertabelle
1634714111,24963,21374,3589,1483,817,https://www.intensivregister.de/api/public/reporting/laendertabelle
1634717708,24985,21406,3579,1481,816,https://www.intensivregister.de/api/public/reporting/laendertabelle
1634721316,24983,21410,3573,1481,816,https://www.intensivregister.de/api/public/reporting/laendertabelle
1634724912,24985,21402,3583,1480,815,https://www.intensivregister.de/api/public/reporting/laendertabelle
1634728510,24983,21406,3577,1480,815,https://www.intensivregister.de/api/public/reporting/laendertabelle
1634732108,24989,21408,3581,1477,812,https://www.intensivregister.de/api/public/reporting/laendertabelle
1634735715,24989,21408,3581,1478,813,https://www.intensivregister.de/api/public/reporting/laendertabelle
1634739312,24989,21409,3580,1478,813,https://www.intensivregister.de/api/public/reporting/laendertabelle
1634750114,24989,21407,3582,1480,813,https://www.intensivregister.de/api/public/reporting/laendertabelle
1634753708,24992,21410,3582,1479,813,https://www.intensivregister.de/api/public/reporting/laendertabelle
1634760908,24992,21419,3573,1479,814,https://www.intensivregister.de/api/public/reporting/laendertabelle
1634764513,24993,21422,3571,1479,814,https://www.intensivregister.de/api/public/reporting/laendertabelle
1634768108,24993,21421,3572,1478,814,https://www.intensivregister.de/api/public/reporting/laendertabelle
1634771714,24989,21416,3573,1478,814,https://www.intensivregister.de/api/public/reporting/laendertabelle
1634775309,24988,21409,3579,1479,814,https://www.intensivregister.de/api/public/reporting/laendertabelle
1634778915,24990,21417,3573,1479,814,https://www.intensivregister.de/api/public/reporting/laendertabelle
1634782511,24993,21386,3607,1480,815,https://www.intensivregister.de/api/public/reporting/laendertabelle
1634786113,24980,21411,3569,1484,819,https://www.intensivregister.de/api/public/reporting/laendertabelle
1634789719,24983,21485,3498,1512,837,https://www.intensivregister.de/api/public/reporting/laendertabelle
1634793308,24971,21517,3454,1523,841,https://www.intensivregister.de/api/public/reporting/laendertabelle
1634796911,24958,21528,3430,1530,842,https://www.intensivregister.de/api/public/reporting/laendertabelle
1634800514,24922,21510,3412,1540,845,https://www.intensivregister.de/api/public/reporting/laendertabelle
1634804108,24923,21519,3404,1541,847,https://www.intensivregister.de/api/public/reporting/laendertabelle
1634807712,24921,21519,3402,1540,847,https://www.intensivregister.de/api/public/reporting/laendertabelle
1634811315,24923,21522,3401,1539,847,https://www.intensivregister.de/api/public/reporting/laendertabelle
1634814908,24923,21521,3402,1539,847,https://www.intensivregister.de/api/public/reporting/laendertabelle
1634818511,24924,21523,3401,1538,847,https://www.intensivregister.de/api/public/reporting/laendertabelle
1634822115,24924,21522,3402,1536,847,https://www.intensivregister.de/api/public/reporting/laendertabelle
1634825717,24924,21524,3400,1536,847,https://www.intensivregister.de/api/public/reporting/laendertabelle
1634829309,24924,21523,3401,1536,847,https://www.intensivregister.de/api/public/reporting/laendertabelle
1634836513,24952,21544,3408,1536,847,https://www.intensivregister.de/api/public/reporting/laendertabelle
1634847308,24949,21541,3408,1537,847,https://www.intensivregister.de/api/public/reporting/laendertabelle
1634850911,24947,21539,3408,1538,847,https://www.intensivregister.de/api/public/reporting/laendertabelle
1634854514,24947,21536,3411,1538,847,https://www.intensivregister.de/api/public/reporting/laendertabelle
1634858116,24945,21540,3405,1537,846,https://www.intensivregister.de/api/public/reporting/laendertabelle
1634861708,24944,21547,3397,1537,848,https://www.intensivregister.de/api/public/reporting/laendertabelle
1634865312,24944,21544,3400,1539,850,https://www.intensivregister.de/api/public/reporting/laendertabelle
1634868914,24945,21584,3361,1553,852,https://www.intensivregister.de/api/public/reporting/laendertabelle
1634868914,24921,21623,3298,1553,858,https://www.intensivregister.de/api/public/reporting/laendertabelle
1634876112,24884,21580,3304,1556,861,https://www.intensivregister.de/api/public/reporting/laendertabelle
1634876112,24855,21548,3307,1549,863,https://www.intensivregister.de/api/public/reporting/laendertabelle
1634883312,24842,21508,3334,1544,864,https://www.intensivregister.de/api/public/reporting/laendertabelle
1634883312,24844,21489,3355,1541,861,https://www.intensivregister.de/api/public/reporting/laendertabelle
1634890512,24847,21492,3355,1541,863,https://www.intensivregister.de/api/public/reporting/laendertabelle
1634894116,24847,21497,3350,1541,863,https://www.intensivregister.de/api/public/reporting/laendertabelle
1634900137,24847,21496,3351,1543,863,https://www.intensivregister.de/api/public/reporting/laendertabelle
1634900137,24843,21495,3348,1546,862,https://www.intensivregister.de/api/public/reporting/laendertabelle
1634904912,24844,21493,3351,1547,860,https://www.intensivregister.de/api/public/reporting/laendertabelle
1634908516,24841,21487,3354,1549,862,https://www.intensivregister.de/api/public/reporting/laendertabelle
1634912111,24841,21488,3353,1549,862,https://www.intensivregister.de/api/public/reporting/laendertabelle
1634915716,24841,21487,3354,1549,862,https://www.intensivregister.de/api/public/reporting/laendertabelle
1634919310,24840,21486,3354,1549,862,https://www.intensivregister.de/api/public/reporting/laendertabelle
1634922914,24840,21492,3348,1550,861,https://www.intensivregister.de/api/public/reporting/laendertabelle
1634926509,24840,21491,3349,1550,861,https://www.intensivregister.de/api/public/reporting/laendertabelle
1634930113,24832,21487,3345,1551,862,https://www.intensivregister.de/api/public/reporting/laendertabelle
1634937311,24833,21495,3338,1551,862,https://www.intensivregister.de/api/public/reporting/laendertabelle
1634940916,24835,21496,3339,1551,862,https://www.intensivregister.de/api/public/reporting/laendertabelle
1634944509,24835,21495,3340,1551,862,https://www.intensivregister.de/api/public/reporting/laendertabelle
1634948114,24832,21493,3339,1556,862,https://www.intensivregister.de/api/public/reporting/laendertabelle
1634948114,24834,21490,3344,1557,863,https://www.intensivregister.de/api/public/reporting/laendertabelle
1634955312,24833,21477,3356,1556,864,https://www.intensivregister.de/api/public/reporting/laendertabelle
1634958916,24812,21387,3425,1556,866,https://www.intensivregister.de/api/public/reporting/laendertabelle
1634962513,24778,21282,3496,1568,864,https://www.intensivregister.de/api/public/reporting/laendertabelle
1634966115,24706,21172,3534,1590,872,https://www.intensivregister.de/api/public/reporting/laendertabelle
1634969708,24664,21111,3553,1600,875,https://www.intensivregister.de/api/public/reporting/laendertabelle
1634973313,24669,21123,3546,1603,875,https://www.intensivregister.de/api/public/reporting/laendertabelle
1634973313,24665,21116,3549,1609,874,https://www.intensivregister.de/api/public/reporting/laendertabelle
1634980512,24664,21093,3571,1612,875,https://www.intensivregister.de/api/public/reporting/laendertabelle
1634984116,24664,21092,3572,1612,876,https://www.intensivregister.de/api/public/reporting/laendertabelle
1634991316,24666,21092,3574,1613,877,https://www.intensivregister.de/api/public/reporting/laendertabelle
1634994911,24666,21093,3573,1613,877,https://www.intensivregister.de/api/public/reporting/laendertabelle
1634998516,24666,21090,3576,1614,878,https://www.intensivregister.de/api/public/reporting/laendertabelle
1635005716,24666,21086,3580,1613,878,https://www.intensivregister.de/api/public/reporting/laendertabelle
1635009311,24666,21085,3581,1612,878,https://www.intensivregister.de/api/public/reporting/laendertabelle
1635016513,24666,21084,3582,1612,878,https://www.intensivregister.de/api/public/reporting/laendertabelle
1635016513,24665,21078,3587,1615,878,https://www.intensivregister.de/api/public/reporting/laendertabelle
1635023712,24666,21078,3588,1614,878,https://www.intensivregister.de/api/public/reporting/laendertabelle
1635023712,24665,21077,3588,1615,878,https://www.intensivregister.de/api/public/reporting/laendertabelle
1635030912,24667,21080,3587,1614,878,https://www.intensivregister.de/api/public/reporting/laendertabelle
1635030912,24668,21082,3586,1614,878,https://www.intensivregister.de/api/public/reporting/laendertabelle
1635038112,24667,21084,3583,1614,878,https://www.intensivregister.de/api/public/reporting/laendertabelle
1635038112,24666,21083,3583,1620,879,https://www.intensivregister.de/api/public/reporting/laendertabelle
1635045312,24654,21015,3639,1622,885,https://www.intensivregister.de/api/public/reporting/laendertabelle
1635048911,24654,20935,3719,1622,882,https://www.intensivregister.de/api/public/reporting/laendertabelle
1635052512,24603,20886,3717,1624,891,https://www.intensivregister.de/api/public/reporting/laendertabelle
1635056108,24538,20798,3740,1618,888,https://www.intensivregister.de/api/public/reporting/laendertabelle
1635059712,24542,20801,3741,1620,890,https://www.intensivregister.de/api/public/reporting/laendertabelle
1635059712,24535,20801,3734,1623,890,https://www.intensivregister.de/api/public/reporting/laendertabelle
1635066912,24534,20795,3739,1624,891,https://www.intensivregister.de/api/public/reporting/laendertabelle
1635070517,24535,20794,3741,1624,891,https://www.intensivregister.de/api/public/reporting/laendertabelle
1635074111,24531,20779,3752,1625,889,https://www.intensivregister.de/api/public/reporting/laendertabelle
1635077716,24531,20771,3760,1625,889,https://www.intensivregister.de/api/public/reporting/laendertabelle
1635081310,24531,20768,3763,1625,888,https://www.intensivregister.de/api/public/reporting/laendertabelle
1635095709,24531,20775,3756,1625,888,https://www.intensivregister.de/api/public/reporting/laendertabelle
1635099314,24531,20776,3755,1626,888,https://www.intensivregister.de/api/public/reporting/laendertabelle
1635106513,24535,20773,3762,1626,888,https://www.intensivregister.de/api/public/reporting/laendertabelle
1635110108,24535,20772,3763,1627,888,https://www.intensivregister.de/api/public/reporting/laendertabelle
1635113712,24535,20767,3768,1627,888,https://www.intensivregister.de/api/public/reporting/laendertabelle
1635113712,24533,20764,3769,1629,889,https://www.intensivregister.de/api/public/reporting/laendertabelle
1635120912,24535,20765,3770,1628,889,https://www.intensivregister.de/api/public/reporting/laendertabelle
1635124516,24535,20775,3760,1629,889,https://www.intensivregister.de/api/public/reporting/laendertabelle
1635128111,24549,20808,3741,1631,891,https://www.intensivregister.de/api/public/reporting/laendertabelle
1635131716,24598,20887,3711,1647,897,https://www.intensivregister.de/api/public/reporting/laendertabelle
1635135314,24651,20945,3706,1671,893,https://www.intensivregister.de/api/public/reporting/laendertabelle
1635135314,24739,21002,3737,1672,891,https://www.intensivregister.de/api/public/reporting/laendertabelle
1635142512,24812,21062,3750,1681,896,https://www.intensivregister.de/api/public/reporting/laendertabelle
1635142512,24835,21073,3762,1689,904,https://www.intensivregister.de/api/public/reporting/laendertabelle
1635149714,24842,21091,3751,1685,905,https://www.intensivregister.de/api/public/reporting/laendertabelle
1635153310,24840,21094,3746,1686,904,https://www.intensivregister.de/api/public/reporting/laendertabelle
1635156915,24840,21092,3748,1687,905,https://www.intensivregister.de/api/public/reporting/laendertabelle
1635160510,24843,21092,3751,1686,904,https://www.intensivregister.de/api/public/reporting/laendertabelle
1635164117,24847,21088,3759,1687,904,https://www.intensivregister.de/api/public/reporting/laendertabelle
1635167712,24839,21084,3755,1687,904,https://www.intensivregister.de/api/public/reporting/laendertabelle
1635189310,24839,21083,3756,1688,905,https://www.intensivregister.de/api/public/reporting/laendertabelle
1635192914,24815,21061,3754,1681,902,https://www.intensivregister.de/api/public/reporting/laendertabelle
1635196508,24815,21059,3756,1681,902,https://www.intensivregister.de/api/public/reporting/laendertabelle
1635203715,24815,21060,3755,1681,902,https://www.intensivregister.de/api/public/reporting/laendertabelle
1635207311,24822,21067,3755,1681,901,https://www.intensivregister.de/api/public/reporting/laendertabelle
1635210916,24827,21071,3756,1682,902,https://www.intensivregister.de/api/public/reporting/laendertabelle
1635214510,24837,21083,3754,1675,898,https://www.intensivregister.de/api/public/reporting/laendertabelle
1635218115,24849,21211,3638,1681,900,https://www.intensivregister.de/api/public/reporting/laendertabelle
1635221713,24872,21250,3622,1697,896,https://www.intensivregister.de/api/public/reporting/laendertabelle
1635225315,24883,21362,3521,1705,888,https://www.intensivregister.de/api/public/reporting/laendertabelle
1635228912,24884,21377,3507,1696,878,https://www.intensivregister.de/api/public/reporting/laendertabelle
1635232516,24918,21413,3505,1706,884,https://www.intensivregister.de/api/public/reporting/laendertabelle
1635236112,24925,21426,3499,1707,884,https://www.intensivregister.de/api/public/reporting/laendertabelle
1635236112,24927,21434,3493,1708,885,https://www.intensivregister.de/api/public/reporting/laendertabelle
1635243312,24929,21434,3495,1708,884,https://www.intensivregister.de/api/public/reporting/laendertabelle
1635246908,24929,21432,3497,1709,884,https://www.intensivregister.de/api/public/reporting/laendertabelle
1635250513,24931,21437,3494,1709,883,https://www.intensivregister.de/api/public/reporting/laendertabelle
1635254109,24930,21439,3491,1710,883,https://www.intensivregister.de/api/public/reporting/laendertabelle
1635257716,24930,21437,3493,1710,883,https://www.intensivregister.de/api/public/reporting/laendertabelle
1635264915,24930,21436,3494,1710,883,https://www.intensivregister.de/api/public/reporting/laendertabelle
1635272116,24930,21435,3495,1710,884,https://www.intensivregister.de/api/public/reporting/laendertabelle
1635275711,24922,21430,3492,1710,884,https://www.intensivregister.de/api/public/reporting/laendertabelle
1635279316,24922,21432,3490,1709,884,https://www.intensivregister.de/api/public/reporting/laendertabelle
1635282910,24920,21437,3483,1709,884,https://www.intensivregister.de/api/public/reporting/laendertabelle
1635286515,24920,21435,3485,1709,885,https://www.intensivregister.de/api/public/reporting/laendertabelle
1635290109,24919,21433,3486,1709,886,https://www.intensivregister.de/api/public/reporting/laendertabelle
1635293709,24925,21435,3490,1709,885,https://www.intensivregister.de/api/public/reporting/laendertabelle
1635300911,24915,21486,3429,1722,890,https://www.intensivregister.de/api/public/reporting/laendertabelle
1635304513,24921,21529,3392,1732,891,https://www.intensivregister.de/api/public/reporting/laendertabelle
1635308119,24935,21552,3383,1749,907,https://www.intensivregister.de/api/public/reporting/laendertabelle
1635311716,24916,21596,3320,1764,910,https://www.intensivregister.de/api/public/reporting/laendertabelle
1635315309,24900,21623,3277,1762,912,https://www.intensivregister.de/api/public/reporting/laendertabelle
1635318910,24903,21645,3258,1766,917,https://www.intensivregister.de/api/public/reporting/laendertabelle
1635322512,24880,21612,3268,1772,918,https://www.intensivregister.de/api/public/reporting/laendertabelle
1635326114,24880,21620,3260,1775,920,https://www.intensivregister.de/api/public/reporting/laendertabelle
1635329716,24881,21630,3251,1775,922,https://www.intensivregister.de/api/public/reporting/laendertabelle
1635333308,24880,21631,3249,1775,922,https://www.intensivregister.de/api/public/reporting/laendertabelle
1635336909,24883,21633,3250,1777,923,https://www.intensivregister.de/api/public/reporting/laendertabelle
1635340511,24883,21631,3252,1777,924,https://www.intensivregister.de/api/public/reporting/laendertabelle
1635344113,24883,21633,3250,1777,924,https://www.intensivregister.de/api/public/reporting/laendertabelle
1635351315,24883,21636,3247,1779,924,https://www.intensivregister.de/api/public/reporting/laendertabelle
1635354917,24876,21638,3238,1780,924,https://www.intensivregister.de/api/public/reporting/laendertabelle
1635365710,24874,21635,3239,1779,924,https://www.intensivregister.de/api/public/reporting/laendertabelle
1635369310,24872,21630,3242,1778,922,https://www.intensivregister.de/api/public/reporting/laendertabelle
1635372911,24873,21628,3245,1778,921,https://www.intensivregister.de/api/public/reporting/laendertabelle
1635376513,24873,21623,3250,1778,922,https://www.intensivregister.de/api/public/reporting/laendertabelle
1635380114,24867,21628,3239,1780,923,https://www.intensivregister.de/api/public/reporting/laendertabelle
1635383716,24865,21621,3244,1780,922,https://www.intensivregister.de/api/public/reporting/laendertabelle
1635390908,24862,21599,3263,1788,916,https://www.intensivregister.de/api/public/reporting/laendertabelle
1635394513,24820,21538,3282,1799,922,https://www.intensivregister.de/api/public/reporting/laendertabelle
1635398111,24829,21519,3310,1809,922,https://www.intensivregister.de/api/public/reporting/laendertabelle
1635401713,24819,21518,3301,1808,927,https://www.intensivregister.de/api/public/reporting/laendertabelle
1635405313,24822,21503,3319,1806,930,https://www.intensivregister.de/api/public/reporting/laendertabelle
1635408917,24819,21506,3313,1813,929,https://www.intensivregister.de/api/public/reporting/laendertabelle
1635412519,24820,21509,3311,1816,929,https://www.intensivregister.de/api/public/reporting/laendertabelle
1635416117,24820,21503,3317,1817,929,https://www.intensivregister.de/api/public/reporting/laendertabelle
1635419709,24823,21504,3319,1817,929,https://www.intensivregister.de/api/public/reporting/laendertabelle
1635423311,24825,21505,3320,1818,930,https://www.intensivregister.de/api/public/reporting/laendertabelle
1635426914,24824,21506,3318,1818,930,https://www.intensivregister.de/api/public/reporting/laendertabelle
1635430514,24824,21508,3316,1816,930,https://www.intensivregister.de/api/public/reporting/laendertabelle
1635434116,24824,21507,3317,1816,930,https://www.intensivregister.de/api/public/reporting/laendertabelle
1635437715,24824,21506,3318,1817,931,https://www.intensivregister.de/api/public/reporting/laendertabelle
1635441316,24824,21504,3320,1816,931,https://www.intensivregister.de/api/public/reporting/laendertabelle
1635455718,24830,21509,3321,1815,928,https://www.intensivregister.de/api/public/reporting/laendertabelle
1635488112,24762,21495,3267,1863,957,https://www.intensivregister.de/api/public/reporting/laendertabelle
1635491710,24727,21483,3244,1867,963,https://www.intensivregister.de/api/public/reporting/laendertabelle
1635512412,24728,21471,3257,1869,963,https://www.intensivregister.de/api/public/reporting/laendertabelle
1635516012,24728,21467,3261,1868,963,https://www.intensivregister.de/api/public/reporting/laendertabelle
1635519610,24729,21463,3266,1868,963,https://www.intensivregister.de/api/public/reporting/laendertabelle
1635523210,24727,21465,3262,1868,964,https://www.intensivregister.de/api/public/reporting/laendertabelle
1635526809,24727,21463,3264,1871,964,https://www.intensivregister.de/api/public/reporting/laendertabelle
1635534017,24727,21463,3264,1870,964,https://www.intensivregister.de/api/public/reporting/laendertabelle
1635541214,24717,21439,3278,1871,964,https://www.intensivregister.de/api/public/reporting/laendertabelle
1635544814,24716,21438,3278,1871,964,https://www.intensivregister.de/api/public/reporting/laendertabelle
1635548413,24717,21433,3284,1871,964,https://www.intensivregister.de/api/public/reporting/laendertabelle
1635552011,24717,21436,3281,1871,965,https://www.intensivregister.de/api/public/reporting/laendertabelle
1635555610,24718,21427,3291,1869,964,https://www.intensivregister.de/api/public/reporting/laendertabelle
1635559210,24719,21417,3302,1870,964,https://www.intensivregister.de/api/public/reporting/laendertabelle
1635562809,24715,21410,3305,1869,964,https://www.intensivregister.de/api/public/reporting/laendertabelle
1635566114,24689,21367,3322,1877,967,https://www.intensivregister.de/api/public/reporting/laendertabelle
1635569714,24649,21274,3375,1886,968,https://www.intensivregister.de/api/public/reporting/laendertabelle
1635573615,24608,21237,3371,1908,982,https://www.intensivregister.de/api/public/reporting/laendertabelle
1635577215,24591,21218,3373,1922,982,https://www.intensivregister.de/api/public/reporting/laendertabelle
1635580814,24580,21154,3426,1928,984,https://www.intensivregister.de/api/public/reporting/laendertabelle
1635584413,24578,21134,3444,1939,990,https://www.intensivregister.de/api/public/reporting/laendertabelle
1635588013,24578,21133,3445,1939,991,https://www.intensivregister.de/api/public/reporting/laendertabelle
1635591612,24582,21129,3453,1940,991,https://www.intensivregister.de/api/public/reporting/laendertabelle
1635595211,24582,21125,3457,1940,991,https://www.intensivregister.de/api/public/reporting/laendertabelle
1635598810,24582,21127,3455,1939,990,https://www.intensivregister.de/api/public/reporting/laendertabelle
1635602410,24581,21127,3454,1937,990,https://www.intensivregister.de/api/public/reporting/laendertabelle
1635609613,24581,21132,3449,1937,991,https://www.intensivregister.de/api/public/reporting/laendertabelle
1635613213,24578,21128,3450,1937,990,https://www.intensivregister.de/api/public/reporting/laendertabelle
1635616814,24577,21128,3449,1937,990,https://www.intensivregister.de/api/public/reporting/laendertabelle
1635624014,24577,21127,3450,1937,990,https://www.intensivregister.de/api/public/reporting/laendertabelle
1635627615,24575,21116,3459,1936,990,https://www.intensivregister.de/api/public/reporting/laendertabelle
1635630912,24575,21118,3457,1936,990,https://www.intensivregister.de/api/public/reporting/laendertabelle
1635634815,24575,21119,3456,1937,990,https://www.intensivregister.de/api/public/reporting/laendertabelle
1635642015,24572,21113,3459,1938,990,https://www.intensivregister.de/api/public/reporting/laendertabelle
1635645617,24562,21107,3455,1938,990,https://www.intensivregister.de/api/public/reporting/laendertabelle
1635649216,24561,21101,3460,1938,991,https://www.intensivregister.de/api/public/reporting/laendertabelle
1635652808,24562,21099,3463,1941,993,https://www.intensivregister.de/api/public/reporting/laendertabelle
1635656410,24570,21082,3488,1944,992,https://www.intensivregister.de/api/public/reporting/laendertabelle
1635660012,24552,21040,3512,1947,1001,https://www.intensivregister.de/api/public/reporting/laendertabelle
1635663615,24549,20985,3564,1971,1015,https://www.intensivregister.de/api/public/reporting/laendertabelle
1635667216,24544,20909,3635,1980,1012,https://www.intensivregister.de/api/public/reporting/laendertabelle
1635670809,24533,20883,3650,1979,1010,https://www.intensivregister.de/api/public/reporting/laendertabelle
1635674411,24517,20863,3654,1984,1012,https://www.intensivregister.de/api/public/reporting/laendertabelle
1635677710,24517,20867,3650,1984,1012,https://www.intensivregister.de/api/public/reporting/laendertabelle
1635681313,24515,20859,3656,1983,1013,https://www.intensivregister.de/api/public/reporting/laendertabelle
1635685210,24517,20859,3658,1983,1014,https://www.intensivregister.de/api/public/reporting/laendertabelle
1635688813,24517,20865,3652,1983,1013,https://www.intensivregister.de/api/public/reporting/laendertabelle
1635692415,24517,20869,3648,1983,1012,https://www.intensivregister.de/api/public/reporting/laendertabelle
1635699611,24517,20871,3646,1984,1012,https://www.intensivregister.de/api/public/reporting/laendertabelle
1635706816,24517,20870,3647,1984,1012,https://www.intensivregister.de/api/public/reporting/laendertabelle
1635710408,24517,20870,3647,1986,1012,https://www.intensivregister.de/api/public/reporting/laendertabelle
1635721214,24520,20874,3646,1987,1012,https://www.intensivregister.de/api/public/reporting/laendertabelle
1635724513,24518,20873,3645,1987,1013,https://www.intensivregister.de/api/public/reporting/laendertabelle
1635728115,24518,20873,3645,1989,1013,https://www.intensivregister.de/api/public/reporting/laendertabelle
1635732011,24515,20881,3634,1988,1013,https://www.intensivregister.de/api/public/reporting/laendertabelle
1635735610,24515,20882,3633,1988,1013,https://www.intensivregister.de/api/public/reporting/laendertabelle
1635738910,24512,20874,3638,1988,1011,https://www.intensivregister.de/api/public/reporting/laendertabelle
1635742815,24536,20883,3653,1997,1013,https://www.intensivregister.de/api/public/reporting/laendertabelle
1635746408,24572,20893,3679,2003,1026,https://www.intensivregister.de/api/public/reporting/laendertabelle
1635750012,24619,20963,3656,2023,1038,https://www.intensivregister.de/api/public/reporting/laendertabelle
1635753608,24685,21040,3645,2040,1050,https://www.intensivregister.de/api/public/reporting/laendertabelle
1635757212,24714,21053,3661,2053,1053,https://www.intensivregister.de/api/public/reporting/laendertabelle
1635760815,24709,21062,3647,2055,1059,https://www.intensivregister.de/api/public/reporting/laendertabelle
1635764409,24757,21103,3654,2060,1062,https://www.intensivregister.de/api/public/reporting/laendertabelle
1635768012,24749,21097,3652,2060,1062,https://www.intensivregister.de/api/public/reporting/laendertabelle
1635771616,24751,21102,3649,2060,1063,https://www.intensivregister.de/api/public/reporting/laendertabelle
1635775209,24751,21106,3645,2062,1063,https://www.intensivregister.de/api/public/reporting/laendertabelle
1635778813,24753,21103,3650,2063,1063,https://www.intensivregister.de/api/public/reporting/laendertabelle
1635782416,24753,21103,3650,2064,1063,https://www.intensivregister.de/api/public/reporting/laendertabelle
1635785716,24752,21103,3649,2065,1064,https://www.intensivregister.de/api/public/reporting/laendertabelle
1635789309,24752,21100,3652,2065,1064,https://www.intensivregister.de/api/public/reporting/laendertabelle
1635793214,24754,21100,3654,2065,1064,https://www.intensivregister.de/api/public/reporting/laendertabelle
1635800409,24754,21100,3654,2067,1064,https://www.intensivregister.de/api/public/reporting/laendertabelle
1635807615,24752,21092,3660,2066,1065,https://www.intensivregister.de/api/public/reporting/laendertabelle
1635810914,24750,21098,3652,2067,1066,https://www.intensivregister.de/api/public/reporting/laendertabelle
1635814810,24748,21095,3653,2067,1067,https://www.intensivregister.de/api/public/reporting/laendertabelle
1635818413,24746,21088,3658,2065,1067,https://www.intensivregister.de/api/public/reporting/laendertabelle
1635822014,24747,21085,3662,2066,1067,https://www.intensivregister.de/api/public/reporting/laendertabelle
1635825314,24780,21128,3652,2072,1068,https://www.intensivregister.de/api/public/reporting/laendertabelle
1635829210,24783,21188,3595,2067,1072,https://www.intensivregister.de/api/public/reporting/laendertabelle
1635832812,24824,21278,3546,2088,1083,https://www.intensivregister.de/api/public/reporting/laendertabelle
1635836414,24869,21421,3448,2095,1088,https://www.intensivregister.de/api/public/reporting/laendertabelle
1635839715,24889,21476,3413,2105,1100,https://www.intensivregister.de/api/public/reporting/laendertabelle
1635843611,24905,21518,3387,2127,1115,https://www.intensivregister.de/api/public/reporting/laendertabelle
1635847214,24923,21510,3413,2133,1120,https://www.intensivregister.de/api/public/reporting/laendertabelle
1635850816,24915,21507,3408,2140,1120,https://www.intensivregister.de/api/public/reporting/laendertabelle
1635854410,24936,21532,3404,2145,1122,https://www.intensivregister.de/api/public/reporting/laendertabelle
1635857710,24936,21528,3408,2144,1120,https://www.intensivregister.de/api/public/reporting/laendertabelle
1635861616,24936,21528,3408,2146,1122,https://www.intensivregister.de/api/public/reporting/laendertabelle
1635865209,24935,21523,3412,2146,1122,https://www.intensivregister.de/api/public/reporting/laendertabelle
1635868812,24938,21527,3411,2146,1122,https://www.intensivregister.de/api/public/reporting/laendertabelle
1635879610,24938,21530,3408,2146,1122,https://www.intensivregister.de/api/public/reporting/laendertabelle
1635890410,24940,21533,3407,2146,1122,https://www.intensivregister.de/api/public/reporting/laendertabelle
1635894015,24945,21543,3402,2147,1123,https://www.intensivregister.de/api/public/reporting/laendertabelle
1635897608,24943,21545,3398,2147,1124,https://www.intensivregister.de/api/public/reporting/laendertabelle
1635900909,24944,21545,3399,2146,1123,https://www.intensivregister.de/api/public/reporting/laendertabelle
1635904514,24943,21550,3393,2150,1126,https://www.intensivregister.de/api/public/reporting/laendertabelle
1635908411,24942,21553,3389,2152,1127,https://www.intensivregister.de/api/public/reporting/laendertabelle
1635911711,24948,21547,3401,2153,1126,https://www.intensivregister.de/api/public/reporting/laendertabelle
1635915609,24977,21577,3400,2173,1138,https://www.intensivregister.de/api/public/reporting/laendertabelle
1635919213,24981,21617,3364,2181,1147,https://www.intensivregister.de/api/public/reporting/laendertabelle
1635922514,24992,21687,3305,2199,1158,https://www.intensivregister.de/api/public/reporting/laendertabelle
1635926109,25028,21761,3267,2221,1168,https://www.intensivregister.de/api/public/reporting/laendertabelle
1635930011,25056,21784,3272,2226,1169,https://www.intensivregister.de/api/public/reporting/laendertabelle
1635933612,25058,21791,3267,2223,1171,https://www.intensivregister.de/api/public/reporting/laendertabelle
1635937216,25053,21791,3262,2229,1173,https://www.intensivregister.de/api/public/reporting/laendertabelle
1635940811,25052,21794,3258,2231,1173,https://www.intensivregister.de/api/public/reporting/laendertabelle
1635944415,25054,21805,3249,2235,1172,https://www.intensivregister.de/api/public/reporting/laendertabelle
1635948010,25054,21812,3242,2239,1173,https://www.intensivregister.de/api/public/reporting/laendertabelle
1635951615,25054,21814,3240,2240,1173,https://www.intensivregister.de/api/public/reporting/laendertabelle
1635955210,25054,21814,3240,2241,1174,https://www.intensivregister.de/api/public/reporting/laendertabelle
1635958814,25054,21815,3239,2244,1175,https://www.intensivregister.de/api/public/reporting/laendertabelle
1635962408,25054,21817,3237,2245,1175,https://www.intensivregister.de/api/public/reporting/laendertabelle
1635966013,25054,21818,3236,2244,1175,https://www.intensivregister.de/api/public/reporting/laendertabelle
1635969609,25054,21818,3236,2246,1177,https://www.intensivregister.de/api/public/reporting/laendertabelle
1635980410,25048,21811,3237,2250,1177,https://www.intensivregister.de/api/public/reporting/laendertabelle
1635984015,25049,21813,3236,2250,1177,https://www.intensivregister.de/api/public/reporting/laendertabelle
1635987609,25049,21807,3242,2248,1177,https://www.intensivregister.de/api/public/reporting/laendertabelle
1635991213,25052,21809,3243,2247,1174,https://www.intensivregister.de/api/public/reporting/laendertabelle
1635994515,25053,21811,3242,2248,1173,https://www.intensivregister.de/api/public/reporting/laendertabelle
1635998412,25053,21819,3234,2250,1175,https://www.intensivregister.de/api/public/reporting/laendertabelle
1636001714,25060,21796,3264,2253,1177,https://www.intensivregister.de/api/public/reporting/laendertabelle
1636005612,25084,21819,3265,2271,1186,https://www.intensivregister.de/api/public/reporting/laendertabelle
1636009217,25082,21819,3263,2310,1196,https://www.intensivregister.de/api/public/reporting/laendertabelle
1636012812,25082,21840,3242,2322,1197,https://www.intensivregister.de/api/public/reporting/laendertabelle
1636016115,25090,21877,3213,2322,1207,https://www.intensivregister.de/api/public/reporting/laendertabelle
1636020013,25073,21848,3225,2329,1210,https://www.intensivregister.de/api/public/reporting/laendertabelle
1636023608,25074,21858,3216,2333,1214,https://www.intensivregister.de/api/public/reporting/laendertabelle
1636027217,25077,21863,3214,2332,1214,https://www.intensivregister.de/api/public/reporting/laendertabelle
1636030809,25075,21862,3213,2333,1216,https://www.intensivregister.de/api/public/reporting/laendertabelle
1636034112,25075,21859,3216,2335,1217,https://www.intensivregister.de/api/public/reporting/laendertabelle
1636038010,25075,21856,3219,2335,1218,https://www.intensivregister.de/api/public/reporting/laendertabelle
1636041313,25075,21859,3216,2335,1218,https://www.intensivregister.de/api/public/reporting/laendertabelle
1636048816,25071,21856,3215,2335,1218,https://www.intensivregister.de/api/public/reporting/laendertabelle
1636052411,25071,21855,3216,2335,1219,https://www.intensivregister.de/api/public/reporting/laendertabelle
1636056015,25072,21849,3223,2334,1220,https://www.intensivregister.de/api/public/reporting/laendertabelle
1636066810,25072,21849,3223,2333,1220,https://www.intensivregister.de/api/public/reporting/laendertabelle
1636070415,25071,21849,3222,2331,1220,https://www.intensivregister.de/api/public/reporting/laendertabelle
1636074010,25068,21845,3223,2330,1219,https://www.intensivregister.de/api/public/reporting/laendertabelle
1636077615,25065,21835,3230,2329,1220,https://www.intensivregister.de/api/public/reporting/laendertabelle
1636081208,25066,21829,3237,2330,1220,https://www.intensivregister.de/api/public/reporting/laendertabelle
1636084813,25066,21833,3233,2329,1219,https://www.intensivregister.de/api/public/reporting/laendertabelle
1636088408,25031,21818,3213,2340,1220,https://www.intensivregister.de/api/public/reporting/laendertabelle
1636092014,25002,21801,3201,2358,1231,https://www.intensivregister.de/api/public/reporting/laendertabelle
1636095608,24985,21788,3197,2369,1236,https://www.intensivregister.de/api/public/reporting/laendertabelle
1636098910,24932,21750,3182,2396,1250,https://www.intensivregister.de/api/public/reporting/laendertabelle
1636102809,24908,21743,3165,2401,1251,https://www.intensivregister.de/api/public/reporting/laendertabelle
1636106414,24907,21755,3152,2420,1258,https://www.intensivregister.de/api/public/reporting/laendertabelle
1636110009,24903,21755,3148,2415,1261,https://www.intensivregister.de/api/public/reporting/laendertabelle
1636113614,24900,21751,3149,2421,1263,https://www.intensivregister.de/api/public/reporting/laendertabelle
1636117210,24899,21753,3146,2421,1263,https://www.intensivregister.de/api/public/reporting/laendertabelle
1636120814,24886,21747,3139,2420,1264,https://www.intensivregister.de/api/public/reporting/laendertabelle
1636124410,24883,21741,3142,2421,1264,https://www.intensivregister.de/api/public/reporting/laendertabelle
1636128015,24883,21741,3142,2424,1265,https://www.intensivregister.de/api/public/reporting/laendertabelle
1636131609,24876,21737,3139,2429,1265,https://www.intensivregister.de/api/public/reporting/laendertabelle
1636135214,24874,21737,3137,2429,1265,https://www.intensivregister.de/api/public/reporting/laendertabelle
1636138809,24874,21738,3136,2430,1266,https://www.intensivregister.de/api/public/reporting/laendertabelle
1636152914,24876,21742,3134,2431,1266,https://www.intensivregister.de/api/public/reporting/laendertabelle
1636156811,24876,21741,3135,2430,1266,https://www.intensivregister.de/api/public/reporting/laendertabelle
1636160417,24874,21744,3130,2432,1266,https://www.intensivregister.de/api/public/reporting/laendertabelle
1636164012,24872,21744,3128,2433,1266,https://www.intensivregister.de/api/public/reporting/laendertabelle
1636167314,24871,21737,3134,2433,1267,https://www.intensivregister.de/api/public/reporting/laendertabelle
1636171212,24871,21735,3136,2436,1270,https://www.intensivregister.de/api/public/reporting/laendertabelle
1636174816,24863,21703,3160,2438,1262,https://www.intensivregister.de/api/public/reporting/laendertabelle
1636178412,24843,21626,3217,2434,1265,https://www.intensivregister.de/api/public/reporting/laendertabelle
1636182016,24775,21492,3283,2454,1266,https://www.intensivregister.de/api/public/reporting/laendertabelle
1636185308,24755,21456,3299,2447,1252,https://www.intensivregister.de/api/public/reporting/laendertabelle
1636189216,24709,21375,3334,2452,1256,https://www.intensivregister.de/api/public/reporting/laendertabelle
1636192810,24699,21342,3357,2451,1254,https://www.intensivregister.de/api/public/reporting/laendertabelle
1636196415,24703,21335,3368,2450,1254,https://www.intensivregister.de/api/public/reporting/laendertabelle
1636200010,24701,21324,3377,2454,1249,https://www.intensivregister.de/api/public/reporting/laendertabelle
1636203614,24703,21318,3385,2450,1244,https://www.intensivregister.de/api/public/reporting/laendertabelle
1636207210,24702,21321,3381,2452,1247,https://www.intensivregister.de/api/public/reporting/laendertabelle
1636210511,24702,21322,3380,2452,1246,https://www.intensivregister.de/api/public/reporting/laendertabelle
1636214409,24702,21321,3381,2453,1247,https://www.intensivregister.de/api/public/reporting/laendertabelle
1636218014,24702,21320,3382,2452,1247,https://www.intensivregister.de/api/public/reporting/laendertabelle
1636221608,24702,21318,3384,2450,1247,https://www.intensivregister.de/api/public/reporting/laendertabelle
1636228808,24702,21319,3383,2451,1248,https://www.intensivregister.de/api/public/reporting/laendertabelle
1636232413,24702,21319,3383,2452,1248,https://www.intensivregister.de/api/public/reporting/laendertabelle
1636235715,24702,21318,3384,2452,1248,https://www.intensivregister.de/api/public/reporting/laendertabelle
1636239613,24705,21313,3392,2452,1250,https://www.intensivregister.de/api/public/reporting/laendertabelle
1636242914,24700,21308,3392,2454,1251,https://www.intensivregister.de/api/public/reporting/laendertabelle
1636250408,24700,21309,3391,2453,1251,https://www.intensivregister.de/api/public/reporting/laendertabelle
1636253714,24701,21299,3402,2451,1250,https://www.intensivregister.de/api/public/reporting/laendertabelle
1636257611,24705,21303,3402,2451,1251,https://www.intensivregister.de/api/public/reporting/laendertabelle
1636260912,24706,21303,3403,2457,1253,https://www.intensivregister.de/api/public/reporting/laendertabelle
1636264810,24710,21270,3440,2470,1253,https://www.intensivregister.de/api/public/reporting/laendertabelle
1636268414,24697,21230,3467,2494,1262,https://www.intensivregister.de/api/public/reporting/laendertabelle
1636272008,24671,21173,3498,2516,1263,https://www.intensivregister.de/api/public/reporting/laendertabelle
1636275613,24674,21147,3527,2526,1271,https://www.intensivregister.de/api/public/reporting/laendertabelle
1636278914,24651,21123,3528,2529,1278,https://www.intensivregister.de/api/public/reporting/laendertabelle
1636282812,24643,21123,3520,2532,1278,https://www.intensivregister.de/api/public/reporting/laendertabelle
1636286417,24628,21111,3517,2530,1277,https://www.intensivregister.de/api/public/reporting/laendertabelle
1636290011,24628,21111,3517,2529,1276,https://www.intensivregister.de/api/public/reporting/laendertabelle
1636293616,24730,21112,3618,2528,1276,https://www.intensivregister.de/api/public/reporting/laendertabelle
1636297211,24731,21116,3615,2528,1276,https://www.intensivregister.de/api/public/reporting/laendertabelle
1636300513,24730,21116,3614,2528,1276,https://www.intensivregister.de/api/public/reporting/laendertabelle
1636304415,24730,21118,3612,2528,1276,https://www.intensivregister.de/api/public/reporting/laendertabelle
1636308016,24725,21113,3612,2530,1276,https://www.intensivregister.de/api/public/reporting/laendertabelle
1636311612,24725,21114,3611,2530,1276,https://www.intensivregister.de/api/public/reporting/laendertabelle
1636315216,24725,21116,3609,2532,1277,https://www.intensivregister.de/api/public/reporting/laendertabelle
1636318811,24725,21114,3611,2530,1276,https://www.intensivregister.de/api/public/reporting/laendertabelle
1636322416,24726,21112,3614,2530,1276,https://www.intensivregister.de/api/public/reporting/laendertabelle
1636326011,24725,21112,3613,2531,1276,https://www.intensivregister.de/api/public/reporting/laendertabelle
1636329616,24725,21111,3614,2532,1276,https://www.intensivregister.de/api/public/reporting/laendertabelle
1636333212,24724,21110,3614,2532,1277,https://www.intensivregister.de/api/public/reporting/laendertabelle
1636336813,24723,21112,3611,2532,1280,https://www.intensivregister.de/api/public/reporting/laendertabelle
1636340408,24722,21121,3601,2534,1280,https://www.intensivregister.de/api/public/reporting/laendertabelle
1636344012,24724,21121,3603,2534,1281,https://www.intensivregister.de/api/public/reporting/laendertabelle
1636347315,24669,21122,3547,2548,1285,https://www.intensivregister.de/api/public/reporting/laendertabelle
1636351212,24696,21144,3552,2560,1289,https://www.intensivregister.de/api/public/reporting/laendertabelle
1636354808,24779,21185,3594,2567,1291,https://www.intensivregister.de/api/public/reporting/laendertabelle
1636358413,24843,21224,3619,2585,1297,https://www.intensivregister.de/api/public/reporting/laendertabelle
1636361716,24877,21236,3641,2603,1304,https://www.intensivregister.de/api/public/reporting/laendertabelle
1636365311,24899,21267,3632,2615,1306,https://www.intensivregister.de/api/public/reporting/laendertabelle
1636369209,24850,21224,3626,2618,1306,https://www.intensivregister.de/api/public/reporting/laendertabelle
1636372512,24853,21227,3626,2617,1307,https://www.intensivregister.de/api/public/reporting/laendertabelle
1636376409,24853,21236,3617,2619,1307,https://www.intensivregister.de/api/public/reporting/laendertabelle
1636380014,24852,21234,3618,2619,1307,https://www.intensivregister.de/api/public/reporting/laendertabelle
1636383609,24853,21229,3624,2625,1309,https://www.intensivregister.de/api/public/reporting/laendertabelle
1636387214,24853,21223,3630,2625,1310,https://www.intensivregister.de/api/public/reporting/laendertabelle
1636390809,24853,21224,3629,2628,1312,https://www.intensivregister.de/api/public/reporting/laendertabelle
1636401613,24853,21224,3629,2629,1313,https://www.intensivregister.de/api/public/reporting/laendertabelle
1636405209,24853,21225,3628,2631,1314,https://www.intensivregister.de/api/public/reporting/laendertabelle
1636412115,24853,21227,3626,2633,1314,https://www.intensivregister.de/api/public/reporting/laendertabelle
1636416012,24856,21230,3626,2633,1315,https://www.intensivregister.de/api/public/reporting/laendertabelle
1636419616,24856,21226,3630,2634,1315,https://www.intensivregister.de/api/public/reporting/laendertabelle
1636423212,24855,21228,3627,2635,1314,https://www.intensivregister.de/api/public/reporting/laendertabelle
1636426817,24859,21234,3625,2637,1315,https://www.intensivregister.de/api/public/reporting/laendertabelle
1636430412,24861,21236,3625,2636,1313,https://www.intensivregister.de/api/public/reporting/laendertabelle
1636434016,24888,21310,3578,2637,1322,https://www.intensivregister.de/api/public/reporting/laendertabelle
1636437309,24858,21354,3504,2642,1331,https://www.intensivregister.de/api/public/reporting/laendertabelle
1636441217,24858,21473,3385,2656,1356,https://www.intensivregister.de/api/public/reporting/laendertabelle
1636444812,24840,21509,3331,2675,1370,https://www.intensivregister.de/api/public/reporting/laendertabelle
1636448116,24843,21555,3288,2690,1372,https://www.intensivregister.de/api/public/reporting/laendertabelle
1636452014,24886,21613,3273,2686,1373,https://www.intensivregister.de/api/public/reporting/laendertabelle
1636455309,24883,21621,3262,2685,1373,https://www.intensivregister.de/api/public/reporting/laendertabelle
1636459217,24889,21621,3268,2684,1372,https://www.intensivregister.de/api/public/reporting/laendertabelle
1636462812,24894,21624,3270,2681,1372,https://www.intensivregister.de/api/public/reporting/laendertabelle
1636466408,24894,21621,3273,2681,1371,https://www.intensivregister.de/api/public/reporting/laendertabelle
1636470013,24895,21621,3274,2682,1371,https://www.intensivregister.de/api/public/reporting/laendertabelle
1636473315,24917,21649,3268,2684,1372,https://www.intensivregister.de/api/public/reporting/laendertabelle
1636476911,24915,21643,3272,2685,1373,https://www.intensivregister.de/api/public/reporting/laendertabelle
1636484413,24915,21642,3273,2685,1372,https://www.intensivregister.de/api/public/reporting/laendertabelle
1636488009,24916,21650,3266,2686,1373,https://www.intensivregister.de/api/public/reporting/laendertabelle
1636491310,24916,21649,3267,2687,1373,https://www.intensivregister.de/api/public/reporting/laendertabelle
1636498812,24914,21646,3268,2686,1373,https://www.intensivregister.de/api/public/reporting/laendertabelle
1636502416,24914,21650,3264,2684,1374,https://www.intensivregister.de/api/public/reporting/laendertabelle
1636506012,24912,21649,3263,2685,1373,https://www.intensivregister.de/api/public/reporting/laendertabelle
1636509616,24909,21644,3265,2685,1373,https://www.intensivregister.de/api/public/reporting/laendertabelle
1636513216,24885,21629,3256,2685,1373,https://www.intensivregister.de/api/public/reporting/laendertabelle
1636516811,24885,21625,3260,2679,1366,https://www.intensivregister.de/api/public/reporting/laendertabelle
1636520416,24885,21615,3270,2698,1371,https://www.intensivregister.de/api/public/reporting/laendertabelle
1636524011,24906,21688,3218,2716,1369,https://www.intensivregister.de/api/public/reporting/laendertabelle
1636527315,24913,21687,3226,2722,1381,https://www.intensivregister.de/api/public/reporting/laendertabelle
1636531212,24920,21730,3190,2738,1396,https://www.intensivregister.de/api/public/reporting/laendertabelle
1636534515,24901,21748,3153,2734,1396,https://www.intensivregister.de/api/public/reporting/laendertabelle
1636538412,24954,21788,3166,2738,1402,https://www.intensivregister.de/api/public/reporting/laendertabelle
1636541715,24956,21789,3167,2742,1405,https://www.intensivregister.de/api/public/reporting/laendertabelle
1636545612,24955,21784,3171,2740,1402,https://www.intensivregister.de/api/public/reporting/laendertabelle
1636549216,24955,21780,3175,2742,1403,https://www.intensivregister.de/api/public/reporting/laendertabelle
1636552508,24955,21783,3172,2743,1403,https://www.intensivregister.de/api/public/reporting/laendertabelle
1636556415,24955,21785,3170,2746,1402,https://www.intensivregister.de/api/public/reporting/laendertabelle
1636560010,24954,21785,3169,2744,1402,https://www.intensivregister.de/api/public/reporting/laendertabelle
1636563614,24954,21786,3168,2744,1402,https://www.intensivregister.de/api/public/reporting/laendertabelle
1636567210,24954,21787,3167,2744,1402,https://www.intensivregister.de/api/public/reporting/laendertabelle
1636570815,24954,21785,3169,2744,1402,https://www.intensivregister.de/api/public/reporting/laendertabelle
1636577712,24954,21785,3169,2746,1402,https://www.intensivregister.de/api/public/reporting/laendertabelle
1636584913,24949,21777,3172,2749,1403,https://www.intensivregister.de/api/public/reporting/laendertabelle
1636588810,24949,21775,3174,2751,1403,https://www.intensivregister.de/api/public/reporting/laendertabelle
1636592112,24953,21777,3176,2751,1403,https://www.intensivregister.de/api/public/reporting/laendertabelle
1636596009,24951,21772,3179,2751,1404,https://www.intensivregister.de/api/public/reporting/laendertabelle
1636599615,24949,21771,3178,2755,1403,https://www.intensivregister.de/api/public/reporting/laendertabelle
1636603210,24951,21771,3180,2760,1405,https://www.intensivregister.de/api/public/reporting/laendertabelle
1636606513,24949,21779,3170,2755,1407,https://www.intensivregister.de/api/public/reporting/laendertabelle
1636610108,24944,21738,3206,2753,1404,https://www.intensivregister.de/api/public/reporting/laendertabelle
1636614015,24925,21670,3255,2802,1424,https://www.intensivregister.de/api/public/reporting/laendertabelle
1636617610,24925,21662,3263,2811,1424,https://www.intensivregister.de/api/public/reporting/laendertabelle
1636621215,24893,21660,3233,2831,1436,https://www.intensivregister.de/api/public/reporting/laendertabelle
1636624811,24885,21663,3222,2828,1439,https://www.intensivregister.de/api/public/reporting/laendertabelle
1636628114,24907,21683,3224,2829,1441,https://www.intensivregister.de/api/public/reporting/laendertabelle
1636632012,24905,21677,3228,2829,1441,https://www.intensivregister.de/api/public/reporting/laendertabelle
1636635315,24902,21675,3227,2831,1441,https://www.intensivregister.de/api/public/reporting/laendertabelle
1636639212,24902,21676,3226,2830,1441,https://www.intensivregister.de/api/public/reporting/laendertabelle
1636642515,24902,21675,3227,2830,1441,https://www.intensivregister.de/api/public/reporting/laendertabelle
1636646413,24903,21676,3227,2831,1441,https://www.intensivregister.de/api/public/reporting/laendertabelle
1636650009,24903,21674,3229,2831,1441,https://www.intensivregister.de/api/public/reporting/laendertabelle
1636653612,24903,21677,3226,2830,1440,https://www.intensivregister.de/api/public/reporting/laendertabelle
1636656916,24903,21672,3231,2830,1439,https://www.intensivregister.de/api/public/reporting/laendertabelle
1636671608,24901,21673,3228,2830,1439,https://www.intensivregister.de/api/public/reporting/laendertabelle
1636674911,24898,21675,3223,2829,1439,https://www.intensivregister.de/api/public/reporting/laendertabelle
1636678515,24898,21678,3220,2828,1439,https://www.intensivregister.de/api/public/reporting/laendertabelle
1636682414,24898,21685,3213,2829,1439,https://www.intensivregister.de/api/public/reporting/laendertabelle
1636686009,24901,21691,3210,2830,1440,https://www.intensivregister.de/api/public/reporting/laendertabelle
1636689614,24895,21682,3213,2830,1441,https://www.intensivregister.de/api/public/reporting/laendertabelle
1636693209,24881,21647,3234,2840,1445,https://www.intensivregister.de/api/public/reporting/laendertabelle
1636696814,24864,21620,3244,2830,1444,https://www.intensivregister.de/api/public/reporting/laendertabelle
1636700409,24857,21649,3208,2839,1453,https://www.intensivregister.de/api/public/reporting/laendertabelle
1636703711,24834,21661,3173,2855,1469,https://www.intensivregister.de/api/public/reporting/laendertabelle
1636707317,24811,21628,3183,2855,1470,https://www.intensivregister.de/api/public/reporting/laendertabelle
1636711213,24809,21605,3204,2862,1472,https://www.intensivregister.de/api/public/reporting/laendertabelle
1636714808,24804,21606,3198,2863,1473,https://www.intensivregister.de/api/public/reporting/laendertabelle
1636718111,24800,21596,3204,2866,1471,https://www.intensivregister.de/api/public/reporting/laendertabelle
1636722008,24800,21597,3203,2865,1470,https://www.intensivregister.de/api/public/reporting/laendertabelle
1636725315,24795,21597,3198,2864,1472,https://www.intensivregister.de/api/public/reporting/laendertabelle
1636728914,24791,21592,3199,2859,1471,https://www.intensivregister.de/api/public/reporting/laendertabelle
1636732814,24787,21596,3191,2862,1471,https://www.intensivregister.de/api/public/reporting/laendertabelle
1636736110,24787,21597,3190,2862,1471,https://www.intensivregister.de/api/public/reporting/laendertabelle
1636740011,24791,21601,3190,2862,1472,https://www.intensivregister.de/api/public/reporting/laendertabelle
1636743310,24791,21601,3190,2863,1472,https://www.intensivregister.de/api/public/reporting/laendertabelle
1636758009,24788,21591,3197,2863,1472,https://www.intensivregister.de/api/public/reporting/laendertabelle
1636761617,24788,21585,3203,2864,1473,https://www.intensivregister.de/api/public/reporting/laendertabelle
1636765216,24787,21587,3200,2866,1474,https://www.intensivregister.de/api/public/reporting/laendertabelle
1636768814,24786,21576,3210,2864,1474,https://www.intensivregister.de/api/public/reporting/laendertabelle
1636772410,24784,21584,3200,2866,1475,https://www.intensivregister.de/api/public/reporting/laendertabelle
1636776015,24806,21610,3196,2865,1475,https://www.intensivregister.de/api/public/reporting/laendertabelle
1636779610,24800,21598,3202,2862,1477,https://www.intensivregister.de/api/public/reporting/laendertabelle
1636783216,24766,21553,3213,2871,1479,https://www.intensivregister.de/api/public/reporting/laendertabelle
1636786811,24738,21514,3224,2891,1488,https://www.intensivregister.de/api/public/reporting/laendertabelle
1636790113,24683,21470,3213,2927,1485,https://www.intensivregister.de/api/public/reporting/laendertabelle
1636794011,24678,21430,3248,2936,1498,https://www.intensivregister.de/api/public/reporting/laendertabelle
1636797617,24673,21415,3258,2941,1495,https://www.intensivregister.de/api/public/reporting/laendertabelle
1636801212,24679,21413,3266,2941,1494,https://www.intensivregister.de/api/public/reporting/laendertabelle
1636804816,24678,21406,3272,2945,1494,https://www.intensivregister.de/api/public/reporting/laendertabelle
1636808412,24682,21411,3271,2945,1493,https://www.intensivregister.de/api/public/reporting/laendertabelle
1636811715,24680,21406,3274,2944,1490,https://www.intensivregister.de/api/public/reporting/laendertabelle
1636815611,24678,21404,3274,2946,1491,https://www.intensivregister.de/api/public/reporting/laendertabelle
1636818914,24678,21405,3273,2950,1491,https://www.intensivregister.de/api/public/reporting/laendertabelle
1636822812,24674,21407,3267,2953,1492,https://www.intensivregister.de/api/public/reporting/laendertabelle
1636830011,24674,21408,3266,2953,1493,https://www.intensivregister.de/api/public/reporting/laendertabelle
1636833616,24668,21401,3267,2953,1493,https://www.intensivregister.de/api/public/reporting/laendertabelle
1636844412,24671,21405,3266,2951,1492,https://www.intensivregister.de/api/public/reporting/laendertabelle
1636847714,24673,21404,3269,2951,1492,https://www.intensivregister.de/api/public/reporting/laendertabelle
1636851611,24674,21401,3273,2952,1491,https://www.intensivregister.de/api/public/reporting/laendertabelle
1636855216,24674,21401,3273,2951,1491,https://www.intensivregister.de/api/public/reporting/laendertabelle
1636858812,24674,21399,3275,2954,1491,https://www.intensivregister.de/api/public/reporting/laendertabelle
1636862417,24676,21392,3284,2953,1491,https://www.intensivregister.de/api/public/reporting/laendertabelle
1636866012,24673,21370,3303,2962,1497,https://www.intensivregister.de/api/public/reporting/laendertabelle
1636869617,24667,21339,3328,2968,1505,https://www.intensivregister.de/api/public/reporting/laendertabelle
1636873212,24614,21244,3370,2984,1517,https://www.intensivregister.de/api/public/reporting/laendertabelle
1636876817,24617,21238,3379,3025,1533,https://www.intensivregister.de/api/public/reporting/laendertabelle
1636880411,24607,21226,3381,3034,1545,https://www.intensivregister.de/api/public/reporting/laendertabelle
1636884016,24604,21205,3399,3034,1557,https://www.intensivregister.de/api/public/reporting/laendertabelle
1636887612,24601,21191,3410,3039,1557,https://www.intensivregister.de/api/public/reporting/laendertabelle
1636891217,24599,21196,3403,3045,1564,https://www.intensivregister.de/api/public/reporting/laendertabelle
1636894811,24600,21196,3404,3045,1564,https://www.intensivregister.de/api/public/reporting/laendertabelle
1636898417,24600,21197,3403,3046,1564,https://www.intensivregister.de/api/public/reporting/laendertabelle
1636902011,24600,21198,3402,3046,1564,https://www.intensivregister.de/api/public/reporting/laendertabelle
1636905615,24600,21197,3403,3048,1564,https://www.intensivregister.de/api/public/reporting/laendertabelle
1636909212,24602,21201,3401,3046,1563,https://www.intensivregister.de/api/public/reporting/laendertabelle
1636919714,24602,21200,3402,3046,1564,https://www.intensivregister.de/api/public/reporting/laendertabelle
1636923611,24602,21202,3400,3046,1564,https://www.intensivregister.de/api/public/reporting/laendertabelle
1636927216,24599,21198,3401,3046,1564,https://www.intensivregister.de/api/public/reporting/laendertabelle
1636930812,24599,21200,3399,3047,1564,https://www.intensivregister.de/api/public/reporting/laendertabelle
1636934408,24597,21199,3398,3050,1564,https://www.intensivregister.de/api/public/reporting/laendertabelle
1636937711,24597,21195,3402,3050,1564,https://www.intensivregister.de/api/public/reporting/laendertabelle
1636941609,24596,21195,3401,3052,1565,https://www.intensivregister.de/api/public/reporting/laendertabelle
1636945214,24598,21197,3401,3055,1566,https://www.intensivregister.de/api/public/reporting/laendertabelle
1636948810,24593,21211,3382,3058,1567,https://www.intensivregister.de/api/public/reporting/laendertabelle
1636952415,24614,21240,3374,3070,1570,https://www.intensivregister.de/api/public/reporting/laendertabelle
1636956010,24660,21278,3382,3108,1587,https://www.intensivregister.de/api/public/reporting/laendertabelle
1636959016,24686,21237,3449,3134,1596,https://www.intensivregister.de/api/public/reporting/laendertabelle
1636963216,24745,21319,3426,3155,1607,https://www.intensivregister.de/api/public/reporting/laendertabelle
1636966812,24774,21345,3429,3176,1612,https://www.intensivregister.de/api/public/reporting/laendertabelle
1636970417,24796,21340,3456,3190,1609,https://www.intensivregister.de/api/public/reporting/laendertabelle
1636974013,24812,21356,3456,3190,1610,https://www.intensivregister.de/api/public/reporting/laendertabelle
1636977609,24812,21344,3468,3190,1610,https://www.intensivregister.de/api/public/reporting/laendertabelle
1636981213,24854,21383,3471,3191,1610,https://www.intensivregister.de/api/public/reporting/laendertabelle
1636984810,24856,21382,3474,3195,1610,https://www.intensivregister.de/api/public/reporting/laendertabelle
1636988415,24856,21380,3476,3194,1610,https://www.intensivregister.de/api/public/reporting/laendertabelle
1636992010,24856,21382,3474,3194,1611,https://www.intensivregister.de/api/public/reporting/laendertabelle
1637002816,24856,21381,3475,3194,1610,https://www.intensivregister.de/api/public/reporting/laendertabelle
1637009714,24856,21372,3484,3193,1610,https://www.intensivregister.de/api/public/reporting/laendertabelle
1637017208,24859,21373,3486,3193,1609,https://www.intensivregister.de/api/public/reporting/laendertabelle
1637020813,24861,21374,3487,3192,1609,https://www.intensivregister.de/api/public/reporting/laendertabelle
1637024408,24864,21375,3489,3192,1611,https://www.intensivregister.de/api/public/reporting/laendertabelle
1637028014,24869,21382,3487,3195,1614,https://www.intensivregister.de/api/public/reporting/laendertabelle
1637031610,24867,21377,3490,3196,1616,https://www.intensivregister.de/api/public/reporting/laendertabelle
1637034911,24874,21392,3482,3196,1614,https://www.intensivregister.de/api/public/reporting/laendertabelle
1637038808,24910,21464,3446,3202,1623,https://www.intensivregister.de/api/public/reporting/laendertabelle
1637042414,24949,21522,3427,3214,1634,https://www.intensivregister.de/api/public/reporting/laendertabelle
1637046010,24961,21568,3393,3236,1655,https://www.intensivregister.de/api/public/reporting/laendertabelle
1637049615,24977,21679,3298,3256,1662,https://www.intensivregister.de/api/public/reporting/laendertabelle
1637053211,24962,21718,3244,3272,1663,https://www.intensivregister.de/api/public/reporting/laendertabelle
1637056514,24971,21751,3220,3277,1668,https://www.intensivregister.de/api/public/reporting/laendertabelle
1637060412,24971,21753,3218,3280,1669,https://www.intensivregister.de/api/public/reporting/laendertabelle
1637064016,24968,21761,3207,3280,1668,https://www.intensivregister.de/api/public/reporting/laendertabelle
1637067613,24969,21767,3202,3280,1667,https://www.intensivregister.de/api/public/reporting/laendertabelle
1637071208,24967,21771,3196,3281,1668,https://www.intensivregister.de/api/public/reporting/laendertabelle
1637074813,24970,21759,3211,3282,1667,https://www.intensivregister.de/api/public/reporting/laendertabelle
1637078408,24971,21759,3212,3280,1666,https://www.intensivregister.de/api/public/reporting/laendertabelle
1637082012,24970,21764,3206,3284,1667,https://www.intensivregister.de/api/public/reporting/laendertabelle
1637092817,24970,21764,3206,3285,1668,https://www.intensivregister.de/api/public/reporting/laendertabelle
1637103615,24969,21752,3217,3284,1668,https://www.intensivregister.de/api/public/reporting/laendertabelle
1637107214,24967,21751,3216,3283,1670,https://www.intensivregister.de/api/public/reporting/laendertabelle
1637110809,24964,21767,3197,3286,1670,https://www.intensivregister.de/api/public/reporting/laendertabelle
1637114414,24958,21768,3190,3287,1668,https://www.intensivregister.de/api/public/reporting/laendertabelle
1637118008,24964,21769,3195,3291,1670,https://www.intensivregister.de/api/public/reporting/laendertabelle
1637121613,24970,21772,3198,3290,1669,https://www.intensivregister.de/api/public/reporting/laendertabelle
1637124916,24966,21776,3190,3307,1683,https://www.intensivregister.de/api/public/reporting/laendertabelle
1637128513,24971,21805,3166,3330,1685,https://www.intensivregister.de/api/public/reporting/laendertabelle
1637132410,24956,21776,3180,3334,1691,https://www.intensivregister.de/api/public/reporting/laendertabelle
1637136014,24970,21836,3134,3375,1704,https://www.intensivregister.de/api/public/reporting/laendertabelle
1637139608,24965,21843,3122,3373,1704,https://www.intensivregister.de/api/public/reporting/laendertabelle
1637142613,24939,21826,3113,3376,1709,https://www.intensivregister.de/api/public/reporting/laendertabelle
1637146814,24940,21826,3114,3376,1709,https://www.intensivregister.de/api/public/reporting/laendertabelle
1637150409,24939,21830,3109,3378,1708,https://www.intensivregister.de/api/public/reporting/laendertabelle
1637154011,24942,21839,3103,3380,1705,https://www.intensivregister.de/api/public/reporting/laendertabelle
1637157615,24944,21844,3100,3383,1705,https://www.intensivregister.de/api/public/reporting/laendertabelle
1637160914,24945,21844,3101,3383,1706,https://www.intensivregister.de/api/public/reporting/laendertabelle
1637164812,24945,21846,3099,3384,1707,https://www.intensivregister.de/api/public/reporting/laendertabelle
1637168112,24945,21835,3110,3385,1708,https://www.intensivregister.de/api/public/reporting/laendertabelle
1637172008,24944,21833,3111,3385,1708,https://www.intensivregister.de/api/public/reporting/laendertabelle
1637175612,24944,21836,3108,3385,1708,https://www.intensivregister.de/api/public/reporting/laendertabelle
1637179216,24944,21837,3107,3385,1708,https://www.intensivregister.de/api/public/reporting/laendertabelle
1637186410,24944,21844,3100,3386,1708,https://www.intensivregister.de/api/public/reporting/laendertabelle
1637189708,24943,21837,3106,3382,1708,https://www.intensivregister.de/api/public/reporting/laendertabelle
1637193614,24943,21836,3107,3384,1707,https://www.intensivregister.de/api/public/reporting/laendertabelle
1637196912,24943,21826,3117,3386,1708,https://www.intensivregister.de/api/public/reporting/laendertabelle
1637200514,24947,21832,3115,3382,1706,https://www.intensivregister.de/api/public/reporting/laendertabelle
1637204414,24947,21825,3122,3384,1706,https://www.intensivregister.de/api/public/reporting/laendertabelle
1637208016,24943,21824,3119,3385,1705,https://www.intensivregister.de/api/public/reporting/laendertabelle
1637211609,24947,21829,3118,3395,1714,https://www.intensivregister.de/api/public/reporting/laendertabelle
1637215212,24970,21833,3137,3418,1718,https://www.intensivregister.de/api/public/reporting/laendertabelle
1637218815,24984,21821,3163,3412,1726,https://www.intensivregister.de/api/public/reporting/laendertabelle
1637222416,24998,21811,3187,3419,1720,https://www.intensivregister.de/api/public/reporting/laendertabelle
1637226009,25000,21792,3208,3419,1721,https://www.intensivregister.de/api/public/reporting/laendertabelle
1637229611,24991,21800,3191,3432,1733,https://www.intensivregister.de/api/public/reporting/laendertabelle
1637232910,24991,21800,3191,3431,1734,https://www.intensivregister.de/api/public/reporting/laendertabelle
1637236512,24996,21804,3192,3432,1735,https://www.intensivregister.de/api/public/reporting/laendertabelle
1637240409,24996,21810,3186,3433,1736,https://www.intensivregister.de/api/public/reporting/laendertabelle
1637244012,24997,21811,3186,3430,1734,https://www.intensivregister.de/api/public/reporting/laendertabelle
1637247311,24997,21807,3190,3428,1734,https://www.intensivregister.de/api/public/reporting/laendertabelle
1637251500,25002,21813,3189,3434,1737,https://www.intensivregister.de/api/public/reporting/laendertabelle
1637255100,25002,21813,3189,3433,1736,https://www.intensivregister.de/api/public/reporting/laendertabelle
1637258700,25002,21813,3189,3432,1736,https://www.intensivregister.de/api/public/reporting/laendertabelle
1637269500,25002,21812,3190,3433,1736,https://www.intensivregister.de/api/public/reporting/laendertabelle
1637273100,25002,21814,3188,3433,1736,https://www.intensivregister.de/api/public/reporting/laendertabelle
1637276700,25002,21810,3192,3433,1737,https://www.intensivregister.de/api/public/reporting/laendertabelle
1637280300,25004,21816,3188,3434,1737,https://www.intensivregister.de/api/public/reporting/laendertabelle
1637283900,25005,21812,3193,3433,1736,https://www.intensivregister.de/api/public/reporting/laendertabelle
1637287500,25004,21803,3201,3436,1737,https://www.intensivregister.de/api/public/reporting/laendertabelle
1637291100,25002,21798,3204,3436,1738,https://www.intensivregister.de/api/public/reporting/laendertabelle
1637294700,25000,21805,3195,3442,1736,https://www.intensivregister.de/api/public/reporting/laendertabelle
1637298300,24999,21800,3199,3442,1736,https://www.intensivregister.de/api/public/reporting/laendertabelle
1637301900,24983,21786,3197,3444,1746,https://www.intensivregister.de/api/public/reporting/laendertabelle
1637305500,24998,21809,3189,3474,1744,https://www.intensivregister.de/api/public/reporting/laendertabelle
1637309100,24975,21783,3192,3507,1746,https://www.intensivregister.de/api/public/reporting/laendertabelle
1637312700,24975,21797,3178,3510,1753,https://www.intensivregister.de/api/public/reporting/laendertabelle
1637316300,24958,21769,3189,3506,1753,https://www.intensivregister.de/api/public/reporting/laendertabelle
1637319900,24937,21756,3181,3509,1753,https://www.intensivregister.de/api/public/reporting/laendertabelle
1637323500,24935,21758,3177,3516,1759,https://www.intensivregister.de/api/public/reporting/laendertabelle
1637327100,24931,21757,3174,3519,1759,https://www.intensivregister.de/api/public/reporting/laendertabelle
1637330700,24954,21769,3185,3520,1760,https://www.intensivregister.de/api/public/reporting/laendertabelle
1637334300,24952,21775,3177,3525,1761,https://www.intensivregister.de/api/public/reporting/laendertabelle
1637337900,24952,21774,3178,3525,1761,https://www.intensivregister.de/api/public/reporting/laendertabelle
1637345100,24953,21774,3179,3525,1762,https://www.intensivregister.de/api/public/reporting/laendertabelle
1637348700,24954,21775,3179,3528,1764,https://www.intensivregister.de/api/public/reporting/laendertabelle
1637352300,24954,21774,3180,3531,1764,https://www.intensivregister.de/api/public/reporting/laendertabelle
1637359500,24954,21775,3179,3533,1764,https://www.intensivregister.de/api/public/reporting/laendertabelle
1637363100,24953,21778,3175,3533,1764,https://www.intensivregister.de/api/public/reporting/laendertabelle
1637366700,24951,21771,3180,3533,1765,https://www.intensivregister.de/api/public/reporting/laendertabelle
1637370300,24951,21771,3180,3532,1764,https://www.intensivregister.de/api/public/reporting/laendertabelle
1637373900,24951,21767,3184,3531,1763,https://www.intensivregister.de/api/public/reporting/laendertabelle
1637377500,24951,21766,3185,3528,1764,https://www.intensivregister.de/api/public/reporting/laendertabelle
1637381100,24951,21763,3188,3526,1763,https://www.intensivregister.de/api/public/reporting/laendertabelle
1637384700,24936,21737,3199,3519,1763,https://www.intensivregister.de/api/public/reporting/laendertabelle
1637388300,24925,21714,3211,3526,1772,https://www.intensivregister.de/api/public/reporting/laendertabelle
1637391900,24860,21660,3200,3541,1787,https://www.intensivregister.de/api/public/reporting/laendertabelle
1637395500,24818,21553,3265,3537,1802,https://www.intensivregister.de/api/public/reporting/laendertabelle
1637399100,24787,21495,3292,3551,1810,https://www.intensivregister.de/api/public/reporting/laendertabelle
1637402700,24751,21450,3301,3565,1811,https://www.intensivregister.de/api/public/reporting/laendertabelle
1637406300,24749,21448,3301,3565,1813,https://www.intensivregister.de/api/public/reporting/laendertabelle
1637409900,24743,21439,3304,3569,1818,https://www.intensivregister.de/api/public/reporting/laendertabelle
1637413500,24741,21448,3293,3573,1819,https://www.intensivregister.de/api/public/reporting/laendertabelle
1637417100,24740,21447,3293,3572,1819,https://www.intensivregister.de/api/public/reporting/laendertabelle
1637420700,24737,21437,3300,3571,1819,https://www.intensivregister.de/api/public/reporting/laendertabelle
1637424300,24734,21433,3301,3576,1822,https://www.intensivregister.de/api/public/reporting/laendertabelle
1637427900,24730,21434,3296,3577,1822,https://www.intensivregister.de/api/public/reporting/laendertabelle
1637431500,24727,21434,3293,3578,1822,https://www.intensivregister.de/api/public/reporting/laendertabelle
1637435100,24727,21434,3293,3580,1823,https://www.intensivregister.de/api/public/reporting/laendertabelle
1637438700,24727,21436,3291,3582,1825,https://www.intensivregister.de/api/public/reporting/laendertabelle
1637445900,24727,21437,3290,3583,1825,https://www.intensivregister.de/api/public/reporting/laendertabelle
1637449500,24726,21428,3298,3587,1826,https://www.intensivregister.de/api/public/reporting/laendertabelle
1637453100,24728,21426,3302,3587,1828,https://www.intensivregister.de/api/public/reporting/laendertabelle
1637456700,24729,21427,3302,3589,1828,https://www.intensivregister.de/api/public/reporting/laendertabelle
1637460300,24727,21421,3306,3590,1828,https://www.intensivregister.de/api/public/reporting/laendertabelle
1637463900,24727,21420,3307,3591,1830,https://www.intensivregister.de/api/public/reporting/laendertabelle
1637467500,24724,21418,3306,3588,1828,https://www.intensivregister.de/api/public/reporting/laendertabelle
1637471100,24730,21424,3306,3585,1832,https://www.intensivregister.de/api/public/reporting/laendertabelle
1637474700,24728,21365,3363,3599,1847,https://www.intensivregister.de/api/public/reporting/laendertabelle
1637478300,24713,21308,3405,3628,1845,https://www.intensivregister.de/api/public/reporting/laendertabelle
1637481900,24711,21245,3466,3641,1859,https://www.intensivregister.de/api/public/reporting/laendertabelle
1637485500,24706,21191,3515,3664,1877,https://www.intensivregister.de/api/public/reporting/laendertabelle
1637489100,24700,21161,3539,3670,1878,https://www.intensivregister.de/api/public/reporting/laendertabelle
1637492700,24689,21153,3536,3678,1878,https://www.intensivregister.de/api/public/reporting/laendertabelle
1637496300,24685,21151,3534,3678,1878,https://www.intensivregister.de/api/public/reporting/laendertabelle
1637499900,24684,21149,3535,3679,1877,https://www.intensivregister.de/api/public/reporting/laendertabelle
1637503500,24684,21141,3543,3682,1879,https://www.intensivregister.de/api/public/reporting/laendertabelle
1637507100,24686,21144,3542,3681,1881,https://www.intensivregister.de/api/public/reporting/laendertabelle
1637510700,24686,21149,3537,3682,1881,https://www.intensivregister.de/api/public/reporting/laendertabelle
1637514300,24685,21143,3542,3685,1881,https://www.intensivregister.de/api/public/reporting/laendertabelle
1637517900,24684,21141,3543,3686,1882,https://www.intensivregister.de/api/public/reporting/laendertabelle
1637525100,24684,21143,3541,3688,1884,https://www.intensivregister.de/api/public/reporting/laendertabelle
1637528700,24684,21147,3537,3691,1885,https://www.intensivregister.de/api/public/reporting/laendertabelle
1637532300,24684,21150,3534,3693,1886,https://www.intensivregister.de/api/public/reporting/laendertabelle
1637535900,24683,21156,3527,3695,1885,https://www.intensivregister.de/api/public/reporting/laendertabelle
1637539500,24681,21151,3530,3693,1884,https://www.intensivregister.de/api/public/reporting/laendertabelle
1637543100,24683,21153,3530,3693,1883,https://www.intensivregister.de/api/public/reporting/laendertabelle
1637546700,24682,21163,3519,3693,1882,https://www.intensivregister.de/api/public/reporting/laendertabelle
1637550300,24683,21165,3518,3695,1883,https://www.intensivregister.de/api/public/reporting/laendertabelle
1637553900,24686,21165,3521,3694,1880,https://www.intensivregister.de/api/public/reporting/laendertabelle
1637557500,24708,21178,3530,3704,1885,https://www.intensivregister.de/api/public/reporting/laendertabelle
1637561100,24751,21191,3560,3734,1904,https://www.intensivregister.de/api/public/reporting/laendertabelle
1637564700,24809,21276,3533,3785,1924,https://www.intensivregister.de/api/public/reporting/laendertabelle
1637568300,24816,21340,3476,3807,1940,https://www.intensivregister.de/api/public/reporting/laendertabelle
1637571900,24812,21357,3455,3820,1957,https://www.intensivregister.de/api/public/reporting/laendertabelle
1637575500,24839,21387,3452,3844,1971,https://www.intensivregister.de/api/public/reporting/laendertabelle
1637579100,24847,21398,3449,3850,1973,https://www.intensivregister.de/api/public/reporting/laendertabelle
1637582700,24847,21401,3446,3855,1976,https://www.intensivregister.de/api/public/reporting/laendertabelle
1637586300,24848,21418,3430,3856,1977,https://www.intensivregister.de/api/public/reporting/laendertabelle
1637589900,24854,21420,3434,3856,1978,https://www.intensivregister.de/api/public/reporting/laendertabelle
1637593500,24848,21412,3436,3855,1978,https://www.intensivregister.de/api/public/reporting/laendertabelle
1637597100,24847,21412,3435,3855,1978,https://www.intensivregister.de/api/public/reporting/laendertabelle
1637600700,24847,21410,3437,3857,1978,https://www.intensivregister.de/api/public/reporting/laendertabelle
1637604300,24847,21415,3432,3857,1978,https://www.intensivregister.de/api/public/reporting/laendertabelle
1637607900,24848,21408,3440,3856,1978,https://www.intensivregister.de/api/public/reporting/laendertabelle
1637615100,24848,21409,3439,3857,1978,https://www.intensivregister.de/api/public/reporting/laendertabelle
1637622300,24848,21408,3440,3859,1979,https://www.intensivregister.de/api/public/reporting/laendertabelle
1637625900,24844,21411,3433,3860,1980,https://www.intensivregister.de/api/public/reporting/laendertabelle
1637629500,24841,21406,3435,3860,1981,https://www.intensivregister.de/api/public/reporting/laendertabelle
1637633100,24844,21412,3432,3860,1983,https://www.intensivregister.de/api/public/reporting/laendertabelle
1637636700,24844,21411,3433,3858,1980,https://www.intensivregister.de/api/public/reporting/laendertabelle
1637640300,24848,21431,3417,3863,1989,https://www.intensivregister.de/api/public/reporting/laendertabelle
1637643900,24854,21493,3361,3863,1983,https://www.intensivregister.de/api/public/reporting/laendertabelle
1637647500,24869,21565,3304,3891,1998,https://www.intensivregister.de/api/public/reporting/laendertabelle
1637651100,24896,21654,3242,3920,2011,https://www.intensivregister.de/api/public/reporting/laendertabelle
1637654700,24966,21788,3178,3959,2033,https://www.intensivregister.de/api/public/reporting/laendertabelle
1637658300,24981,21834,3147,3974,2029,https://www.intensivregister.de/api/public/reporting/laendertabelle
1637661900,25003,21859,3144,3986,2041,https://www.intensivregister.de/api/public/reporting/laendertabelle
1637665500,25005,21866,3139,3988,2042,https://www.intensivregister.de/api/public/reporting/laendertabelle
1637669100,25005,21856,3149,3983,2040,https://www.intensivregister.de/api/public/reporting/laendertabelle
1637672700,25008,21865,3143,3980,2037,https://www.intensivregister.de/api/public/reporting/laendertabelle
1637676300,25005,21864,3141,3977,2035,https://www.intensivregister.de/api/public/reporting/laendertabelle
1637679900,25005,21863,3142,3976,2035,https://www.intensivregister.de/api/public/reporting/laendertabelle
1637683500,25005,21862,3143,3976,2035,https://www.intensivregister.de/api/public/reporting/laendertabelle
1637687100,25005,21861,3144,3976,2035,https://www.intensivregister.de/api/public/reporting/laendertabelle
1637690700,25003,21857,3146,3976,2034,https://www.intensivregister.de/api/public/reporting/laendertabelle
1637705100,25003,21858,3145,3977,2034,https://www.intensivregister.de/api/public/reporting/laendertabelle
1637708700,25002,21867,3135,3978,2035,https://www.intensivregister.de/api/public/reporting/laendertabelle
1637712300,25004,21873,3131,3981,2038,https://www.intensivregister.de/api/public/reporting/laendertabelle
1637715900,25006,21875,3131,3982,2037,https://www.intensivregister.de/api/public/reporting/laendertabelle
1637719500,25012,21873,3139,3984,2037,https://www.intensivregister.de/api/public/reporting/laendertabelle
1637723100,25008,21876,3132,3984,2038,https://www.intensivregister.de/api/public/reporting/laendertabelle
1637726700,25007,21881,3126,3988,2043,https://www.intensivregister.de/api/public/reporting/laendertabelle
1637730300,25010,21902,3108,4002,2047,https://www.intensivregister.de/api/public/reporting/laendertabelle
1637733900,25003,21904,3099,4015,2064,https://www.intensivregister.de/api/public/reporting/laendertabelle
1637737500,25015,21934,3081,4023,2097,https://www.intensivregister.de/api/public/reporting/laendertabelle
1637741100,25011,21937,3074,4041,2109,https://www.intensivregister.de/api/public/reporting/laendertabelle
1637744700,25005,21934,3071,4061,2119,https://www.intensivregister.de/api/public/reporting/laendertabelle
1637748300,24987,21955,3032,4069,2124,https://www.intensivregister.de/api/public/reporting/laendertabelle
1637751900,24986,21958,3028,4071,2122,https://www.intensivregister.de/api/public/reporting/laendertabelle
1637755500,24992,21952,3040,4075,2123,https://www.intensivregister.de/api/public/reporting/laendertabelle
1637759100,24996,21952,3044,4073,2123,https://www.intensivregister.de/api/public/reporting/laendertabelle
1637762700,24996,21947,3049,4071,2122,https://www.intensivregister.de/api/public/reporting/laendertabelle
1637766300,24999,21954,3045,4070,2123,https://www.intensivregister.de/api/public/reporting/laendertabelle
1637769900,24996,21956,3040,4072,2124,https://www.intensivregister.de/api/public/reporting/laendertabelle
1637773500,24996,21958,3038,4073,2125,https://www.intensivregister.de/api/public/reporting/laendertabelle
1637777100,24996,21957,3039,4075,2124,https://www.intensivregister.de/api/public/reporting/laendertabelle
1637780700,24994,21953,3041,4074,2124,https://www.intensivregister.de/api/public/reporting/laendertabelle
1637784300,24994,21952,3042,4074,2123,https://www.intensivregister.de/api/public/reporting/laendertabelle
1637791500,24994,21950,3044,4076,2123,https://www.intensivregister.de/api/public/reporting/laendertabelle
1637795100,24994,21954,3040,4076,2122,https://www.intensivregister.de/api/public/reporting/laendertabelle
1637798700,24994,21955,3039,4077,2122,https://www.intensivregister.de/api/public/reporting/laendertabelle
1637802300,24993,21958,3035,4075,2122,https://www.intensivregister.de/api/public/reporting/laendertabelle
1637805900,24992,21949,3043,4074,2120,https://www.intensivregister.de/api/public/reporting/laendertabelle
1637809500,24997,21962,3035,4073,2123,https://www.intensivregister.de/api/public/reporting/laendertabelle
1637813100,24996,21948,3048,4073,2122,https://www.intensivregister.de/api/public/reporting/laendertabelle
1637816700,24978,21900,3078,4079,2123,https://www.intensivregister.de/api/public/reporting/laendertabelle
1637820300,24976,21900,3076,4108,2144,https://www.intensivregister.de/api/public/reporting/laendertabelle
1637823900,24967,21908,3059,4147,2141,https://www.intensivregister.de/api/public/reporting/laendertabelle
1637827500,24971,21930,3041,4177,2153,https://www.intensivregister.de/api/public/reporting/laendertabelle
1637831100,24971,21924,3047,4189,2154,https://www.intensivregister.de/api/public/reporting/laendertabelle
1637838635,24949,21896,3053,4205,2163,https://www.intensivregister.de/api/public/reporting/laendertabelle
1637841900,24947,21887,3060,4205,2164,https://www.intensivregister.de/api/public/reporting/laendertabelle
1637845500,24949,21889,3060,4206,2166,https://www.intensivregister.de/api/public/reporting/laendertabelle
1637849100,24949,21889,3060,4211,2168,https://www.intensivregister.de/api/public/reporting/laendertabelle
1637852700,24949,21890,3059,4212,2170,https://www.intensivregister.de/api/public/reporting/laendertabelle
1637856300,24949,21890,3059,4210,2168,https://www.intensivregister.de/api/public/reporting/laendertabelle
1637859900,24949,21888,3061,4209,2167,https://www.intensivregister.de/api/public/reporting/laendertabelle
1637863500,24949,21889,3060,4210,2168,https://www.intensivregister.de/api/public/reporting/laendertabelle
1637870700,24949,21887,3062,4211,2169,https://www.intensivregister.de/api/public/reporting/laendertabelle
1637877900,24949,21888,3061,4211,2169,https://www.intensivregister.de/api/public/reporting/laendertabelle
1637881500,24947,21888,3059,4216,2171,https://www.intensivregister.de/api/public/reporting/laendertabelle
1637885100,24947,21893,3054,4216,2171,https://www.intensivregister.de/api/public/reporting/laendertabelle
1637888700,24946,21893,3053,4218,2172,https://www.intensivregister.de/api/public/reporting/laendertabelle
1637892300,24947,21892,3055,4221,2172,https://www.intensivregister.de/api/public/reporting/laendertabelle
1637895900,24950,21892,3058,4224,2176,https://www.intensivregister.de/api/public/reporting/laendertabelle
1637899500,24942,21882,3060,4220,2173,https://www.intensivregister.de/api/public/reporting/laendertabelle
1637903100,24942,21872,3070,4221,2175,https://www.intensivregister.de/api/public/reporting/laendertabelle
1637906700,24984,21897,3087,4233,2183,https://www.intensivregister.de/api/public/reporting/laendertabelle
1637910300,24951,21889,3062,4279,2192,https://www.intensivregister.de/api/public/reporting/laendertabelle
1637913900,24943,21869,3074,4300,2187,https://www.intensivregister.de/api/public/reporting/laendertabelle
1637917500,24944,21892,3052,4306,2200,https://www.intensivregister.de/api/public/reporting/laendertabelle
1637921100,24957,21921,3036,4325,2215,https://www.intensivregister.de/api/public/reporting/laendertabelle
1637924700,24958,21940,3018,4322,2218,https://www.intensivregister.de/api/public/reporting/laendertabelle
1637928300,24949,21944,3005,4326,2219,https://www.intensivregister.de/api/public/reporting/laendertabelle
1637931900,24941,21924,3017,4328,2218,https://www.intensivregister.de/api/public/reporting/laendertabelle
1637935500,24942,21924,3018,4330,2217,https://www.intensivregister.de/api/public/reporting/laendertabelle
1637939100,24946,21930,3016,4328,2217,https://www.intensivregister.de/api/public/reporting/laendertabelle
1637942700,24942,21934,3008,4329,2218,https://www.intensivregister.de/api/public/reporting/laendertabelle
1637946300,24942,21933,3009,4329,2218,https://www.intensivregister.de/api/public/reporting/laendertabelle
1637949900,24941,21932,3009,4329,2219,https://www.intensivregister.de/api/public/reporting/laendertabelle
1637957100,24941,21933,3008,4331,2220,https://www.intensivregister.de/api/public/reporting/laendertabelle
1637960700,24941,21933,3008,4332,2220,https://www.intensivregister.de/api/public/reporting/laendertabelle
1637964300,24831,21833,2998,4328,2218,https://www.intensivregister.de/api/public/reporting/laendertabelle
1637967900,24834,21832,3002,4331,2219,https://www.intensivregister.de/api/public/reporting/laendertabelle
1637971500,24832,21823,3009,4329,2216,https://www.intensivregister.de/api/public/reporting/laendertabelle
1637975100,24830,21820,3010,4328,2215,https://www.intensivregister.de/api/public/reporting/laendertabelle
1637978700,24832,21823,3009,4328,2217,https://www.intensivregister.de/api/public/reporting/laendertabelle
1637982300,24835,21824,3011,4328,2217,https://www.intensivregister.de/api/public/reporting/laendertabelle
1637985900,24830,21825,3005,4325,2214,https://www.intensivregister.de/api/public/reporting/laendertabelle
1637989500,24819,21816,3003,4332,2216,https://www.intensivregister.de/api/public/reporting/laendertabelle
1637993100,24779,21756,3023,4352,2234,https://www.intensivregister.de/api/public/reporting/laendertabelle
1637996700,24733,21689,3044,4361,2237,https://www.intensivregister.de/api/public/reporting/laendertabelle
1638000300,24727,21612,3115,4351,2227,https://www.intensivregister.de/api/public/reporting/laendertabelle
1638003900,24655,21517,3138,4376,2235,https://www.intensivregister.de/api/public/reporting/laendertabelle
1638007500,24629,21478,3151,4369,2233,https://www.intensivregister.de/api/public/reporting/laendertabelle
1638011100,24618,21466,3152,4369,2229,https://www.intensivregister.de/api/public/reporting/laendertabelle
1638014700,24617,21470,3147,4370,2234,https://www.intensivregister.de/api/public/reporting/laendertabelle
1638018300,24617,21464,3153,4371,2235,https://www.intensivregister.de/api/public/reporting/laendertabelle
1638021900,24622,21456,3166,4369,2237,https://www.intensivregister.de/api/public/reporting/laendertabelle
1638025500,24621,21456,3165,4370,2237,https://www.intensivregister.de/api/public/reporting/laendertabelle
1638029100,24621,21459,3162,4374,2237,https://www.intensivregister.de/api/public/reporting/laendertabelle
1638032700,24619,21457,3162,4375,2237,https://www.intensivregister.de/api/public/reporting/laendertabelle
1638039900,24619,21460,3159,4377,2237,https://www.intensivregister.de/api/public/reporting/laendertabelle
1638047100,24619,21458,3161,4376,2240,https://www.intensivregister.de/api/public/reporting/laendertabelle
1638050700,24619,21457,3162,4376,2240,https://www.intensivregister.de/api/public/reporting/laendertabelle
1638054300,24618,21453,3165,4378,2241,https://www.intensivregister.de/api/public/reporting/laendertabelle
1638057900,24618,21452,3166,4377,2240,https://www.intensivregister.de/api/public/reporting/laendertabelle
1638061500,24617,21454,3163,4381,2242,https://www.intensivregister.de/api/public/reporting/laendertabelle
1638065100,24616,21455,3161,4381,2243,https://www.intensivregister.de/api/public/reporting/laendertabelle
1638068700,24616,21457,3159,4382,2242,https://www.intensivregister.de/api/public/reporting/laendertabelle
1638072300,24617,21458,3159,4387,2245,https://www.intensivregister.de/api/public/reporting/laendertabelle
1638075900,24609,21453,3156,4389,2245,https://www.intensivregister.de/api/public/reporting/laendertabelle
1638079500,24610,21424,3186,4389,2257,https://www.intensivregister.de/api/public/reporting/laendertabelle
1638083100,24590,21350,3240,4401,2273,https://www.intensivregister.de/api/public/reporting/laendertabelle
1638086700,24579,21280,3299,4433,2277,https://www.intensivregister.de/api/public/reporting/laendertabelle
1638090300,24587,21266,3321,4454,2283,https://www.intensivregister.de/api/public/reporting/laendertabelle
1638093900,24576,21265,3311,4460,2283,https://www.intensivregister.de/api/public/reporting/laendertabelle
1638097500,24582,21266,3316,4464,2283,https://www.intensivregister.de/api/public/reporting/laendertabelle
1638101100,24585,21264,3321,4467,2282,https://www.intensivregister.de/api/public/reporting/laendertabelle
1638104700,24578,21265,3313,4469,2283,https://www.intensivregister.de/api/public/reporting/laendertabelle
1638108300,24578,21264,3314,4469,2283,https://www.intensivregister.de/api/public/reporting/laendertabelle
1638111900,24576,21266,3310,4475,2284,https://www.intensivregister.de/api/public/reporting/laendertabelle
1638115500,24576,21268,3308,4476,2284,https://www.intensivregister.de/api/public/reporting/laendertabelle
1638119100,24575,21266,3309,4478,2285,https://www.intensivregister.de/api/public/reporting/laendertabelle
1638122700,24576,21265,3311,4479,2285,https://www.intensivregister.de/api/public/reporting/laendertabelle
1638126300,24576,21266,3310,4479,2285,https://www.intensivregister.de/api/public/reporting/laendertabelle
1638133500,24576,21266,3310,4481,2286,https://www.intensivregister.de/api/public/reporting/laendertabelle
1638137100,24576,21267,3309,4482,2286,https://www.intensivregister.de/api/public/reporting/laendertabelle
1638140700,24576,21268,3308,4480,2283,https://www.intensivregister.de/api/public/reporting/laendertabelle
1638144300,24573,21269,3304,4480,2282,https://www.intensivregister.de/api/public/reporting/laendertabelle
1638147900,24575,21274,3301,4481,2279,https://www.intensivregister.de/api/public/reporting/laendertabelle
1638151500,24580,21276,3304,4483,2281,https://www.intensivregister.de/api/public/reporting/laendertabelle
1638155100,24579,21283,3296,4480,2280,https://www.intensivregister.de/api/public/reporting/laendertabelle
1638158700,24580,21289,3291,4481,2282,https://www.intensivregister.de/api/public/reporting/laendertabelle
1638162300,24592,21329,3263,4505,2288,https://www.intensivregister.de/api/public/reporting/laendertabelle
1638165900,24637,21425,3212,4524,2295,https://www.intensivregister.de/api/public/reporting/laendertabelle
1638169500,24731,21523,3208,4547,2322,https://www.intensivregister.de/api/public/reporting/laendertabelle
1638173100,24794,21592,3202,4570,2337,https://www.intensivregister.de/api/public/reporting/laendertabelle
1638176700,24814,21628,3186,4584,2350,https://www.intensivregister.de/api/public/reporting/laendertabelle
1638180300,24828,21647,3181,4598,2354,https://www.intensivregister.de/api/public/reporting/laendertabelle
1638183900,24837,21669,3168,4594,2358,https://www.intensivregister.de/api/public/reporting/laendertabelle
1638187500,24837,21675,3162,4594,2360,https://www.intensivregister.de/api/public/reporting/laendertabelle
1638191100,24837,21674,3163,4595,2363,https://www.intensivregister.de/api/public/reporting/laendertabelle
1638194700,24858,21699,3159,4597,2365,https://www.intensivregister.de/api/public/reporting/laendertabelle
1638198300,24863,21706,3157,4605,2368,https://www.intensivregister.de/api/public/reporting/laendertabelle
1638201900,24861,21704,3157,4605,2367,https://www.intensivregister.de/api/public/reporting/laendertabelle
1638205500,24860,21703,3157,4604,2366,https://www.intensivregister.de/api/public/reporting/laendertabelle
1638209100,24860,21704,3156,4604,2366,https://www.intensivregister.de/api/public/reporting/laendertabelle
1638212700,24860,21705,3155,4605,2366,https://www.intensivregister.de/api/public/reporting/laendertabelle
1638223500,24765,21625,3140,4599,2362,https://www.intensivregister.de/api/public/reporting/laendertabelle
1638227100,24766,21623,3143,4600,2362,https://www.intensivregister.de/api/public/reporting/laendertabelle
1638230700,24794,21635,3159,4598,2362,https://www.intensivregister.de/api/public/reporting/laendertabelle
1638234300,24791,21632,3159,4601,2361,https://www.intensivregister.de/api/public/reporting/laendertabelle
1638237900,24792,21629,3163,4602,2360,https://www.intensivregister.de/api/public/reporting/laendertabelle
1638241500,24793,21629,3164,4600,2359,https://www.intensivregister.de/api/public/reporting/laendertabelle
1638245100,24795,21642,3153,4603,2362,https://www.intensivregister.de/api/public/reporting/laendertabelle
1638248700,24805,21679,3126,4601,2362,https://www.intensivregister.de/api/public/reporting/laendertabelle
1638252300,24840,21737,3103,4597,2371,https://www.intensivregister.de/api/public/reporting/laendertabelle
1638255900,24888,21791,3097,4605,2383,https://www.intensivregister.de/api/public/reporting/laendertabelle
1638259500,24990,21873,3117,4613,2378,https://www.intensivregister.de/api/public/reporting/laendertabelle
1638263100,24986,21873,3113,4629,2389,https://www.intensivregister.de/api/public/reporting/laendertabelle
1638266700,25000,21890,3110,4635,2387,https://www.intensivregister.de/api/public/reporting/laendertabelle
1638270300,25002,21893,3109,4637,2382,https://www.intensivregister.de/api/public/reporting/laendertabelle
1638273900,24998,21891,3107,4641,2384,https://www.intensivregister.de/api/public/reporting/laendertabelle
1638277500,25002,21894,3108,4640,2382,https://www.intensivregister.de/api/public/reporting/laendertabelle
1638281100,25002,21891,3111,4640,2383,https://www.intensivregister.de/api/public/reporting/laendertabelle
1638284700,24973,21872,3101,4640,2383,https://www.intensivregister.de/api/public/reporting/laendertabelle
1638288300,24973,21870,3103,4639,2383,https://www.intensivregister.de/api/public/reporting/laendertabelle
1638291900,24973,21869,3104,4639,2383,https://www.intensivregister.de/api/public/reporting/laendertabelle
1638295500,24973,21868,3105,4640,2385,https://www.intensivregister.de/api/public/reporting/laendertabelle
1638299100,24976,21872,3104,4641,2385,https://www.intensivregister.de/api/public/reporting/laendertabelle
1638306300,24976,21872,3104,4642,2382,https://www.intensivregister.de/api/public/reporting/laendertabelle
1638313500,24974,21874,3100,4643,2384,https://www.intensivregister.de/api/public/reporting/laendertabelle
1638317100,24972,21869,3103,4643,2384,https://www.intensivregister.de/api/public/reporting/laendertabelle
1638320700,24973,21873,3100,4643,2385,https://www.intensivregister.de/api/public/reporting/laendertabelle
1638324300,24974,21866,3108,4645,2386,https://www.intensivregister.de/api/public/reporting/laendertabelle
1638327900,24973,21865,3108,4648,2388,https://www.intensivregister.de/api/public/reporting/laendertabelle
1638331500,24976,21863,3113,4647,2389,https://www.intensivregister.de/api/public/reporting/laendertabelle
1638335100,24964,21851,3113,4652,2404,https://www.intensivregister.de/api/public/reporting/laendertabelle
1638338700,24988,21834,3154,4654,2399,https://www.intensivregister.de/api/public/reporting/laendertabelle
1638342300,24995,21855,3140,4666,2430,https://www.intensivregister.de/api/public/reporting/laendertabelle
1638345900,25018,21896,3122,4690,2436,https://www.intensivregister.de/api/public/reporting/laendertabelle
1638349500,25010,21915,3095,4694,2441,https://www.intensivregister.de/api/public/reporting/laendertabelle
1638353100,25019,21929,3090,4692,2436,https://www.intensivregister.de/api/public/reporting/laendertabelle
1638356700,25022,21945,3077,4693,2437,https://www.intensivregister.de/api/public/reporting/laendertabelle
1638360300,25012,21934,3078,4687,2438,https://www.intensivregister.de/api/public/reporting/laendertabelle
1638363900,25004,21930,3074,4686,2437,https://www.intensivregister.de/api/public/reporting/laendertabelle
1638367500,25004,21924,3080,4688,2439,https://www.intensivregister.de/api/public/reporting/laendertabelle
1638371100,25004,21929,3075,4689,2438,https://www.intensivregister.de/api/public/reporting/laendertabelle
1638374700,25002,21928,3074,4691,2439,https://www.intensivregister.de/api/public/reporting/laendertabelle
1638378300,25001,21927,3074,4691,2441,https://www.intensivregister.de/api/public/reporting/laendertabelle
1638381900,25001,21930,3071,4692,2441,https://www.intensivregister.de/api/public/reporting/laendertabelle
1638385500,25000,21929,3071,4691,2444,https://www.intensivregister.de/api/public/reporting/laendertabelle
1638392700,25000,21934,3066,4694,2444,https://www.intensivregister.de/api/public/reporting/laendertabelle
1638396300,25001,21934,3067,4694,2444,https://www.intensivregister.de/api/public/reporting/laendertabelle
1638399900,25001,21930,3071,4693,2444,https://www.intensivregister.de/api/public/reporting/laendertabelle
1638403500,25000,21927,3073,4690,2443,https://www.intensivregister.de/api/public/reporting/laendertabelle
1638407100,24998,21925,3073,4689,2443,https://www.intensivregister.de/api/public/reporting/laendertabelle
1638410700,25003,21929,3074,4686,2444,https://www.intensivregister.de/api/public/reporting/laendertabelle
1638414300,24999,21929,3070,4681,2442,https://www.intensivregister.de/api/public/reporting/laendertabelle
1638417900,25004,21941,3063,4685,2445,https://www.intensivregister.de/api/public/reporting/laendertabelle
1638421500,25014,21971,3043,4700,2450,https://www.intensivregister.de/api/public/reporting/laendertabelle
1638425100,25011,21998,3013,4731,2447,https://www.intensivregister.de/api/public/reporting/laendertabelle
1638428700,25021,22059,2962,4751,2468,https://www.intensivregister.de/api/public/reporting/laendertabelle
1638432300,24995,22011,2984,4765,2481,https://www.intensivregister.de/api/public/reporting/laendertabelle
1638435900,24957,21999,2958,4777,2493,https://www.intensivregister.de/api/public/reporting/laendertabelle
1638439500,24949,21975,2974,4793,2507,https://www.intensivregister.de/api/public/reporting/laendertabelle
1638443100,24946,21977,2969,4795,2511,https://www.intensivregister.de/api/public/reporting/laendertabelle
1638446700,24949,21974,2975,4798,2513,https://www.intensivregister.de/api/public/reporting/laendertabelle
1638450300,24949,21969,2980,4798,2510,https://www.intensivregister.de/api/public/reporting/laendertabelle
1638453900,24948,21966,2982,4799,2511,https://www.intensivregister.de/api/public/reporting/laendertabelle
1638457500,24948,21966,2982,4802,2512,https://www.intensivregister.de/api/public/reporting/laendertabelle
1638461100,24949,21971,2978,4801,2513,https://www.intensivregister.de/api/public/reporting/laendertabelle
1638464700,24949,21968,2981,4799,2513,https://www.intensivregister.de/api/public/reporting/laendertabelle
1638468300,24946,21967,2979,4799,2514,https://www.intensivregister.de/api/public/reporting/laendertabelle
1638471900,24946,21971,2975,4799,2513,https://www.intensivregister.de/api/public/reporting/laendertabelle
1638475500,24948,21971,2977,4798,2512,https://www.intensivregister.de/api/public/reporting/laendertabelle
1638479100,24948,21973,2975,4798,2512,https://www.intensivregister.de/api/public/reporting/laendertabelle
1638482700,24945,21966,2979,4797,2512,https://www.intensivregister.de/api/public/reporting/laendertabelle
1638486300,24944,21962,2982,4799,2514,https://www.intensivregister.de/api/public/reporting/laendertabelle
1638489900,24944,21966,2978,4802,2516,https://www.intensivregister.de/api/public/reporting/laendertabelle
1638493500,24944,21967,2977,4804,2517,https://www.intensivregister.de/api/public/reporting/laendertabelle
1638497100,24951,21958,2993,4801,2515,https://www.intensivregister.de/api/public/reporting/laendertabelle
1638500700,24953,21959,2994,4802,2516,https://www.intensivregister.de/api/public/reporting/laendertabelle
1638504300,24952,21954,2998,4798,2517,https://www.intensivregister.de/api/public/reporting/laendertabelle
1638507900,24975,21973,3002,4794,2517,https://www.intensivregister.de/api/public/reporting/laendertabelle
1638511500,24971,21964,3007,4790,2531,https://www.intensivregister.de/api/public/reporting/laendertabelle
1638515100,24946,21971,2975,4775,2535,https://www.intensivregister.de/api/public/reporting/laendertabelle
1638518700,24894,21938,2956,4778,2545,https://www.intensivregister.de/api/public/reporting/laendertabelle
1638522300,24891,21934,2957,4788,2556,https://www.intensivregister.de/api/public/reporting/laendertabelle
1638525900,24895,21950,2945,4795,2562,https://www.intensivregister.de/api/public/reporting/laendertabelle
1638529500,24891,21949,2942,4807,2568,https://www.intensivregister.de/api/public/reporting/laendertabelle
1638533100,24891,21941,2950,4807,2568,https://www.intensivregister.de/api/public/reporting/laendertabelle
1638536700,24892,21941,2951,4811,2570,https://www.intensivregister.de/api/public/reporting/laendertabelle
1638540300,24892,21935,2957,4807,2566,https://www.intensivregister.de/api/public/reporting/laendertabelle
1638543900,24894,21936,2958,4808,2567,https://www.intensivregister.de/api/public/reporting/laendertabelle
1638547500,24892,21932,2960,4803,2566,https://www.intensivregister.de/api/public/reporting/laendertabelle
1638551100,24892,21932,2960,4804,2566,https://www.intensivregister.de/api/public/reporting/laendertabelle
1638554700,24892,21934,2958,4804,2565,https://www.intensivregister.de/api/public/reporting/laendertabelle
1638558300,24892,21933,2959,4803,2564,https://www.intensivregister.de/api/public/reporting/laendertabelle
1638561900,24892,21934,2958,4803,2564,https://www.intensivregister.de/api/public/reporting/laendertabelle
1638565500,24892,21933,2959,4803,2564,https://www.intensivregister.de/api/public/reporting/laendertabelle
1638569100,24892,21934,2958,4803,2564,https://www.intensivregister.de/api/public/reporting/laendertabelle
1638572700,24896,21940,2956,4803,2568,https://www.intensivregister.de/api/public/reporting/laendertabelle
1638576300,24896,21937,2959,4803,2568,https://www.intensivregister.de/api/public/reporting/laendertabelle
1638579900,24897,21939,2958,4802,2568,https://www.intensivregister.de/api/public/reporting/laendertabelle
1638583500,24901,21943,2958,4802,2568,https://www.intensivregister.de/api/public/reporting/laendertabelle
1638587100,24907,21947,2960,4804,2569,https://www.intensivregister.de/api/public/reporting/laendertabelle
1638590700,24910,21940,2970,4806,2568,https://www.intensivregister.de/api/public/reporting/laendertabelle
1638594300,24897,21921,2976,4798,2552,https://www.intensivregister.de/api/public/reporting/laendertabelle
1638597900,24889,21879,3010,4796,2549,https://www.intensivregister.de/api/public/reporting/laendertabelle
1638601500,24838,21795,3043,4781,2538,https://www.intensivregister.de/api/public/reporting/laendertabelle
1638605100,24806,21736,3070,4797,2552,https://www.intensivregister.de/api/public/reporting/laendertabelle
1638608700,24769,21670,3099,4810,2564,https://www.intensivregister.de/api/public/reporting/laendertabelle
1638612300,24757,21643,3114,4808,2560,https://www.intensivregister.de/api/public/reporting/laendertabelle
1638615900,24756,21638,3118,4806,2556,https://www.intensivregister.de/api/public/reporting/laendertabelle
1638619500,24752,21630,3122,4805,2553,https://www.intensivregister.de/api/public/reporting/laendertabelle
1638623100,24752,21634,3118,4806,2553,https://www.intensivregister.de/api/public/reporting/laendertabelle
1638626700,24751,21637,3114,4806,2554,https://www.intensivregister.de/api/public/reporting/laendertabelle
1638630300,24746,21635,3111,4806,2551,https://www.intensivregister.de/api/public/reporting/laendertabelle
1638633900,24745,21633,3112,4806,2551,https://www.intensivregister.de/api/public/reporting/laendertabelle
1638637500,24745,21634,3111,4806,2551,https://www.intensivregister.de/api/public/reporting/laendertabelle
1638641100,24743,21636,3107,4804,2551,https://www.intensivregister.de/api/public/reporting/laendertabelle
1638644700,24743,21638,3105,4805,2553,https://www.intensivregister.de/api/public/reporting/laendertabelle
1638648300,24743,21637,3106,4806,2553,https://www.intensivregister.de/api/public/reporting/laendertabelle
1638651900,24743,21636,3107,4806,2553,https://www.intensivregister.de/api/public/reporting/laendertabelle
1638655500,24744,21635,3109,4807,2553,https://www.intensivregister.de/api/public/reporting/laendertabelle
1638659100,24741,21633,3108,4805,2553,https://www.intensivregister.de/api/public/reporting/laendertabelle
1638662700,24740,21628,3112,4805,2554,https://www.intensivregister.de/api/public/reporting/laendertabelle
1638666300,24740,21621,3119,4805,2554,https://www.intensivregister.de/api/public/reporting/laendertabelle
1638669900,24741,21616,3125,4806,2552,https://www.intensivregister.de/api/public/reporting/laendertabelle
1638673500,24740,21616,3124,4806,2553,https://www.intensivregister.de/api/public/reporting/laendertabelle
1638677100,24740,21622,3118,4810,2557,https://www.intensivregister.de/api/public/reporting/laendertabelle
1638680700,24740,21609,3131,4807,2557,https://www.intensivregister.de/api/public/reporting/laendertabelle
1638684300,24737,21559,3178,4815,2563,https://www.intensivregister.de/api/public/reporting/laendertabelle
1638687900,24731,21522,3209,4800,2569,https://www.intensivregister.de/api/public/reporting/laendertabelle
1638691500,24707,21478,3229,4809,2556,https://www.intensivregister.de/api/public/reporting/laendertabelle
1638695100,24674,21388,3286,4831,2570,https://www.intensivregister.de/api/public/reporting/laendertabelle
1638698700,24673,21369,3304,4824,2570,https://www.intensivregister.de/api/public/reporting/laendertabelle
1638702300,24675,21370,3305,4822,2568,https://www.intensivregister.de/api/public/reporting/laendertabelle
1638705900,24675,21370,3305,4821,2567,https://www.intensivregister.de/api/public/reporting/laendertabelle
1638709500,24675,21361,3314,4823,2567,https://www.intensivregister.de/api/public/reporting/laendertabelle
1638713100,24672,21358,3314,4822,2567,https://www.intensivregister.de/api/public/reporting/laendertabelle
1638716700,24674,21358,3316,4822,2567,https://www.intensivregister.de/api/public/reporting/laendertabelle
1638720300,24673,21351,3322,4822,2568,https://www.intensivregister.de/api/public/reporting/laendertabelle
1638727500,24673,21350,3323,4823,2569,https://www.intensivregister.de/api/public/reporting/laendertabelle
1638734700,24673,21351,3322,4823,2569,https://www.intensivregister.de/api/public/reporting/laendertabelle
1638738300,24673,21352,3321,4823,2569,https://www.intensivregister.de/api/public/reporting/laendertabelle
1638741900,24673,21351,3322,4823,2569,https://www.intensivregister.de/api/public/reporting/laendertabelle
1638745500,24676,21355,3321,4821,2570,https://www.intensivregister.de/api/public/reporting/laendertabelle
1638749100,24677,21353,3324,4820,2570,https://www.intensivregister.de/api/public/reporting/laendertabelle
1638752700,24677,21354,3323,4820,2570,https://www.intensivregister.de/api/public/reporting/laendertabelle
1638756300,24677,21357,3320,4824,2570,https://www.intensivregister.de/api/public/reporting/laendertabelle
1638759900,24676,21354,3322,4831,2573,https://www.intensivregister.de/api/public/reporting/laendertabelle
1638763500,24681,21359,3322,4829,2573,https://www.intensivregister.de/api/public/reporting/laendertabelle
1638767100,24689,21391,3298,4836,2574,https://www.intensivregister.de/api/public/reporting/laendertabelle
1638770700,24705,21429,3276,4838,2571,https://www.intensivregister.de/api/public/reporting/laendertabelle
1638787139,24857,21629,3228,4907,2657,https://www.intensivregister.de/api/public/reporting/laendertabelle
1638852152,24899,21694,3205,4921,2657,https://www.intensivregister.de/api/public/reporting/laendertabelle
1638853500,24906,21715,3191,4926,2659,https://www.intensivregister.de/api/public/reporting/laendertabelle
1638857100,24924,21757,3167,4918,2674,https://www.intensivregister.de/api/public/reporting/laendertabelle
1638860700,24961,21826,3135,4916,2688,https://www.intensivregister.de/api/public/reporting/laendertabelle
1638864300,24988,21887,3101,4924,2679,https://www.intensivregister.de/api/public/reporting/laendertabelle
1638867900,25020,21954,3066,4929,2684,https://www.intensivregister.de/api/public/reporting/laendertabelle
1638871500,25033,21974,3059,4949,2700,https://www.intensivregister.de/api/public/reporting/laendertabelle
1638875100,25039,21976,3063,4951,2698,https://www.intensivregister.de/api/public/reporting/laendertabelle
1638878700,25037,21971,3066,4949,2700,https://www.intensivregister.de/api/public/reporting/laendertabelle
1638882300,25039,21974,3065,4950,2700,https://www.intensivregister.de/api/public/reporting/laendertabelle
1638885900,25039,21979,3060,4951,2701,https://www.intensivregister.de/api/public/reporting/laendertabelle
1638889500,25039,21983,3056,4953,2702,https://www.intensivregister.de/api/public/reporting/laendertabelle
1638893100,25039,21980,3059,4950,2701,https://www.intensivregister.de/api/public/reporting/laendertabelle
1638896700,25038,21981,3057,4950,2701,https://www.intensivregister.de/api/public/reporting/laendertabelle
1638900300,25038,21982,3056,4949,2702,https://www.intensivregister.de/api/public/reporting/laendertabelle
1638903900,25039,21987,3052,4950,2702,https://www.intensivregister.de/api/public/reporting/laendertabelle
1638911100,25040,21988,3052,4950,2702,https://www.intensivregister.de/api/public/reporting/laendertabelle
1638918300,25044,21985,3059,4950,2702,https://www.intensivregister.de/api/public/reporting/laendertabelle
1638921900,25044,21984,3060,4949,2701,https://www.intensivregister.de/api/public/reporting/laendertabelle
1638925500,25043,21981,3062,4951,2703,https://www.intensivregister.de/api/public/reporting/laendertabelle
1638929100,25039,21971,3068,4949,2703,https://www.intensivregister.de/api/public/reporting/laendertabelle
1638932700,25038,21974,3064,4945,2707,https://www.intensivregister.de/api/public/reporting/laendertabelle
1638936300,25042,21980,3062,4943,2708,https://www.intensivregister.de/api/public/reporting/laendertabelle
1638939900,25038,21982,3056,4934,2702,https://www.intensivregister.de/api/public/reporting/laendertabelle
1638943500,25049,22042,3007,4935,2709,https://www.intensivregister.de/api/public/reporting/laendertabelle
1638947100,25045,22085,2960,4927,2714,https://www.intensivregister.de/api/public/reporting/laendertabelle
1638950700,25073,22088,2985,4918,2706,https://www.intensivregister.de/api/public/reporting/laendertabelle
1638954300,25086,22091,2995,4910,2714,https://www.intensivregister.de/api/public/reporting/laendertabelle
1638957900,25087,22062,3025,4896,2717,https://www.intensivregister.de/api/public/reporting/laendertabelle
1638961500,25085,22066,3019,4898,2717,https://www.intensivregister.de/api/public/reporting/laendertabelle
1638965100,25086,22068,3018,4895,2716,https://www.intensivregister.de/api/public/reporting/laendertabelle
1638968700,25095,22071,3024,4897,2716,https://www.intensivregister.de/api/public/reporting/laendertabelle
1638972300,25096,22075,3021,4903,2721,https://www.intensivregister.de/api/public/reporting/laendertabelle
1638975900,25096,22076,3020,4901,2723,https://www.intensivregister.de/api/public/reporting/laendertabelle
1638979500,25091,22065,3026,4900,2723,https://www.intensivregister.de/api/public/reporting/laendertabelle
1638983100,25089,22064,3025,4899,2722,https://www.intensivregister.de/api/public/reporting/laendertabelle
1638990300,25089,22067,3022,4900,2722,https://www.intensivregister.de/api/public/reporting/laendertabelle
1639004700,25064,22059,3005,4900,2721,https://www.intensivregister.de/api/public/reporting/laendertabelle
1639008300,25066,22059,3007,4899,2719,https://www.intensivregister.de/api/public/reporting/laendertabelle
1639011900,25066,22067,2999,4901,2720,https://www.intensivregister.de/api/public/reporting/laendertabelle
1639015500,25070,22066,3004,4903,2722,https://www.intensivregister.de/api/public/reporting/laendertabelle
1639019100,25070,22064,3006,4904,2723,https://www.intensivregister.de/api/public/reporting/laendertabelle
1639022700,25070,22060,3010,4903,2723,https://www.intensivregister.de/api/public/reporting/laendertabelle
1639026300,25077,22051,3026,4894,2730,https://www.intensivregister.de/api/public/reporting/laendertabelle
1639029900,25042,22040,3002,4877,2722,https://www.intensivregister.de/api/public/reporting/laendertabelle
1639033500,25018,22050,2968,4888,2733,https://www.intensivregister.de/api/public/reporting/laendertabelle
1639037100,24974,21996,2978,4913,2738,https://www.intensivregister.de/api/public/reporting/laendertabelle
1639040700,24963,22010,2953,4918,2729,https://www.intensivregister.de/api/public/reporting/laendertabelle
1639044300,24967,22018,2949,4944,2732,https://www.intensivregister.de/api/public/reporting/laendertabelle
1639047900,24960,22013,2947,4941,2729,https://www.intensivregister.de/api/public/reporting/laendertabelle
1639051500,24959,22021,2938,4942,2729,https://www.intensivregister.de/api/public/reporting/laendertabelle
1639055100,24958,22015,2943,4938,2726,https://www.intensivregister.de/api/public/reporting/laendertabelle
1639058700,24958,22018,2940,4943,2726,https://www.intensivregister.de/api/public/reporting/laendertabelle
1639062300,24958,22017,2941,4942,2724,https://www.intensivregister.de/api/public/reporting/laendertabelle
1639065900,24961,22020,2941,4942,2724,https://www.intensivregister.de/api/public/reporting/laendertabelle
1639069500,24961,22022,2939,4942,2725,https://www.intensivregister.de/api/public/reporting/laendertabelle
1639073100,24961,22021,2940,4941,2725,https://www.intensivregister.de/api/public/reporting/laendertabelle
1639076700,24961,22022,2939,4941,2725,https://www.intensivregister.de/api/public/reporting/laendertabelle
1639083900,24962,22021,2941,4941,2725,https://www.intensivregister.de/api/public/reporting/laendertabelle
1639087500,24884,21946,2938,4929,2719,https://www.intensivregister.de/api/public/reporting/laendertabelle
1639091100,24885,21950,2935,4927,2719,https://www.intensivregister.de/api/public/reporting/laendertabelle
1639094700,24884,21945,2939,4924,2718,https://www.intensivregister.de/api/public/reporting/laendertabelle
1639098300,24884,21950,2934,4924,2718,https://www.intensivregister.de/api/public/reporting/laendertabelle
1639101900,24883,21941,2942,4923,2717,https://www.intensivregister.de/api/public/reporting/laendertabelle
1639105500,24883,21945,2938,4922,2717,https://www.intensivregister.de/api/public/reporting/laendertabelle
1639109100,24883,21949,2934,4926,2714,https://www.intensivregister.de/api/public/reporting/laendertabelle
1639112700,24874,21903,2971,4923,2717,https://www.intensivregister.de/api/public/reporting/laendertabelle
1639116300,24874,21889,2985,4930,2716,https://www.intensivregister.de/api/public/reporting/laendertabelle
1639119900,24891,21909,2982,4955,2698,https://www.intensivregister.de/api/public/reporting/laendertabelle
1639123500,24866,21883,2983,4955,2717,https://www.intensivregister.de/api/public/reporting/laendertabelle
1639127100,24846,21863,2983,4942,2701,https://www.intensivregister.de/api/public/reporting/laendertabelle
1639130700,24841,21858,2983,4948,2703,https://www.intensivregister.de/api/public/reporting/laendertabelle
1639134300,24840,21849,2991,4947,2700,https://www.intensivregister.de/api/public/reporting/laendertabelle
1639137900,24845,21846,2999,4948,2701,https://www.intensivregister.de/api/public/reporting/laendertabelle
1639141500,24839,21838,3001,4950,2702,https://www.intensivregister.de/api/public/reporting/laendertabelle
1639145100,24837,21829,3008,4948,2701,https://www.intensivregister.de/api/public/reporting/laendertabelle
1639148700,24837,21832,3005,4947,2701,https://www.intensivregister.de/api/public/reporting/laendertabelle
1639152300,24924,21916,3008,4959,2708,https://www.intensivregister.de/api/public/reporting/laendertabelle
1639155900,24932,21927,3005,4960,2708,https://www.intensivregister.de/api/public/reporting/laendertabelle
1639159500,24932,21927,3005,4961,2708,https://www.intensivregister.de/api/public/reporting/laendertabelle
1639163100,24932,21930,3002,4961,2708,https://www.intensivregister.de/api/public/reporting/laendertabelle
1639166700,24932,21931,3001,4961,2709,https://www.intensivregister.de/api/public/reporting/laendertabelle
1639173900,24932,21932,3000,4963,2710,https://www.intensivregister.de/api/public/reporting/laendertabelle
1639177500,24930,21926,3004,4962,2712,https://www.intensivregister.de/api/public/reporting/laendertabelle
1639181100,24926,21929,2997,4963,2713,https://www.intensivregister.de/api/public/reporting/laendertabelle
1639184700,24929,21933,2996,4961,2710,https://www.intensivregister.de/api/public/reporting/laendertabelle
1639188300,24931,21935,2996,4960,2714,https://www.intensivregister.de/api/public/reporting/laendertabelle
1639191900,24930,21931,2999,4961,2714,https://www.intensivregister.de/api/public/reporting/laendertabelle
1639195500,24932,21930,3002,4963,2715,https://www.intensivregister.de/api/public/reporting/laendertabelle
1639199100,24937,21929,3008,4958,2718,https://www.intensivregister.de/api/public/reporting/laendertabelle
1639202700,24921,21907,3014,4969,2710,https://www.intensivregister.de/api/public/reporting/laendertabelle
1639206300,24875,21852,3023,4939,2699,https://www.intensivregister.de/api/public/reporting/laendertabelle
1639209900,24829,21786,3043,4903,2690,https://www.intensivregister.de/api/public/reporting/laendertabelle
1639213500,24774,21726,3048,4900,2685,https://www.intensivregister.de/api/public/reporting/laendertabelle
1639217100,24772,21680,3092,4905,2705,https://www.intensivregister.de/api/public/reporting/laendertabelle
1639220700,24769,21677,3092,4898,2706,https://www.intensivregister.de/api/public/reporting/laendertabelle
1639224300,24763,21672,3091,4898,2708,https://www.intensivregister.de/api/public/reporting/laendertabelle
1639227900,24763,21672,3091,4899,2708,https://www.intensivregister.de/api/public/reporting/laendertabelle
1639231500,24751,21664,3087,4897,2708,https://www.intensivregister.de/api/public/reporting/laendertabelle
1639235100,24749,21659,3090,4895,2706,https://www.intensivregister.de/api/public/reporting/laendertabelle
1639238700,24749,21661,3088,4895,2706,https://www.intensivregister.de/api/public/reporting/laendertabelle
1639242300,24748,21660,3088,4894,2705,https://www.intensivregister.de/api/public/reporting/laendertabelle
1639245900,24748,21660,3088,4895,2705,https://www.intensivregister.de/api/public/reporting/laendertabelle
1639249500,24748,21659,3089,4893,2704,https://www.intensivregister.de/api/public/reporting/laendertabelle
1639253100,24748,21660,3088,4893,2704,https://www.intensivregister.de/api/public/reporting/laendertabelle
1639260300,24748,21654,3094,4893,2704,https://www.intensivregister.de/api/public/reporting/laendertabelle
1639263900,24749,21640,3109,4895,2704,https://www.intensivregister.de/api/public/reporting/laendertabelle
1639267500,24748,21640,3108,4894,2701,https://www.intensivregister.de/api/public/reporting/laendertabelle
1639271100,24748,21631,3117,4892,2700,https://www.intensivregister.de/api/public/reporting/laendertabelle
1639274700,24748,21630,3118,4897,2700,https://www.intensivregister.de/api/public/reporting/laendertabelle
1639278300,24749,21629,3120,4899,2702,https://www.intensivregister.de/api/public/reporting/laendertabelle
1639281900,24748,21623,3125,4899,2701,https://www.intensivregister.de/api/public/reporting/laendertabelle
1639285500,24734,21597,3137,4891,2705,https://www.intensivregister.de/api/public/reporting/laendertabelle
1639289100,24727,21582,3145,4883,2725,https://www.intensivregister.de/api/public/reporting/laendertabelle
1639292700,24716,21540,3176,4897,2722,https://www.intensivregister.de/api/public/reporting/laendertabelle
1639296300,24671,21464,3207,4904,2732,https://www.intensivregister.de/api/public/reporting/laendertabelle
1639299900,24666,21417,3249,4903,2723,https://www.intensivregister.de/api/public/reporting/laendertabelle
1639303500,24656,21410,3246,4905,2726,https://www.intensivregister.de/api/public/reporting/laendertabelle
1639307100,24661,21411,3250,4908,2725,https://www.intensivregister.de/api/public/reporting/laendertabelle
1639310700,24661,21408,3253,4907,2723,https://www.intensivregister.de/api/public/reporting/laendertabelle
1639314300,24676,21419,3257,4904,2723,https://www.intensivregister.de/api/public/reporting/laendertabelle
1639317900,24677,21419,3258,4904,2723,https://www.intensivregister.de/api/public/reporting/laendertabelle
1639321500,24677,21419,3258,4902,2722,https://www.intensivregister.de/api/public/reporting/laendertabelle
1639325100,24678,21420,3258,4900,2723,https://www.intensivregister.de/api/public/reporting/laendertabelle
1639328700,24678,21418,3260,4899,2723,https://www.intensivregister.de/api/public/reporting/laendertabelle
1639332300,24678,21417,3261,4898,2722,https://www.intensivregister.de/api/public/reporting/laendertabelle
1639335900,24678,21417,3261,4899,2726,https://www.intensivregister.de/api/public/reporting/laendertabelle
1639339500,24681,21419,3262,4899,2726,https://www.intensivregister.de/api/public/reporting/laendertabelle
1639350300,24680,21416,3264,4897,2725,https://www.intensivregister.de/api/public/reporting/laendertabelle
1639353900,24678,21417,3261,4896,2727,https://www.intensivregister.de/api/public/reporting/laendertabelle
1639357500,24678,21417,3261,4897,2727,https://www.intensivregister.de/api/public/reporting/laendertabelle
1639361100,24679,21417,3262,4895,2727,https://www.intensivregister.de/api/public/reporting/laendertabelle
1639364700,24678,21417,3261,4895,2727,https://www.intensivregister.de/api/public/reporting/laendertabelle
1639368300,24680,21418,3262,4894,2724,https://www.intensivregister.de/api/public/reporting/laendertabelle
1639371900,24718,21407,3311,4899,2717,https://www.intensivregister.de/api/public/reporting/laendertabelle
1639375500,24760,21411,3349,4901,2715,https://www.intensivregister.de/api/public/reporting/laendertabelle
1639379100,24793,21481,3312,4909,2725,https://www.intensivregister.de/api/public/reporting/laendertabelle
1639382700,24822,21483,3339,4931,2733,https://www.intensivregister.de/api/public/reporting/laendertabelle
1639386300,24824,21503,3321,4937,2735,https://www.intensivregister.de/api/public/reporting/laendertabelle
1639389900,24832,21520,3312,4927,2733,https://www.intensivregister.de/api/public/reporting/laendertabelle
1639393500,24830,21509,3321,4929,2736,https://www.intensivregister.de/api/public/reporting/laendertabelle
1639397100,24832,21506,3326,4929,2737,https://www.intensivregister.de/api/public/reporting/laendertabelle
1639400700,24832,21505,3327,4928,2736,https://www.intensivregister.de/api/public/reporting/laendertabelle
1639404300,24839,21509,3330,4931,2738,https://www.intensivregister.de/api/public/reporting/laendertabelle
1639407900,24854,21522,3332,4931,2739,https://www.intensivregister.de/api/public/reporting/laendertabelle
1639411500,24853,21521,3332,4929,2738,https://www.intensivregister.de/api/public/reporting/laendertabelle
1639418700,24853,21527,3326,4930,2738,https://www.intensivregister.de/api/public/reporting/laendertabelle
1639422300,24853,21524,3329,4929,2738,https://www.intensivregister.de/api/public/reporting/laendertabelle
1639433100,24810,21484,3326,4914,2726,https://www.intensivregister.de/api/public/reporting/laendertabelle
1639436700,24833,21494,3339,4908,2723,https://www.intensivregister.de/api/public/reporting/laendertabelle
1639440300,24833,21490,3343,4908,2723,https://www.intensivregister.de/api/public/reporting/laendertabelle
1639443900,24833,21495,3338,4908,2724,https://www.intensivregister.de/api/public/reporting/laendertabelle
1639447500,24833,21493,3340,4908,2724,https://www.intensivregister.de/api/public/reporting/laendertabelle
1639451100,24833,21499,3334,4908,2723,https://www.intensivregister.de/api/public/reporting/laendertabelle
1639454700,24833,21518,3315,4904,2723,https://www.intensivregister.de/api/public/reporting/laendertabelle
1639458300,24857,21551,3306,4898,2728,https://www.intensivregister.de/api/public/reporting/laendertabelle
1639461900,24854,21637,3217,4904,2741,https://www.intensivregister.de/api/public/reporting/laendertabelle
1639465500,24903,21750,3153,4896,2739,https://www.intensivregister.de/api/public/reporting/laendertabelle
1639469100,24935,21802,3133,4889,2727,https://www.intensivregister.de/api/public/reporting/laendertabelle
1639472700,24984,21891,3093,4884,2716,https://www.intensivregister.de/api/public/reporting/laendertabelle
1639476300,25011,21884,3127,4890,2713,https://www.intensivregister.de/api/public/reporting/laendertabelle
1639479900,25010,21906,3104,4887,2711,https://www.intensivregister.de/api/public/reporting/laendertabelle
1639483500,25009,21906,3103,4886,2723,https://www.intensivregister.de/api/public/reporting/laendertabelle
1639487100,25009,21909,3100,4887,2724,https://www.intensivregister.de/api/public/reporting/laendertabelle
1639490700,25010,21913,3097,4885,2725,https://www.intensivregister.de/api/public/reporting/laendertabelle
1639494300,25009,21910,3099,4882,2725,https://www.intensivregister.de/api/public/reporting/laendertabelle
1639497900,25017,21920,3097,4884,2727,https://www.intensivregister.de/api/public/reporting/laendertabelle
1639501500,25021,21918,3103,4880,2726,https://www.intensivregister.de/api/public/reporting/laendertabelle
1639508700,25021,21914,3107,4880,2727,https://www.intensivregister.de/api/public/reporting/laendertabelle
1639515900,25021,21912,3109,4880,2727,https://www.intensivregister.de/api/public/reporting/laendertabelle
1639519500,25022,21910,3112,4880,2727,https://www.intensivregister.de/api/public/reporting/laendertabelle
1639523100,25021,21908,3113,4879,2727,https://www.intensivregister.de/api/public/reporting/laendertabelle
1639526700,25019,21904,3115,4879,2727,https://www.intensivregister.de/api/public/reporting/laendertabelle
1639530300,25021,21908,3113,4881,2727,https://www.intensivregister.de/api/public/reporting/laendertabelle
1639533900,25021,21906,3115,4881,2728,https://www.intensivregister.de/api/public/reporting/laendertabelle
1639541100,25021,21921,3100,4882,2730,https://www.intensivregister.de/api/public/reporting/laendertabelle
1639544700,25011,21913,3098,4873,2726,https://www.intensivregister.de/api/public/reporting/laendertabelle
1639548300,25006,21877,3129,4858,2720,https://www.intensivregister.de/api/public/reporting/laendertabelle
1639551900,24980,21865,3115,4814,2701,https://www.intensivregister.de/api/public/reporting/laendertabelle
1639555500,24989,21872,3117,4822,2691,https://www.intensivregister.de/api/public/reporting/laendertabelle
1639559100,25008,21922,3086,4817,2699,https://www.intensivregister.de/api/public/reporting/laendertabelle
1639562700,25007,21928,3079,4807,2695,https://www.intensivregister.de/api/public/reporting/laendertabelle
1639566300,25009,21923,3086,4808,2692,https://www.intensivregister.de/api/public/reporting/laendertabelle
1639569900,25009,21919,3090,4807,2694,https://www.intensivregister.de/api/public/reporting/laendertabelle
1639573500,25009,21919,3090,4804,2694,https://www.intensivregister.de/api/public/reporting/laendertabelle
1639577100,25013,21929,3084,4805,2697,https://www.intensivregister.de/api/public/reporting/laendertabelle
1639580700,25013,21939,3074,4809,2699,https://www.intensivregister.de/api/public/reporting/laendertabelle
1639584300,25001,21932,3069,4809,2698,https://www.intensivregister.de/api/public/reporting/laendertabelle
1639587900,25001,21931,3070,4809,2698,https://www.intensivregister.de/api/public/reporting/laendertabelle
1639598700,25001,21932,3069,4806,2697,https://www.intensivregister.de/api/public/reporting/laendertabelle
1639605900,25001,21934,3067,4806,2697,https://www.intensivregister.de/api/public/reporting/laendertabelle
1639609500,25005,21937,3068,4806,2698,https://www.intensivregister.de/api/public/reporting/laendertabelle
1639613100,25005,21939,3066,4805,2699,https://www.intensivregister.de/api/public/reporting/laendertabelle
1639616700,25005,21939,3066,4807,2699,https://www.intensivregister.de/api/public/reporting/laendertabelle
1639620300,25004,21945,3059,4803,2695,https://www.intensivregister.de/api/public/reporting/laendertabelle
1639623900,25003,21952,3051,4803,2695,https://www.intensivregister.de/api/public/reporting/laendertabelle
1639627500,25002,21954,3048,4802,2693,https://www.intensivregister.de/api/public/reporting/laendertabelle
1639631100,25006,21922,3084,4796,2685,https://www.intensivregister.de/api/public/reporting/laendertabelle
1639634700,25003,21871,3132,4785,2667,https://www.intensivregister.de/api/public/reporting/laendertabelle
1639638300,25019,21880,3139,4787,2663,https://www.intensivregister.de/api/public/reporting/laendertabelle
1639641900,24999,21854,3145,4788,2662,https://www.intensivregister.de/api/public/reporting/laendertabelle
1639645500,24989,21830,3159,4755,2663,https://www.intensivregister.de/api/public/reporting/laendertabelle
1639649100,24977,21807,3170,4763,2659,https://www.intensivregister.de/api/public/reporting/laendertabelle
1639652700,24976,21797,3179,4764,2661,https://www.intensivregister.de/api/public/reporting/laendertabelle
1639656300,24976,21794,3182,4765,2662,https://www.intensivregister.de/api/public/reporting/laendertabelle
1639659900,24965,21788,3177,4766,2663,https://www.intensivregister.de/api/public/reporting/laendertabelle
1639663500,24967,21789,3178,4769,2664,https://www.intensivregister.de/api/public/reporting/laendertabelle
1639667100,24967,21788,3179,4767,2659,https://www.intensivregister.de/api/public/reporting/laendertabelle
1639670700,24967,21787,3180,4766,2658,https://www.intensivregister.de/api/public/reporting/laendertabelle
1639674300,24967,21785,3182,4767,2658,https://www.intensivregister.de/api/public/reporting/laendertabelle
1639677900,24979,21792,3187,4768,2658,https://www.intensivregister.de/api/public/reporting/laendertabelle
1639681500,24977,21790,3187,4768,2658,https://www.intensivregister.de/api/public/reporting/laendertabelle
1639688700,24977,21791,3186,4769,2658,https://www.intensivregister.de/api/public/reporting/laendertabelle
1639692300,24977,21789,3188,4768,2657,https://www.intensivregister.de/api/public/reporting/laendertabelle
1639695900,24977,21793,3184,4768,2657,https://www.intensivregister.de/api/public/reporting/laendertabelle
1639699500,24979,21796,3183,4768,2658,https://www.intensivregister.de/api/public/reporting/laendertabelle
1639703100,24980,21803,3177,4768,2658,https://www.intensivregister.de/api/public/reporting/laendertabelle
1639706700,24981,21797,3184,4766,2657,https://www.intensivregister.de/api/public/reporting/laendertabelle
1639710300,24979,21794,3185,4762,2657,https://www.intensivregister.de/api/public/reporting/laendertabelle
1639713900,24977,21780,3197,4754,2652,https://www.intensivregister.de/api/public/reporting/laendertabelle
1639717500,24965,21812,3153,4758,2650,https://www.intensivregister.de/api/public/reporting/laendertabelle
1639721100,24946,21809,3137,4746,2641,https://www.intensivregister.de/api/public/reporting/laendertabelle
1639724700,24945,21761,3184,4715,2640,https://www.intensivregister.de/api/public/reporting/laendertabelle
1639728300,24934,21728,3206,4697,2648,https://www.intensivregister.de/api/public/reporting/laendertabelle
1639731900,24944,21732,3212,4688,2648,https://www.intensivregister.de/api/public/reporting/laendertabelle
1639735500,24936,21698,3238,4676,2641,https://www.intensivregister.de/api/public/reporting/laendertabelle
1639739100,24930,21689,3241,4676,2641,https://www.intensivregister.de/api/public/reporting/laendertabelle
1639742700,24934,21694,3240,4679,2645,https://www.intensivregister.de/api/public/reporting/laendertabelle
1639746300,24937,21698,3239,4681,2646,https://www.intensivregister.de/api/public/reporting/laendertabelle
1639749900,24935,21688,3247,4679,2645,https://www.intensivregister.de/api/public/reporting/laendertabelle
1639753500,24935,21687,3248,4678,2647,https://www.intensivregister.de/api/public/reporting/laendertabelle
1639757100,24936,21689,3247,4679,2648,https://www.intensivregister.de/api/public/reporting/laendertabelle
1639760700,24936,21688,3248,4679,2648,https://www.intensivregister.de/api/public/reporting/laendertabelle
1639767900,24936,21683,3253,4681,2648,https://www.intensivregister.de/api/public/reporting/laendertabelle
1639778700,24936,21679,3257,4681,2648,https://www.intensivregister.de/api/public/reporting/laendertabelle
1639782300,24936,21673,3263,4677,2648,https://www.intensivregister.de/api/public/reporting/laendertabelle
1639785900,24931,21667,3264,4678,2648,https://www.intensivregister.de/api/public/reporting/laendertabelle
1639789500,24932,21662,3270,4678,2648,https://www.intensivregister.de/api/public/reporting/laendertabelle
1639793100,24930,21666,3264,4678,2648,https://www.intensivregister.de/api/public/reporting/laendertabelle
1639796700,24933,21674,3259,4682,2648,https://www.intensivregister.de/api/public/reporting/laendertabelle
1639800300,24929,21674,3255,4684,2649,https://www.intensivregister.de/api/public/reporting/laendertabelle
1639803900,24937,21662,3275,4684,2650,https://www.intensivregister.de/api/public/reporting/laendertabelle
1639807500,24935,21607,3328,4685,2647,https://www.intensivregister.de/api/public/reporting/laendertabelle
1639811100,24927,21584,3343,4666,2645,https://www.intensivregister.de/api/public/reporting/laendertabelle
1639814700,24882,21497,3385,4666,2664,https://www.intensivregister.de/api/public/reporting/laendertabelle
1639818300,24824,21450,3374,4656,2665,https://www.intensivregister.de/api/public/reporting/laendertabelle
1639821900,24768,21398,3370,4649,2661,https://www.intensivregister.de/api/public/reporting/laendertabelle
1639825500,24767,21397,3370,4652,2663,https://www.intensivregister.de/api/public/reporting/laendertabelle
1639829100,24754,21384,3370,4649,2664,https://www.intensivregister.de/api/public/reporting/laendertabelle
1639832700,24753,21383,3370,4651,2666,https://www.intensivregister.de/api/public/reporting/laendertabelle
1639836300,24752,21381,3371,4647,2661,https://www.intensivregister.de/api/public/reporting/laendertabelle
1639839900,24752,21383,3369,4649,2663,https://www.intensivregister.de/api/public/reporting/laendertabelle
1639843500,24752,21388,3364,4651,2663,https://www.intensivregister.de/api/public/reporting/laendertabelle
1639861500,24752,21386,3366,4650,2663,https://www.intensivregister.de/api/public/reporting/laendertabelle
1639865100,24752,21383,3369,4649,2663,https://www.intensivregister.de/api/public/reporting/laendertabelle
1639868700,24753,21384,3369,4649,2664,https://www.intensivregister.de/api/public/reporting/laendertabelle
1639872300,24755,21381,3374,4649,2663,https://www.intensivregister.de/api/public/reporting/laendertabelle
1639875900,24753,21377,3376,4650,2664,https://www.intensivregister.de/api/public/reporting/laendertabelle
1639879500,24754,21377,3377,4649,2665,https://www.intensivregister.de/api/public/reporting/laendertabelle
1639883100,24754,21376,3378,4649,2665,https://www.intensivregister.de/api/public/reporting/laendertabelle
1639886700,24751,21371,3380,4647,2665,https://www.intensivregister.de/api/public/reporting/laendertabelle
1639890300,24751,21369,3382,4643,2667,https://www.intensivregister.de/api/public/reporting/laendertabelle
1639893900,24738,21347,3391,4628,2655,https://www.intensivregister.de/api/public/reporting/laendertabelle
1639897500,24726,21285,3441,4618,2644,https://www.intensivregister.de/api/public/reporting/laendertabelle
1639901100,24719,21200,3519,4618,2638,https://www.intensivregister.de/api/public/reporting/laendertabelle
1639904700,24701,21161,3540,4622,2639,https://www.intensivregister.de/api/public/reporting/laendertabelle
1639908300,24677,21116,3561,4619,2634,https://www.intensivregister.de/api/public/reporting/laendertabelle
1639911900,24680,21104,3576,4621,2631,https://www.intensivregister.de/api/public/reporting/laendertabelle
1639915500,24679,21097,3582,4616,2630,https://www.intensivregister.de/api/public/reporting/laendertabelle
1639919100,24678,21097,3581,4616,2630,https://www.intensivregister.de/api/public/reporting/laendertabelle
1639922700,24677,21096,3581,4618,2631,https://www.intensivregister.de/api/public/reporting/laendertabelle
1639933500,24677,21100,3577,4618,2635,https://www.intensivregister.de/api/public/reporting/laendertabelle
1639940700,24676,21100,3576,4618,2635,https://www.intensivregister.de/api/public/reporting/laendertabelle
1639947900,24676,21099,3577,4619,2636,https://www.intensivregister.de/api/public/reporting/laendertabelle
1639951500,24676,21098,3578,4619,2636,https://www.intensivregister.de/api/public/reporting/laendertabelle
1639955100,24672,21089,3583,4619,2635,https://www.intensivregister.de/api/public/reporting/laendertabelle
1639958700,24673,21090,3583,4618,2634,https://www.intensivregister.de/api/public/reporting/laendertabelle
1639962300,24672,21086,3586,4617,2634,https://www.intensivregister.de/api/public/reporting/laendertabelle
1639965900,24668,21082,3586,4615,2630,https://www.intensivregister.de/api/public/reporting/laendertabelle
1639969500,24665,21072,3593,4614,2631,https://www.intensivregister.de/api/public/reporting/laendertabelle
1639973100,24668,21080,3588,4613,2631,https://www.intensivregister.de/api/public/reporting/laendertabelle
1639976700,24668,21089,3579,4615,2635,https://www.intensivregister.de/api/public/reporting/laendertabelle
1639980300,24704,21092,3612,4609,2618,https://www.intensivregister.de/api/public/reporting/laendertabelle
1639983900,24784,21150,3634,4603,2638,https://www.intensivregister.de/api/public/reporting/laendertabelle
1639987500,24810,21197,3613,4607,2662,https://www.intensivregister.de/api/public/reporting/laendertabelle
1639991100,24843,21215,3628,4609,2657,https://www.intensivregister.de/api/public/reporting/laendertabelle
1639994700,24854,21218,3636,4611,2662,https://www.intensivregister.de/api/public/reporting/laendertabelle
1639998300,24861,21218,3643,4619,2662,https://www.intensivregister.de/api/public/reporting/laendertabelle
1640001900,24854,21212,3642,4615,2662,https://www.intensivregister.de/api/public/reporting/laendertabelle
1640005500,24856,21210,3646,4614,2664,https://www.intensivregister.de/api/public/reporting/laendertabelle
1640009100,24858,21210,3648,4616,2665,https://www.intensivregister.de/api/public/reporting/laendertabelle
1640012700,24860,21217,3643,4617,2664,https://www.intensivregister.de/api/public/reporting/laendertabelle
1640016300,24860,21219,3641,4619,2664,https://www.intensivregister.de/api/public/reporting/laendertabelle
1640023500,24860,21221,3639,4620,2665,https://www.intensivregister.de/api/public/reporting/laendertabelle
1640027100,24860,21221,3639,4619,2664,https://www.intensivregister.de/api/public/reporting/laendertabelle
1640030700,24860,21222,3638,4619,2664,https://www.intensivregister.de/api/public/reporting/laendertabelle
1640034300,24859,21220,3639,4619,2664,https://www.intensivregister.de/api/public/reporting/laendertabelle
1640037900,24859,21221,3638,4619,2664,https://www.intensivregister.de/api/public/reporting/laendertabelle
1640041500,24859,21222,3637,4615,2663,https://www.intensivregister.de/api/public/reporting/laendertabelle
1640045100,24862,21230,3632,4616,2663,https://www.intensivregister.de/api/public/reporting/laendertabelle
1640048700,24862,21237,3625,4617,2664,https://www.intensivregister.de/api/public/reporting/laendertabelle
1640052300,24865,21250,3615,4614,2662,https://www.intensivregister.de/api/public/reporting/laendertabelle
1640055900,24867,21251,3616,4612,2664,https://www.intensivregister.de/api/public/reporting/laendertabelle
1640059500,24874,21265,3609,4608,2663,https://www.intensivregister.de/api/public/reporting/laendertabelle
1640063100,24876,21277,3599,4595,2659,https://www.intensivregister.de/api/public/reporting/laendertabelle
1640066700,24897,21345,3552,4577,2653,https://www.intensivregister.de/api/public/reporting/laendertabelle
1640070300,24908,21366,3542,4559,2636,https://www.intensivregister.de/api/public/reporting/laendertabelle
1640073900,24929,21447,3482,4565,2637,https://www.intensivregister.de/api/public/reporting/laendertabelle
1640077500,24954,21493,3461,4559,2644,https://www.intensivregister.de/api/public/reporting/laendertabelle
1640081100,24959,21523,3436,4564,2639,https://www.intensivregister.de/api/public/reporting/laendertabelle
1640084700,24959,21524,3435,4564,2640,https://www.intensivregister.de/api/public/reporting/laendertabelle
1640088300,24954,21524,3430,4566,2640,https://www.intensivregister.de/api/public/reporting/laendertabelle
1640091900,24955,21525,3430,4565,2639,https://www.intensivregister.de/api/public/reporting/laendertabelle
1640095500,24953,21512,3441,4566,2640,https://www.intensivregister.de/api/public/reporting/laendertabelle
1640099100,24951,21509,3442,4563,2640,https://www.intensivregister.de/api/public/reporting/laendertabelle
1640102700,24950,21511,3439,4563,2640,https://www.intensivregister.de/api/public/reporting/laendertabelle
1640107238,24950,21515,3435,4563,2640,https://www.intensivregister.de/api/public/reporting/laendertabelle
1640113500,24948,21513,3435,4564,2640,https://www.intensivregister.de/api/public/reporting/laendertabelle
1640127900,24950,21510,3440,4562,2639,https://www.intensivregister.de/api/public/reporting/laendertabelle
1640131500,24950,21505,3445,4561,2638,https://www.intensivregister.de/api/public/reporting/laendertabelle
1640135100,24948,21502,3446,4558,2636,https://www.intensivregister.de/api/public/reporting/laendertabelle
1640138700,24943,21491,3452,4555,2632,https://www.intensivregister.de/api/public/reporting/laendertabelle
1640142300,24943,21492,3451,4554,2632,https://www.intensivregister.de/api/public/reporting/laendertabelle
1640145900,24943,21496,3447,4559,2633,https://www.intensivregister.de/api/public/reporting/laendertabelle
1640149500,24941,21473,3468,4546,2634,https://www.intensivregister.de/api/public/reporting/laendertabelle
1640153100,24946,21430,3516,4536,2613,https://www.intensivregister.de/api/public/reporting/laendertabelle
1640156700,24946,21364,3582,4505,2607,https://www.intensivregister.de/api/public/reporting/laendertabelle
1640160300,24966,21358,3608,4500,2600,https://www.intensivregister.de/api/public/reporting/laendertabelle
1640163900,24950,21313,3637,4482,2615,https://www.intensivregister.de/api/public/reporting/laendertabelle
1640167500,24936,21296,3640,4473,2608,https://www.intensivregister.de/api/public/reporting/laendertabelle
1640171100,24943,21296,3647,4472,2613,https://www.intensivregister.de/api/public/reporting/laendertabelle
1640174700,24943,21295,3648,4470,2614,https://www.intensivregister.de/api/public/reporting/laendertabelle
1640178300,24937,21289,3648,4470,2614,https://www.intensivregister.de/api/public/reporting/laendertabelle
1640181900,24937,21286,3651,4467,2611,https://www.intensivregister.de/api/public/reporting/laendertabelle
1640185500,24913,21260,3653,4466,2611,https://www.intensivregister.de/api/public/reporting/laendertabelle
1640192700,24913,21264,3649,4468,2613,https://www.intensivregister.de/api/public/reporting/laendertabelle
1640199900,24913,21263,3650,4467,2614,https://www.intensivregister.de/api/public/reporting/laendertabelle
1640210700,24873,21227,3646,4462,2612,https://www.intensivregister.de/api/public/reporting/laendertabelle
1640214300,24873,21230,3643,4461,2612,https://www.intensivregister.de/api/public/reporting/laendertabelle
1640217900,24873,21230,3643,4459,2612,https://www.intensivregister.de/api/public/reporting/laendertabelle
1640221500,24873,21226,3647,4461,2612,https://www.intensivregister.de/api/public/reporting/laendertabelle
1640225100,24874,21224,3650,4461,2611,https://www.intensivregister.de/api/public/reporting/laendertabelle
1640228700,24872,21215,3657,4458,2607,https://www.intensivregister.de/api/public/reporting/laendertabelle
1640232300,24870,21202,3668,4454,2603,https://www.intensivregister.de/api/public/reporting/laendertabelle
1640235900,24860,21193,3667,4457,2611,https://www.intensivregister.de/api/public/reporting/laendertabelle
1640239500,24893,21173,3720,4437,2616,https://www.intensivregister.de/api/public/reporting/laendertabelle
1640243100,24882,21136,3746,4402,2617,https://www.intensivregister.de/api/public/reporting/laendertabelle
1640246700,24870,21116,3754,4388,2607,https://www.intensivregister.de/api/public/reporting/laendertabelle
1640250300,24863,21081,3782,4383,2586,https://www.intensivregister.de/api/public/reporting/laendertabelle
1640253900,24876,21109,3767,4382,2588,https://www.intensivregister.de/api/public/reporting/laendertabelle
1640257500,24873,21105,3768,4384,2589,https://www.intensivregister.de/api/public/reporting/laendertabelle
1640261100,24874,21106,3768,4383,2589,https://www.intensivregister.de/api/public/reporting/laendertabelle
1640264700,24874,21100,3774,4383,2589,https://www.intensivregister.de/api/public/reporting/laendertabelle
1640268300,24873,21102,3771,4382,2589,https://www.intensivregister.de/api/public/reporting/laendertabelle
1640271900,24873,21100,3773,4383,2587,https://www.intensivregister.de/api/public/reporting/laendertabelle
1640275500,24873,21104,3769,4383,2587,https://www.intensivregister.de/api/public/reporting/laendertabelle
1640279100,24872,21102,3770,4382,2588,https://www.intensivregister.de/api/public/reporting/laendertabelle
1640282700,24872,21103,3769,4382,2588,https://www.intensivregister.de/api/public/reporting/laendertabelle
1640286300,24872,21105,3767,4384,2588,https://www.intensivregister.de/api/public/reporting/laendertabelle
1640293500,24872,21104,3768,4383,2586,https://www.intensivregister.de/api/public/reporting/laendertabelle
1640297100,24874,21106,3768,4385,2586,https://www.intensivregister.de/api/public/reporting/laendertabelle
1640300700,24874,21105,3769,4389,2584,https://www.intensivregister.de/api/public/reporting/laendertabelle
1640304300,24875,21102,3773,4387,2584,https://www.intensivregister.de/api/public/reporting/laendertabelle
1640307900,24877,21102,3775,4387,2585,https://www.intensivregister.de/api/public/reporting/laendertabelle
1640311500,24876,21101,3775,4386,2586,https://www.intensivregister.de/api/public/reporting/laendertabelle
1640315100,24877,21106,3771,4385,2588,https://www.intensivregister.de/api/public/reporting/laendertabelle
1640318700,24874,21115,3759,4389,2590,https://www.intensivregister.de/api/public/reporting/laendertabelle
1640322300,24869,21119,3750,4381,2580,https://www.intensivregister.de/api/public/reporting/laendertabelle
1640325900,24846,21079,3767,4363,2569,https://www.intensivregister.de/api/public/reporting/laendertabelle
1640329500,24778,20875,3903,4320,2539,https://www.intensivregister.de/api/public/reporting/laendertabelle
1640333100,24745,20789,3956,4292,2528,https://www.intensivregister.de/api/public/reporting/laendertabelle
1640336700,24720,20726,3994,4287,2525,https://www.intensivregister.de/api/public/reporting/laendertabelle
1640340300,24731,20670,4061,4279,2518,https://www.intensivregister.de/api/public/reporting/laendertabelle
1640343900,24725,20654,4071,4280,2520,https://www.intensivregister.de/api/public/reporting/laendertabelle
1640347500,24723,20639,4084,4282,2520,https://www.intensivregister.de/api/public/reporting/laendertabelle
1640351100,24721,20637,4084,4281,2520,https://www.intensivregister.de/api/public/reporting/laendertabelle
1640354700,24721,20634,4087,4281,2520,https://www.intensivregister.de/api/public/reporting/laendertabelle
1640358300,24721,20632,4089,4280,2520,https://www.intensivregister.de/api/public/reporting/laendertabelle
1640361900,24720,20632,4088,4281,2520,https://www.intensivregister.de/api/public/reporting/laendertabelle
1640369100,24720,20633,4087,4282,2520,https://www.intensivregister.de/api/public/reporting/laendertabelle
1640372700,24721,20634,4087,4282,2521,https://www.intensivregister.de/api/public/reporting/laendertabelle
1640376300,24721,20634,4087,4283,2522,https://www.intensivregister.de/api/public/reporting/laendertabelle
1640379900,24719,20635,4084,4283,2521,https://www.intensivregister.de/api/public/reporting/laendertabelle
1640387100,24719,20642,4077,4284,2521,https://www.intensivregister.de/api/public/reporting/laendertabelle
1640390700,24718,20641,4077,4284,2521,https://www.intensivregister.de/api/public/reporting/laendertabelle
1640394300,24718,20641,4077,4285,2521,https://www.intensivregister.de/api/public/reporting/laendertabelle
1640397900,24721,20643,4078,4285,2523,https://www.intensivregister.de/api/public/reporting/laendertabelle
1640401500,24720,20639,4081,4285,2523,https://www.intensivregister.de/api/public/reporting/laendertabelle
1640405100,24724,20641,4083,4286,2524,https://www.intensivregister.de/api/public/reporting/laendertabelle
1640408700,24726,20634,4092,4289,2526,https://www.intensivregister.de/api/public/reporting/laendertabelle
1640412300,24728,20599,4129,4275,2527,https://www.intensivregister.de/api/public/reporting/laendertabelle
1640415900,24733,20558,4175,4246,2510,https://www.intensivregister.de/api/public/reporting/laendertabelle
1640419500,24716,20535,4181,4272,2510,https://www.intensivregister.de/api/public/reporting/laendertabelle
1640423100,24712,20512,4200,4266,2508,https://www.intensivregister.de/api/public/reporting/laendertabelle
1640426700,24705,20502,4203,4272,2509,https://www.intensivregister.de/api/public/reporting/laendertabelle
1640430300,24717,20506,4211,4270,2512,https://www.intensivregister.de/api/public/reporting/laendertabelle
1640433900,24715,20508,4207,4269,2511,https://www.intensivregister.de/api/public/reporting/laendertabelle
1640437500,24716,20505,4211,4269,2511,https://www.intensivregister.de/api/public/reporting/laendertabelle
1640441100,24716,20497,4219,4269,2511,https://www.intensivregister.de/api/public/reporting/laendertabelle
1640444700,24716,20498,4218,4269,2510,https://www.intensivregister.de/api/public/reporting/laendertabelle
1640451900,24718,20496,4222,4268,2508,https://www.intensivregister.de/api/public/reporting/laendertabelle
1640459100,24718,20491,4227,4268,2508,https://www.intensivregister.de/api/public/reporting/laendertabelle
1640462700,24718,20490,4228,4267,2507,https://www.intensivregister.de/api/public/reporting/laendertabelle
1640466300,24718,20491,4227,4266,2505,https://www.intensivregister.de/api/public/reporting/laendertabelle
1640473500,24718,20490,4228,4265,2504,https://www.intensivregister.de/api/public/reporting/laendertabelle
1640477100,24717,20489,4228,4267,2505,https://www.intensivregister.de/api/public/reporting/laendertabelle
1640480700,24716,20494,4222,4268,2505,https://www.intensivregister.de/api/public/reporting/laendertabelle
1640484300,24714,20488,4226,4270,2506,https://www.intensivregister.de/api/public/reporting/laendertabelle
1640487900,24714,20488,4226,4268,2505,https://www.intensivregister.de/api/public/reporting/laendertabelle
1640491500,24711,20485,4226,4266,2505,https://www.intensivregister.de/api/public/reporting/laendertabelle
1640495100,24705,20483,4222,4266,2500,https://www.intensivregister.de/api/public/reporting/laendertabelle
1640498700,24706,20500,4206,4276,2494,https://www.intensivregister.de/api/public/reporting/laendertabelle
1640502300,24691,20576,4115,4247,2483,https://www.intensivregister.de/api/public/reporting/laendertabelle
1640505900,24695,20608,4087,4251,2482,https://www.intensivregister.de/api/public/reporting/laendertabelle
1640509500,24702,20625,4077,4244,2477,https://www.intensivregister.de/api/public/reporting/laendertabelle
1640513100,24698,20613,4085,4230,2470,https://www.intensivregister.de/api/public/reporting/laendertabelle
1640516700,24697,20615,4082,4229,2470,https://www.intensivregister.de/api/public/reporting/laendertabelle
1640520300,24700,20618,4082,4231,2471,https://www.intensivregister.de/api/public/reporting/laendertabelle
1640523900,24701,20621,4080,4231,2470,https://www.intensivregister.de/api/public/reporting/laendertabelle
1640527500,24700,20620,4080,4231,2470,https://www.intensivregister.de/api/public/reporting/laendertabelle
1640531100,24698,20620,4078,4231,2472,https://www.intensivregister.de/api/public/reporting/laendertabelle
1640534700,24699,20621,4078,4230,2471,https://www.intensivregister.de/api/public/reporting/laendertabelle
1640538300,24699,20619,4080,4230,2470,https://www.intensivregister.de/api/public/reporting/laendertabelle
1640545500,24699,20617,4082,4230,2470,https://www.intensivregister.de/api/public/reporting/laendertabelle
1640549100,24699,20618,4081,4231,2470,https://www.intensivregister.de/api/public/reporting/laendertabelle
1640552700,24699,20616,4083,4231,2470,https://www.intensivregister.de/api/public/reporting/laendertabelle
1640556300,24699,20617,4082,4231,2470,https://www.intensivregister.de/api/public/reporting/laendertabelle
1640559900,24699,20620,4079,4230,2467,https://www.intensivregister.de/api/public/reporting/laendertabelle
1640563500,24700,20623,4077,4229,2467,https://www.intensivregister.de/api/public/reporting/laendertabelle
1640567100,24693,20618,4075,4228,2467,https://www.intensivregister.de/api/public/reporting/laendertabelle
1640570700,24693,20614,4079,4228,2469,https://www.intensivregister.de/api/public/reporting/laendertabelle
1640577900,24697,20615,4082,4229,2471,https://www.intensivregister.de/api/public/reporting/laendertabelle
1640581500,24719,20620,4099,4227,2462,https://www.intensivregister.de/api/public/reporting/laendertabelle
1640585100,24762,20654,4108,4222,2463,https://www.intensivregister.de/api/public/reporting/laendertabelle
1640588700,24756,20685,4071,4188,2444,https://www.intensivregister.de/api/public/reporting/laendertabelle
1640592300,24784,20720,4064,4201,2444,https://www.intensivregister.de/api/public/reporting/laendertabelle
1640595900,24775,20737,4038,4207,2446,https://www.intensivregister.de/api/public/reporting/laendertabelle
1640599500,24778,20732,4046,4203,2443,https://www.intensivregister.de/api/public/reporting/laendertabelle
1640603100,24779,20731,4048,4199,2441,https://www.intensivregister.de/api/public/reporting/laendertabelle
1640606700,24774,20736,4038,4201,2442,https://www.intensivregister.de/api/public/reporting/laendertabelle
1640610300,24775,20740,4035,4199,2441,https://www.intensivregister.de/api/public/reporting/laendertabelle
1640613900,24775,20740,4035,4200,2442,https://www.intensivregister.de/api/public/reporting/laendertabelle
1640617500,24776,20740,4036,4201,2441,https://www.intensivregister.de/api/public/reporting/laendertabelle
1640621100,24776,20741,4035,4201,2441,https://www.intensivregister.de/api/public/reporting/laendertabelle
1640635500,24776,20740,4036,4200,2441,https://www.intensivregister.de/api/public/reporting/laendertabelle
1640642700,24775,20736,4039,4199,2440,https://www.intensivregister.de/api/public/reporting/laendertabelle
1640646300,24772,20733,4039,4195,2440,https://www.intensivregister.de/api/public/reporting/laendertabelle
1640649900,24773,20734,4039,4195,2439,https://www.intensivregister.de/api/public/reporting/laendertabelle
1640653500,24773,20735,4038,4198,2441,https://www.intensivregister.de/api/public/reporting/laendertabelle
1640657100,24773,20729,4044,4199,2442,https://www.intensivregister.de/api/public/reporting/laendertabelle
1640660700,24773,20733,4040,4201,2442,https://www.intensivregister.de/api/public/reporting/laendertabelle
1640664300,24775,20737,4038,4203,2440,https://www.intensivregister.de/api/public/reporting/laendertabelle
1640667900,24768,20750,4018,4192,2429,https://www.intensivregister.de/api/public/reporting/laendertabelle
1640671500,24772,20737,4035,4177,2417,https://www.intensivregister.de/api/public/reporting/laendertabelle
1640675100,24795,20811,3984,4176,2418,https://www.intensivregister.de/api/public/reporting/laendertabelle
1640678700,24807,20817,3990,4143,2397,https://www.intensivregister.de/api/public/reporting/laendertabelle
1640682300,24825,20847,3978,4141,2386,https://www.intensivregister.de/api/public/reporting/laendertabelle
1640685900,24834,20881,3953,4127,2386,https://www.intensivregister.de/api/public/reporting/laendertabelle
1640689500,24839,20878,3961,4126,2383,https://www.intensivregister.de/api/public/reporting/laendertabelle
1640693100,24842,20879,3963,4129,2384,https://www.intensivregister.de/api/public/reporting/laendertabelle
1640696700,24842,20877,3965,4128,2383,https://www.intensivregister.de/api/public/reporting/laendertabelle
1640700300,24842,20876,3966,4127,2383,https://www.intensivregister.de/api/public/reporting/laendertabelle
1640703900,24842,20879,3963,4130,2384,https://www.intensivregister.de/api/public/reporting/laendertabelle
1640714700,24842,20876,3966,4131,2385,https://www.intensivregister.de/api/public/reporting/laendertabelle
1640729100,24842,20873,3969,4131,2385,https://www.intensivregister.de/api/public/reporting/laendertabelle
1640732700,24843,20873,3970,4132,2385,https://www.intensivregister.de/api/public/reporting/laendertabelle
1640736300,24843,20874,3969,4131,2385,https://www.intensivregister.de/api/public/reporting/laendertabelle
1640739900,24840,20872,3968,4131,2386,https://www.intensivregister.de/api/public/reporting/laendertabelle
1640743500,24835,20871,3964,4127,2384,https://www.intensivregister.de/api/public/reporting/laendertabelle
1640747100,24834,20868,3966,4125,2384,https://www.intensivregister.de/api/public/reporting/laendertabelle
1640750700,24840,20864,3976,4122,2384,https://www.intensivregister.de/api/public/reporting/laendertabelle
1640754300,24847,20867,3980,4107,2387,https://www.intensivregister.de/api/public/reporting/laendertabelle
1640757900,24844,20870,3974,4067,2367,https://www.intensivregister.de/api/public/reporting/laendertabelle
1640761500,24813,20843,3970,4025,2367,https://www.intensivregister.de/api/public/reporting/laendertabelle
1640765100,24812,20889,3923,4038,2371,https://www.intensivregister.de/api/public/reporting/laendertabelle
1640768700,24806,20877,3929,4026,2372,https://www.intensivregister.de/api/public/reporting/laendertabelle
1640772300,24804,20904,3900,4014,2367,https://www.intensivregister.de/api/public/reporting/laendertabelle
1640775900,24784,20881,3903,4013,2365,https://www.intensivregister.de/api/public/reporting/laendertabelle
1640779500,24766,20874,3892,4008,2364,https://www.intensivregister.de/api/public/reporting/laendertabelle
1640783100,24731,20851,3880,4008,2364,https://www.intensivregister.de/api/public/reporting/laendertabelle
1640786700,24731,20851,3880,4006,2365,https://www.intensivregister.de/api/public/reporting/laendertabelle
1640790300,24730,20853,3877,4009,2365,https://www.intensivregister.de/api/public/reporting/laendertabelle
1640793900,24729,20853,3876,4009,2365,https://www.intensivregister.de/api/public/reporting/laendertabelle
1640801100,24729,20852,3877,4005,2364,https://www.intensivregister.de/api/public/reporting/laendertabelle
1640808300,24764,20881,3883,4005,2364,https://www.intensivregister.de/api/public/reporting/laendertabelle
1640811900,24764,20882,3882,4005,2364,https://www.intensivregister.de/api/public/reporting/laendertabelle
1640815500,24764,20877,3887,4005,2364,https://www.intensivregister.de/api/public/reporting/laendertabelle
1640819100,24770,20886,3884,4007,2363,https://www.intensivregister.de/api/public/reporting/laendertabelle
1640822700,24770,20884,3886,4006,2362,https://www.intensivregister.de/api/public/reporting/laendertabelle
1640826300,24767,20880,3887,4006,2362,https://www.intensivregister.de/api/public/reporting/laendertabelle
1640829900,24769,20885,3884,4002,2362,https://www.intensivregister.de/api/public/reporting/laendertabelle
1640833500,24768,20885,3883,4004,2358,https://www.intensivregister.de/api/public/reporting/laendertabelle
1640837100,24766,20879,3887,4005,2357,https://www.intensivregister.de/api/public/reporting/laendertabelle
1640840700,24772,20856,3916,3999,2357,https://www.intensivregister.de/api/public/reporting/laendertabelle
1640844300,24757,20792,3965,3965,2332,https://www.intensivregister.de/api/public/reporting/laendertabelle
1640847900,24744,20769,3975,3921,2313,https://www.intensivregister.de/api/public/reporting/laendertabelle
1640851500,24707,20691,4016,3911,2302,https://www.intensivregister.de/api/public/reporting/laendertabelle
1640855100,24699,20701,3998,3912,2298,https://www.intensivregister.de/api/public/reporting/laendertabelle
1640858700,24703,20718,3985,3914,2300,https://www.intensivregister.de/api/public/reporting/laendertabelle
1640862300,24698,20715,3983,3913,2301,https://www.intensivregister.de/api/public/reporting/laendertabelle
1640865900,24698,20716,3982,3918,2303,https://www.intensivregister.de/api/public/reporting/laendertabelle
1640869500,24698,20712,3986,3916,2305,https://www.intensivregister.de/api/public/reporting/laendertabelle
1640873100,24697,20715,3982,3914,2304,https://www.intensivregister.de/api/public/reporting/laendertabelle
1640876700,24697,20713,3984,3914,2304,https://www.intensivregister.de/api/public/reporting/laendertabelle
1640880300,24695,20713,3982,3913,2306,https://www.intensivregister.de/api/public/reporting/laendertabelle
1640887500,24695,20717,3978,3914,2307,https://www.intensivregister.de/api/public/reporting/laendertabelle
1640894700,24695,20718,3977,3913,2307,https://www.intensivregister.de/api/public/reporting/laendertabelle
1640898300,24695,20715,3980,3913,2307,https://www.intensivregister.de/api/public/reporting/laendertabelle
1640901900,24695,20717,3978,3914,2307,https://www.intensivregister.de/api/public/reporting/laendertabelle
1640905500,24695,20717,3978,3913,2307,https://www.intensivregister.de/api/public/reporting/laendertabelle
1640909100,24698,20716,3982,3913,2307,https://www.intensivregister.de/api/public/reporting/laendertabelle
1640912700,24683,20711,3972,3909,2307,https://www.intensivregister.de/api/public/reporting/laendertabelle
1640916300,24681,20719,3962,3909,2305,https://www.intensivregister.de/api/public/reporting/laendertabelle
1640919900,24681,20716,3965,3908,2304,https://www.intensivregister.de/api/public/reporting/laendertabelle
1640923500,24683,20715,3968,3908,2304,https://www.intensivregister.de/api/public/reporting/laendertabelle
1640927100,24682,20705,3977,3912,2308,https://www.intensivregister.de/api/public/reporting/laendertabelle
1640930700,24662,20692,3970,3908,2299,https://www.intensivregister.de/api/public/reporting/laendertabelle
1640934300,24644,20639,4005,3866,2303,https://www.intensivregister.de/api/public/reporting/laendertabelle
1640937900,24636,20627,4009,3845,2282,https://www.intensivregister.de/api/public/reporting/laendertabelle
1640941500,24639,20556,4083,3846,2284,https://www.intensivregister.de/api/public/reporting/laendertabelle
1640945100,24628,20501,4127,3829,2280,https://www.intensivregister.de/api/public/reporting/laendertabelle
1640948700,24634,20497,4137,3826,2280,https://www.intensivregister.de/api/public/reporting/laendertabelle
1640952300,24632,20486,4146,3827,2278,https://www.intensivregister.de/api/public/reporting/laendertabelle
1640955900,24632,20486,4146,3826,2279,https://www.intensivregister.de/api/public/reporting/laendertabelle
1640959500,24631,20487,4144,3826,2282,https://www.intensivregister.de/api/public/reporting/laendertabelle
1640963100,24631,20488,4143,3828,2282,https://www.intensivregister.de/api/public/reporting/laendertabelle
1640966700,24631,20484,4147,3827,2280,https://www.intensivregister.de/api/public/reporting/laendertabelle
1640970300,24632,20483,4149,3826,2279,https://www.intensivregister.de/api/public/reporting/laendertabelle
1640977500,24632,20484,4148,3826,2279,https://www.intensivregister.de/api/public/reporting/laendertabelle
1640981100,24631,20485,4146,3827,2279,https://www.intensivregister.de/api/public/reporting/laendertabelle
1640991900,24631,20482,4149,3828,2278,https://www.intensivregister.de/api/public/reporting/laendertabelle
1640995500,24628,20480,4148,3825,2278,https://www.intensivregister.de/api/public/reporting/laendertabelle
1640999100,24626,20474,4152,3825,2279,https://www.intensivregister.de/api/public/reporting/laendertabelle
1641002700,24631,20473,4158,3824,2279,https://www.intensivregister.de/api/public/reporting/laendertabelle
1641006300,24632,20477,4155,3825,2279,https://www.intensivregister.de/api/public/reporting/laendertabelle
1641009900,24628,20474,4154,3827,2279,https://www.intensivregister.de/api/public/reporting/laendertabelle
1641013500,24629,20461,4168,3819,2277,https://www.intensivregister.de/api/public/reporting/laendertabelle
1641017100,24638,20446,4192,3817,2274,https://www.intensivregister.de/api/public/reporting/laendertabelle
1641020700,24636,20477,4159,3818,2267,https://www.intensivregister.de/api/public/reporting/laendertabelle
1641024300,24609,20434,4175,3825,2248,https://www.intensivregister.de/api/public/reporting/laendertabelle
1641027900,24603,20395,4208,3815,2245,https://www.intensivregister.de/api/public/reporting/laendertabelle
1641031500,24582,20445,4137,3825,2247,https://www.intensivregister.de/api/public/reporting/laendertabelle
1641035100,24588,20435,4153,3821,2244,https://www.intensivregister.de/api/public/reporting/laendertabelle
1641038700,24589,20446,4143,3821,2242,https://www.intensivregister.de/api/public/reporting/laendertabelle
1641042300,24586,20446,4140,3820,2242,https://www.intensivregister.de/api/public/reporting/laendertabelle
1641045900,24582,20442,4140,3821,2243,https://www.intensivregister.de/api/public/reporting/laendertabelle
1641049500,24581,20444,4137,3823,2243,https://www.intensivregister.de/api/public/reporting/laendertabelle
1641053100,24581,20443,4138,3824,2243,https://www.intensivregister.de/api/public/reporting/laendertabelle
1641056700,24581,20444,4137,3824,2243,https://www.intensivregister.de/api/public/reporting/laendertabelle
1641060300,24581,20443,4138,3825,2244,https://www.intensivregister.de/api/public/reporting/laendertabelle
1641063900,24581,20442,4139,3824,2245,https://www.intensivregister.de/api/public/reporting/laendertabelle
1641067500,24581,20443,4138,3823,2245,https://www.intensivregister.de/api/public/reporting/laendertabelle
1641074700,24581,20442,4139,3823,2245,https://www.intensivregister.de/api/public/reporting/laendertabelle
1641078300,24581,20451,4130,3828,2245,https://www.intensivregister.de/api/public/reporting/laendertabelle
1641081900,24581,20449,4132,3829,2245,https://www.intensivregister.de/api/public/reporting/laendertabelle
1641085500,24580,20448,4132,3830,2245,https://www.intensivregister.de/api/public/reporting/laendertabelle
1641089100,24578,20452,4126,3829,2243,https://www.intensivregister.de/api/public/reporting/laendertabelle
1641092700,24579,20454,4125,3828,2243,https://www.intensivregister.de/api/public/reporting/laendertabelle
1641096300,24580,20467,4113,3831,2245,https://www.intensivregister.de/api/public/reporting/laendertabelle
1641099900,24580,20479,4101,3836,2245,https://www.intensivregister.de/api/public/reporting/laendertabelle
1641103500,24580,20459,4121,3831,2236,https://www.intensivregister.de/api/public/reporting/laendertabelle
1641107100,24576,20450,4126,3829,2237,https://www.intensivregister.de/api/public/reporting/laendertabelle
1641110700,24581,20492,4089,3819,2230,https://www.intensivregister.de/api/public/reporting/laendertabelle
1641114300,24589,20492,4097,3802,2227,https://www.intensivregister.de/api/public/reporting/laendertabelle
1641117900,24592,20476,4116,3804,2226,https://www.intensivregister.de/api/public/reporting/laendertabelle
1641121500,24588,20484,4104,3807,2229,https://www.intensivregister.de/api/public/reporting/laendertabelle
1641125100,24588,20481,4107,3810,2227,https://www.intensivregister.de/api/public/reporting/laendertabelle
1641128700,24588,20479,4109,3811,2227,https://www.intensivregister.de/api/public/reporting/laendertabelle
1641132300,24588,20476,4112,3811,2227,https://www.intensivregister.de/api/public/reporting/laendertabelle
1641135900,24588,20479,4109,3813,2227,https://www.intensivregister.de/api/public/reporting/laendertabelle
1641139500,24588,20479,4109,3814,2227,https://www.intensivregister.de/api/public/reporting/laendertabelle
1641143100,24588,20478,4110,3814,2227,https://www.intensivregister.de/api/public/reporting/laendertabelle
1641150300,24588,20478,4110,3817,2229,https://www.intensivregister.de/api/public/reporting/laendertabelle
1641153900,24588,20480,4108,3818,2230,https://www.intensivregister.de/api/public/reporting/laendertabelle
1641161100,24588,20478,4110,3818,2230,https://www.intensivregister.de/api/public/reporting/laendertabelle
1641164700,24590,20467,4123,3818,2230,https://www.intensivregister.de/api/public/reporting/laendertabelle
1641168300,24588,20469,4119,3818,2230,https://www.intensivregister.de/api/public/reporting/laendertabelle
1641175500,24589,20470,4119,3819,2230,https://www.intensivregister.de/api/public/reporting/laendertabelle
1641179100,24592,20470,4122,3819,2231,https://www.intensivregister.de/api/public/reporting/laendertabelle
1641182700,24610,20492,4118,3816,2231,https://www.intensivregister.de/api/public/reporting/laendertabelle
1641186300,24623,20502,4121,3810,2231,https://www.intensivregister.de/api/public/reporting/laendertabelle
1641189900,24644,20541,4103,3810,2222,https://www.intensivregister.de/api/public/reporting/laendertabelle
1641193500,24711,20575,4136,3796,2212,https://www.intensivregister.de/api/public/reporting/laendertabelle
1641197100,24740,20625,4115,3803,2217,https://www.intensivregister.de/api/public/reporting/laendertabelle
1641200700,24746,20683,4063,3805,2214,https://www.intensivregister.de/api/public/reporting/laendertabelle
1641204300,24753,20678,4075,3804,2215,https://www.intensivregister.de/api/public/reporting/laendertabelle
1641207900,24759,20683,4076,3798,2215,https://www.intensivregister.de/api/public/reporting/laendertabelle
1641211500,24759,20686,4073,3798,2214,https://www.intensivregister.de/api/public/reporting/laendertabelle
1641215100,24752,20671,4081,3794,2214,https://www.intensivregister.de/api/public/reporting/laendertabelle
1641218700,24753,20675,4078,3795,2215,https://www.intensivregister.de/api/public/reporting/laendertabelle
1641222300,24754,20676,4078,3794,2214,https://www.intensivregister.de/api/public/reporting/laendertabelle
1641225900,24754,20673,4081,3794,2214,https://www.intensivregister.de/api/public/reporting/laendertabelle
1641229500,24754,20671,4083,3794,2214,https://www.intensivregister.de/api/public/reporting/laendertabelle
1641233100,24754,20669,4085,3794,2214,https://www.intensivregister.de/api/public/reporting/laendertabelle
1641240300,24754,20668,4086,3792,2214,https://www.intensivregister.de/api/public/reporting/laendertabelle
1641247500,24754,20669,4085,3792,2214,https://www.intensivregister.de/api/public/reporting/laendertabelle
1641251100,24754,20667,4087,3791,2214,https://www.intensivregister.de/api/public/reporting/laendertabelle
1641254700,24753,20665,4088,3793,2214,https://www.intensivregister.de/api/public/reporting/laendertabelle
1641258300,24753,20666,4087,3793,2214,https://www.intensivregister.de/api/public/reporting/laendertabelle
1641261900,24776,20681,4095,3790,2209,https://www.intensivregister.de/api/public/reporting/laendertabelle
1641265500,24777,20678,4099,3788,2208,https://www.intensivregister.de/api/public/reporting/laendertabelle
1641269100,24774,20680,4094,3787,2207,https://www.intensivregister.de/api/public/reporting/laendertabelle
1641272700,24784,20731,4053,3769,2193,https://www.intensivregister.de/api/public/reporting/laendertabelle
1641276300,24814,20794,4020,3750,2191,https://www.intensivregister.de/api/public/reporting/laendertabelle
1641279900,24881,20902,3979,3708,2176,https://www.intensivregister.de/api/public/reporting/laendertabelle
1641283500,24903,20968,3935,3691,2179,https://www.intensivregister.de/api/public/reporting/laendertabelle
1641287100,24905,21029,3876,3669,2174,https://www.intensivregister.de/api/public/reporting/laendertabelle
1641290700,24913,21039,3874,3667,2176,https://www.intensivregister.de/api/public/reporting/laendertabelle
1641294300,24911,21032,3879,3664,2171,https://www.intensivregister.de/api/public/reporting/laendertabelle
1641297900,24919,21045,3874,3670,2172,https://www.intensivregister.de/api/public/reporting/laendertabelle
1641301500,24920,21038,3882,3668,2171,https://www.intensivregister.de/api/public/reporting/laendertabelle
1641305100,24922,21037,3885,3668,2172,https://www.intensivregister.de/api/public/reporting/laendertabelle
1641308700,24922,21037,3885,3667,2172,https://www.intensivregister.de/api/public/reporting/laendertabelle
1641312300,24922,21042,3880,3669,2172,https://www.intensivregister.de/api/public/reporting/laendertabelle
1641315900,24922,21044,3878,3669,2172,https://www.intensivregister.de/api/public/reporting/laendertabelle
1641333900,24922,21046,3876,3671,2172,https://www.intensivregister.de/api/public/reporting/laendertabelle
1641337500,24924,21052,3872,3669,2171,https://www.intensivregister.de/api/public/reporting/laendertabelle
1641341100,24925,21049,3876,3668,2171,https://www.intensivregister.de/api/public/reporting/laendertabelle
1641344700,24925,21048,3877,3667,2171,https://www.intensivregister.de/api/public/reporting/laendertabelle
1641348300,24926,21034,3892,3664,2171,https://www.intensivregister.de/api/public/reporting/laendertabelle
1641351900,24921,21033,3888,3664,2172,https://www.intensivregister.de/api/public/reporting/laendertabelle
1641355500,24917,21020,3897,3662,2169,https://www.intensivregister.de/api/public/reporting/laendertabelle
1641359100,24918,21006,3912,3657,2173,https://www.intensivregister.de/api/public/reporting/laendertabelle
1641362700,24950,21028,3922,3622,2163,https://www.intensivregister.de/api/public/reporting/laendertabelle
1641366300,24945,21031,3914,3568,2142,https://www.intensivregister.de/api/public/reporting/laendertabelle
1641369900,24955,21029,3926,3562,2136,https://www.intensivregister.de/api/public/reporting/laendertabelle
1641373500,24973,21030,3943,3566,2129,https://www.intensivregister.de/api/public/reporting/laendertabelle
1641377100,24982,21059,3923,3562,2135,https://www.intensivregister.de/api/public/reporting/laendertabelle
1641380700,24980,21067,3913,3558,2134,https://www.intensivregister.de/api/public/reporting/laendertabelle
1641384300,24975,21063,3912,3557,2132,https://www.intensivregister.de/api/public/reporting/laendertabelle
1641387900,24972,21061,3911,3557,2131,https://www.intensivregister.de/api/public/reporting/laendertabelle
1641391500,24969,21059,3910,3555,2130,https://www.intensivregister.de/api/public/reporting/laendertabelle
1641395100,24969,21073,3896,3559,2130,https://www.intensivregister.de/api/public/reporting/laendertabelle
1641398700,24969,21078,3891,3559,2130,https://www.intensivregister.de/api/public/reporting/laendertabelle
1641420300,24972,21080,3892,3559,2130,https://www.intensivregister.de/api/public/reporting/laendertabelle
1641423900,24966,21073,3893,3562,2131,https://www.intensivregister.de/api/public/reporting/laendertabelle
1641427500,24965,21071,3894,3562,2131,https://www.intensivregister.de/api/public/reporting/laendertabelle
1641431100,24966,21075,3891,3562,2131,https://www.intensivregister.de/api/public/reporting/laendertabelle
1641434700,24967,21073,3894,3561,2130,https://www.intensivregister.de/api/public/reporting/laendertabelle
1641438300,24963,21071,3892,3564,2130,https://www.intensivregister.de/api/public/reporting/laendertabelle
1641441900,24961,21073,3888,3561,2130,https://www.intensivregister.de/api/public/reporting/laendertabelle
1641445500,24961,21055,3906,3549,2124,https://www.intensivregister.de/api/public/reporting/laendertabelle
1641449100,24991,21055,3936,3507,2111,https://www.intensivregister.de/api/public/reporting/laendertabelle
1641452700,24941,20979,3962,3467,2110,https://www.intensivregister.de/api/public/reporting/laendertabelle
1641456300,24947,20993,3954,3463,2098,https://www.intensivregister.de/api/public/reporting/laendertabelle
1641459900,24948,20999,3949,3455,2096,https://www.intensivregister.de/api/public/reporting/laendertabelle
1641463500,24945,21003,3942,3447,2096,https://www.intensivregister.de/api/public/reporting/laendertabelle
1641467100,24946,20995,3951,3445,2094,https://www.intensivregister.de/api/public/reporting/laendertabelle
1641470700,24940,20971,3969,3442,2091,https://www.intensivregister.de/api/public/reporting/laendertabelle
1641474300,24941,20977,3964,3441,2089,https://www.intensivregister.de/api/public/reporting/laendertabelle
1641477900,24941,20976,3965,3441,2089,https://www.intensivregister.de/api/public/reporting/laendertabelle
1641481500,24941,20974,3967,3441,2089,https://www.intensivregister.de/api/public/reporting/laendertabelle
1641485100,24940,20976,3964,3440,2089,https://www.intensivregister.de/api/public/reporting/laendertabelle
1641492300,24940,20975,3965,3439,2088,https://www.intensivregister.de/api/public/reporting/laendertabelle
1641495900,24940,20974,3966,3441,2089,https://www.intensivregister.de/api/public/reporting/laendertabelle
1641499500,24938,20972,3966,3440,2089,https://www.intensivregister.de/api/public/reporting/laendertabelle
1641506700,24938,20971,3967,3440,2089,https://www.intensivregister.de/api/public/reporting/laendertabelle
1641510300,24940,20975,3965,3439,2089,https://www.intensivregister.de/api/public/reporting/laendertabelle
1641513900,24940,20976,3964,3438,2089,https://www.intensivregister.de/api/public/reporting/laendertabelle
1641517500,24937,20970,3967,3437,2089,https://www.intensivregister.de/api/public/reporting/laendertabelle
1641521100,24934,20965,3969,3437,2089,https://www.intensivregister.de/api/public/reporting/laendertabelle
1641524700,24934,20964,3970,3437,2089,https://www.intensivregister.de/api/public/reporting/laendertabelle
1641528300,24930,20964,3966,3441,2088,https://www.intensivregister.de/api/public/reporting/laendertabelle
1641531900,24924,20942,3982,3442,2088,https://www.intensivregister.de/api/public/reporting/laendertabelle
1641535500,24912,20918,3994,3439,2062,https://www.intensivregister.de/api/public/reporting/laendertabelle
1641539100,24921,20920,4001,3408,2036,https://www.intensivregister.de/api/public/reporting/laendertabelle
1641542700,24920,20948,3972,3401,2048,https://www.intensivregister.de/api/public/reporting/laendertabelle
1641546300,24916,20933,3983,3390,2033,https://www.intensivregister.de/api/public/reporting/laendertabelle
1641549900,24924,20926,3998,3381,2026,https://www.intensivregister.de/api/public/reporting/laendertabelle
1641553500,24920,20916,4004,3375,2033,https://www.intensivregister.de/api/public/reporting/laendertabelle
1641557100,24920,20921,3999,3379,2038,https://www.intensivregister.de/api/public/reporting/laendertabelle
1641560700,24921,20921,4000,3381,2039,https://www.intensivregister.de/api/public/reporting/laendertabelle
1641564300,24921,20924,3997,3380,2038,https://www.intensivregister.de/api/public/reporting/laendertabelle
1641567900,24918,20920,3998,3380,2037,https://www.intensivregister.de/api/public/reporting/laendertabelle
1641571500,24916,20921,3995,3380,2037,https://www.intensivregister.de/api/public/reporting/laendertabelle
1641575100,24916,20922,3994,3380,2038,https://www.intensivregister.de/api/public/reporting/laendertabelle
1641582300,24916,20922,3994,3381,2038,https://www.intensivregister.de/api/public/reporting/laendertabelle
1641585900,24916,20923,3993,3381,2038,https://www.intensivregister.de/api/public/reporting/laendertabelle
1641593100,24916,20921,3995,3382,2038,https://www.intensivregister.de/api/public/reporting/laendertabelle
1641596700,24915,20924,3991,3384,2039,https://www.intensivregister.de/api/public/reporting/laendertabelle
1641600300,24915,20925,3990,3384,2039,https://www.intensivregister.de/api/public/reporting/laendertabelle
1641603900,24912,20909,4003,3382,2039,https://www.intensivregister.de/api/public/reporting/laendertabelle
1641607500,24911,20907,4004,3383,2038,https://www.intensivregister.de/api/public/reporting/laendertabelle
1641611100,24913,20908,4005,3380,2038,https://www.intensivregister.de/api/public/reporting/laendertabelle
1641614700,24912,20910,4002,3379,2038,https://www.intensivregister.de/api/public/reporting/laendertabelle
1641618300,24910,20885,4025,3371,2029,https://www.intensivregister.de/api/public/reporting/laendertabelle
1641621900,24913,20863,4050,3365,2027,https://www.intensivregister.de/api/public/reporting/laendertabelle
1641625500,24865,20809,4056,3345,2002,https://www.intensivregister.de/api/public/reporting/laendertabelle
1641629100,24828,20746,4082,3320,2001,https://www.intensivregister.de/api/public/reporting/laendertabelle
1641632700,24834,20689,4145,3324,1990,https://www.intensivregister.de/api/public/reporting/laendertabelle
1641636300,24829,20670,4159,3316,1988,https://www.intensivregister.de/api/public/reporting/laendertabelle
1641639900,24827,20667,4160,3313,1985,https://www.intensivregister.de/api/public/reporting/laendertabelle
1641643500,24868,20703,4165,3320,1987,https://www.intensivregister.de/api/public/reporting/laendertabelle
1641647100,24866,20698,4168,3322,1987,https://www.intensivregister.de/api/public/reporting/laendertabelle
1641650700,24866,20703,4163,3323,1987,https://www.intensivregister.de/api/public/reporting/laendertabelle
1641657900,24866,20702,4164,3323,1987,https://www.intensivregister.de/api/public/reporting/laendertabelle
1641661500,24867,20702,4165,3323,1988,https://www.intensivregister.de/api/public/reporting/laendertabelle
1641668700,24867,20697,4170,3323,1988,https://www.intensivregister.de/api/public/reporting/laendertabelle
1641672300,24865,20697,4168,3323,1988,https://www.intensivregister.de/api/public/reporting/laendertabelle
1641683100,24865,20699,4166,3323,1988,https://www.intensivregister.de/api/public/reporting/laendertabelle
1641686700,24863,20688,4175,3322,1988,https://www.intensivregister.de/api/public/reporting/laendertabelle
1641690300,24843,20662,4181,3321,1987,https://www.intensivregister.de/api/public/reporting/laendertabelle
1641693900,24844,20663,4181,3322,1987,https://www.intensivregister.de/api/public/reporting/laendertabelle
1641697500,24845,20645,4200,3320,1987,https://www.intensivregister.de/api/public/reporting/laendertabelle
1641701100,24840,20639,4201,3315,1986,https://www.intensivregister.de/api/public/reporting/laendertabelle
1641704700,24839,20641,4198,3309,1992,https://www.intensivregister.de/api/public/reporting/laendertabelle
1641708300,24820,20590,4230,3309,1988,https://www.intensivregister.de/api/public/reporting/laendertabelle
1641711900,24803,20514,4289,3294,1993,https://www.intensivregister.de/api/public/reporting/laendertabelle
1641715500,24775,20419,4356,3293,1999,https://www.intensivregister.de/api/public/reporting/laendertabelle
1641719100,24767,20420,4347,3268,1986,https://www.intensivregister.de/api/public/reporting/laendertabelle
1641722700,24760,20402,4358,3269,1988,https://www.intensivregister.de/api/public/reporting/laendertabelle
1641726300,24755,20395,4360,3270,1985,https://www.intensivregister.de/api/public/reporting/laendertabelle
1641729900,24754,20395,4359,3271,1986,https://www.intensivregister.de/api/public/reporting/laendertabelle
1641733500,24751,20387,4364,3273,1988,https://www.intensivregister.de/api/public/reporting/laendertabelle
1641737100,24751,20388,4363,3273,1986,https://www.intensivregister.de/api/public/reporting/laendertabelle
1641744300,24751,20390,4361,3277,1987,https://www.intensivregister.de/api/public/reporting/laendertabelle
1641747900,24751,20389,4362,3277,1987,https://www.intensivregister.de/api/public/reporting/laendertabelle
1641751500,24751,20387,4364,3277,1987,https://www.intensivregister.de/api/public/reporting/laendertabelle
1641755100,24750,20386,4364,3277,1987,https://www.intensivregister.de/api/public/reporting/laendertabelle
1641758700,24750,20385,4365,3277,1987,https://www.intensivregister.de/api/public/reporting/laendertabelle
1641762300,24750,20384,4366,3276,1986,https://www.intensivregister.de/api/public/reporting/laendertabelle
1641765900,24749,20383,4366,3276,1986,https://www.intensivregister.de/api/public/reporting/laendertabelle
1641769500,24749,20384,4365,3275,1986,https://www.intensivregister.de/api/public/reporting/laendertabelle
1641773100,24751,20385,4366,3275,1985,https://www.intensivregister.de/api/public/reporting/laendertabelle
1641776700,24746,20386,4360,3275,1985,https://www.intensivregister.de/api/public/reporting/laendertabelle
1641780300,24744,20390,4354,3275,1985,https://www.intensivregister.de/api/public/reporting/laendertabelle
1641783900,24747,20392,4355,3275,1985,https://www.intensivregister.de/api/public/reporting/laendertabelle
1641787500,24747,20407,4340,3276,1984,https://www.intensivregister.de/api/public/reporting/laendertabelle
1641791100,24774,20430,4344,3259,1980,https://www.intensivregister.de/api/public/reporting/laendertabelle
1641794700,24818,20513,4305,3270,1978,https://www.intensivregister.de/api/public/reporting/laendertabelle
1641798300,24871,20588,4283,3260,1967,https://www.intensivregister.de/api/public/reporting/laendertabelle
1641801900,24934,20641,4293,3257,1975,https://www.intensivregister.de/api/public/reporting/laendertabelle
1641805500,24943,20692,4251,3264,1978,https://www.intensivregister.de/api/public/reporting/laendertabelle
1641809100,24962,20704,4258,3259,1988,https://www.intensivregister.de/api/public/reporting/laendertabelle
1641812700,24948,20682,4266,3249,1984,https://www.intensivregister.de/api/public/reporting/laendertabelle
1641816300,24947,20680,4267,3247,1984,https://www.intensivregister.de/api/public/reporting/laendertabelle
1641819900,24947,20674,4273,3244,1982,https://www.intensivregister.de/api/public/reporting/laendertabelle
1641823500,24947,20677,4270,3244,1982,https://www.intensivregister.de/api/public/reporting/laendertabelle
1641827100,24949,20676,4273,3244,1983,https://www.intensivregister.de/api/public/reporting/laendertabelle
1641841500,24948,20675,4273,3241,1981,https://www.intensivregister.de/api/public/reporting/laendertabelle
1641845100,24954,20681,4273,3241,1981,https://www.intensivregister.de/api/public/reporting/laendertabelle
1641852300,24954,20680,4274,3241,1981,https://www.intensivregister.de/api/public/reporting/laendertabelle
1641855900,24955,20670,4285,3240,1981,https://www.intensivregister.de/api/public/reporting/laendertabelle
1641859500,24954,20668,4286,3241,1981,https://www.intensivregister.de/api/public/reporting/laendertabelle
1641863100,24949,20669,4280,3241,1981,https://www.intensivregister.de/api/public/reporting/laendertabelle
1641866700,24949,20662,4287,3243,1980,https://www.intensivregister.de/api/public/reporting/laendertabelle
1641870300,24951,20661,4290,3241,1979,https://www.intensivregister.de/api/public/reporting/laendertabelle
1641873900,24962,20676,4286,3241,1979,https://www.intensivregister.de/api/public/reporting/laendertabelle
1641877500,24983,20709,4274,3222,1962,https://www.intensivregister.de/api/public/reporting/laendertabelle
1641881100,25006,20775,4231,3207,1947,https://www.intensivregister.de/api/public/reporting/laendertabelle
1641884700,25074,20908,4166,3154,1917,https://www.intensivregister.de/api/public/reporting/laendertabelle
1641888300,25095,20970,4125,3143,1910,https://www.intensivregister.de/api/public/reporting/laendertabelle
1641891900,25115,20983,4132,3145,1911,https://www.intensivregister.de/api/public/reporting/laendertabelle
1641895500,25137,21019,4118,3154,1916,https://www.intensivregister.de/api/public/reporting/laendertabelle
1641899100,25142,21019,4123,3153,1916,https://www.intensivregister.de/api/public/reporting/laendertabelle
1641902700,25140,21017,4123,3152,1914,https://www.intensivregister.de/api/public/reporting/laendertabelle
1641906300,25138,21012,4126,3151,1914,https://www.intensivregister.de/api/public/reporting/laendertabelle
1641909900,25138,21008,4130,3151,1913,https://www.intensivregister.de/api/public/reporting/laendertabelle
1641913500,25138,21012,4126,3152,1914,https://www.intensivregister.de/api/public/reporting/laendertabelle
1641920700,25138,21009,4129,3152,1914,https://www.intensivregister.de/api/public/reporting/laendertabelle
1641931500,25138,21007,4131,3153,1914,https://www.intensivregister.de/api/public/reporting/laendertabelle
1641935100,25138,21005,4133,3153,1914,https://www.intensivregister.de/api/public/reporting/laendertabelle
1641942300,25138,21005,4133,3152,1913,https://www.intensivregister.de/api/public/reporting/laendertabelle
1641945900,25141,21007,4134,3150,1913,https://www.intensivregister.de/api/public/reporting/laendertabelle
1641949500,25141,21006,4135,3150,1913,https://www.intensivregister.de/api/public/reporting/laendertabelle
1641953100,25139,21002,4137,3152,1913,https://www.intensivregister.de/api/public/reporting/laendertabelle
1641956700,25138,21009,4129,3150,1913,https://www.intensivregister.de/api/public/reporting/laendertabelle
1641960300,25140,21010,4130,3148,1913,https://www.intensivregister.de/api/public/reporting/laendertabelle
1641963900,25137,21023,4114,3117,1892,https://www.intensivregister.de/api/public/reporting/laendertabelle
1641967500,25145,21062,4083,3099,1877,https://www.intensivregister.de/api/public/reporting/laendertabelle
1641971100,25149,21093,4056,3083,1866,https://www.intensivregister.de/api/public/reporting/laendertabelle
1641974700,25161,21156,4005,3064,1849,https://www.intensivregister.de/api/public/reporting/laendertabelle
1641978300,25159,21147,4012,3058,1842,https://www.intensivregister.de/api/public/reporting/laendertabelle
1641981900,25144,21149,3995,3049,1836,https://www.intensivregister.de/api/public/reporting/laendertabelle
1641985500,25143,21152,3991,3048,1838,https://www.intensivregister.de/api/public/reporting/laendertabelle
1641989100,25144,21157,3987,3047,1838,https://www.intensivregister.de/api/public/reporting/laendertabelle
1641992700,25146,21169,3977,3048,1838,https://www.intensivregister.de/api/public/reporting/laendertabelle
1641996300,25149,21168,3981,3047,1836,https://www.intensivregister.de/api/public/reporting/laendertabelle
1641999900,25149,21167,3982,3046,1835,https://www.intensivregister.de/api/public/reporting/laendertabelle
1642003500,25149,21170,3979,3047,1835,https://www.intensivregister.de/api/public/reporting/laendertabelle
1642007100,25149,21169,3980,3048,1835,https://www.intensivregister.de/api/public/reporting/laendertabelle
1642014300,25149,21168,3981,3045,1833,https://www.intensivregister.de/api/public/reporting/laendertabelle
1642025100,25149,21167,3982,3046,1834,https://www.intensivregister.de/api/public/reporting/laendertabelle
1642028700,25150,21162,3988,3045,1834,https://www.intensivregister.de/api/public/reporting/laendertabelle
1642032300,25151,21159,3992,3047,1835,https://www.intensivregister.de/api/public/reporting/laendertabelle
1642035900,25149,21157,3992,3045,1834,https://www.intensivregister.de/api/public/reporting/laendertabelle
1642039500,25148,21150,3998,3044,1833,https://www.intensivregister.de/api/public/reporting/laendertabelle
1642043100,25155,21155,4000,3045,1833,https://www.intensivregister.de/api/public/reporting/laendertabelle
1642046700,25154,21163,3991,3045,1832,https://www.intensivregister.de/api/public/reporting/laendertabelle
1642050300,25163,21158,4005,3028,1829,https://www.intensivregister.de/api/public/reporting/laendertabelle
1642053900,25156,21138,4018,3011,1818,https://www.intensivregister.de/api/public/reporting/laendertabelle
1642057500,25159,21137,4022,2994,1802,https://www.intensivregister.de/api/public/reporting/laendertabelle
1642061100,25147,21185,3962,2981,1793,https://www.intensivregister.de/api/public/reporting/laendertabelle
1642064700,25191,21181,4010,2962,1786,https://www.intensivregister.de/api/public/reporting/laendertabelle
1642068300,25195,21170,4025,2956,1782,https://www.intensivregister.de/api/public/reporting/laendertabelle
1642071900,25199,21163,4036,2955,1782,https://www.intensivregister.de/api/public/reporting/laendertabelle
1642075500,25199,21162,4037,2954,1782,https://www.intensivregister.de/api/public/reporting/laendertabelle
1642079100,25199,21157,4042,2953,1781,https://www.intensivregister.de/api/public/reporting/laendertabelle
1642082700,25199,21158,4041,2953,1780,https://www.intensivregister.de/api/public/reporting/laendertabelle
1642086300,25199,21159,4040,2954,1781,https://www.intensivregister.de/api/public/reporting/laendertabelle
1642089900,25196,21160,4036,2951,1778,https://www.intensivregister.de/api/public/reporting/laendertabelle
1642097100,25196,21160,4036,2952,1780,https://www.intensivregister.de/api/public/reporting/laendertabelle
1642100700,25196,21160,4036,2953,1781,https://www.intensivregister.de/api/public/reporting/laendertabelle
1642107900,25196,21161,4035,2954,1781,https://www.intensivregister.de/api/public/reporting/laendertabelle
1642111500,25196,21164,4032,2954,1781,https://www.intensivregister.de/api/public/reporting/laendertabelle
1642115100,25195,21160,4035,2951,1780,https://www.intensivregister.de/api/public/reporting/laendertabelle
1642118700,25196,21163,4033,2950,1780,https://www.intensivregister.de/api/public/reporting/laendertabelle
1642122300,25197,21164,4033,2950,1779,https://www.intensivregister.de/api/public/reporting/laendertabelle
1642125900,25199,21164,4035,2950,1779,https://www.intensivregister.de/api/public/reporting/laendertabelle
1642129500,25199,21165,4034,2947,1779,https://www.intensivregister.de/api/public/reporting/laendertabelle
1642133100,25201,21168,4033,2943,1779,https://www.intensivregister.de/api/public/reporting/laendertabelle
1642136700,25195,21192,4003,2934,1768,https://www.intensivregister.de/api/public/reporting/laendertabelle
1642140300,25198,21223,3975,2912,1765,https://www.intensivregister.de/api/public/reporting/laendertabelle
1642143900,25210,21202,4008,2891,1765,https://www.intensivregister.de/api/public/reporting/laendertabelle
1642147500,25186,21202,3984,2880,1762,https://www.intensivregister.de/api/public/reporting/laendertabelle
1642151100,25182,21160,4022,2871,1750,https://www.intensivregister.de/api/public/reporting/laendertabelle
1642154700,25172,21174,3998,2873,1744,https://www.intensivregister.de/api/public/reporting/laendertabelle
1642158300,25171,21177,3994,2872,1743,https://www.intensivregister.de/api/public/reporting/laendertabelle
1642161900,25171,21178,3993,2872,1743,https://www.intensivregister.de/api/public/reporting/laendertabelle
1642165500,25171,21174,3997,2871,1741,https://www.intensivregister.de/api/public/reporting/laendertabelle
1642169100,25171,21177,3994,2871,1741,https://www.intensivregister.de/api/public/reporting/laendertabelle
1642172700,25171,21179,3992,2872,1741,https://www.intensivregister.de/api/public/reporting/laendertabelle
1642176300,25172,21181,3991,2870,1739,https://www.intensivregister.de/api/public/reporting/laendertabelle
1642201500,25174,21190,3984,2868,1739,https://www.intensivregister.de/api/public/reporting/laendertabelle
1642205100,25177,21181,3996,2867,1738,https://www.intensivregister.de/api/public/reporting/laendertabelle
1642208700,25179,21170,4009,2866,1738,https://www.intensivregister.de/api/public/reporting/laendertabelle
1642212300,25177,21166,4011,2861,1735,https://www.intensivregister.de/api/public/reporting/laendertabelle
1642215900,25200,21190,4010,2860,1736,https://www.intensivregister.de/api/public/reporting/laendertabelle
1642219500,25199,21188,4011,2861,1737,https://www.intensivregister.de/api/public/reporting/laendertabelle
1642223100,25191,21154,4037,2861,1736,https://www.intensivregister.de/api/public/reporting/laendertabelle
1642226700,25160,21111,4049,2859,1739,https://www.intensivregister.de/api/public/reporting/laendertabelle
1642230300,25130,21041,4089,2839,1731,https://www.intensivregister.de/api/public/reporting/laendertabelle
1642233900,25056,20923,4133,2803,1715,https://www.intensivregister.de/api/public/reporting/laendertabelle
1642237500,25040,20890,4150,2804,1711,https://www.intensivregister.de/api/public/reporting/laendertabelle
1642241100,25030,20859,4171,2799,1707,https://www.intensivregister.de/api/public/reporting/laendertabelle
1642244700,25029,20824,4205,2801,1709,https://www.intensivregister.de/api/public/reporting/laendertabelle
1642248300,25026,20820,4206,2803,1709,https://www.intensivregister.de/api/public/reporting/laendertabelle
1642251900,25026,20819,4207,2803,1709,https://www.intensivregister.de/api/public/reporting/laendertabelle
1642255500,25027,20803,4224,2801,1709,https://www.intensivregister.de/api/public/reporting/laendertabelle
1642259100,25029,20803,4226,2800,1705,https://www.intensivregister.de/api/public/reporting/laendertabelle
1642262700,25023,20803,4220,2800,1706,https://www.intensivregister.de/api/public/reporting/laendertabelle
1642266300,25021,20802,4219,2801,1709,https://www.intensivregister.de/api/public/reporting/laendertabelle
1642273500,25023,20807,4216,2801,1709,https://www.intensivregister.de/api/public/reporting/laendertabelle
1642277100,25022,20802,4220,2800,1709,https://www.intensivregister.de/api/public/reporting/laendertabelle
1642284300,25022,20801,4221,2801,1710,https://www.intensivregister.de/api/public/reporting/laendertabelle
1642287900,25020,20795,4225,2801,1711,https://www.intensivregister.de/api/public/reporting/laendertabelle
1642291500,25020,20792,4228,2800,1711,https://www.intensivregister.de/api/public/reporting/laendertabelle
1642295100,25018,20792,4226,2801,1711,https://www.intensivregister.de/api/public/reporting/laendertabelle
1642298700,25020,20785,4235,2802,1711,https://www.intensivregister.de/api/public/reporting/laendertabelle
1642302300,25019,20787,4232,2803,1711,https://www.intensivregister.de/api/public/reporting/laendertabelle
1642305900,25019,20785,4234,2802,1711,https://www.intensivregister.de/api/public/reporting/laendertabelle
1642309500,25014,20781,4233,2794,1708,https://www.intensivregister.de/api/public/reporting/laendertabelle
1642313100,25014,20705,4309,2791,1708,https://www.intensivregister.de/api/public/reporting/laendertabelle
1642316700,24984,20586,4398,2776,1692,https://www.intensivregister.de/api/public/reporting/laendertabelle
1642320300,24958,20467,4491,2767,1694,https://www.intensivregister.de/api/public/reporting/laendertabelle
1642323900,24957,20387,4570,2754,1687,https://www.intensivregister.de/api/public/reporting/laendertabelle
1642327500,24937,20330,4607,2742,1674,https://www.intensivregister.de/api/public/reporting/laendertabelle
1642331100,24938,20327,4611,2740,1672,https://www.intensivregister.de/api/public/reporting/laendertabelle
1642334700,24938,20332,4606,2736,1670,https://www.intensivregister.de/api/public/reporting/laendertabelle
1642338300,24938,20329,4609,2737,1670,https://www.intensivregister.de/api/public/reporting/laendertabelle
1642341900,24937,20330,4607,2738,1671,https://www.intensivregister.de/api/public/reporting/laendertabelle
1642345500,24935,20327,4608,2738,1672,https://www.intensivregister.de/api/public/reporting/laendertabelle
1642349100,24935,20329,4606,2737,1672,https://www.intensivregister.de/api/public/reporting/laendertabelle
1642352700,24933,20330,4603,2737,1672,https://www.intensivregister.de/api/public/reporting/laendertabelle
1642356300,24933,20330,4603,2735,1671,https://www.intensivregister.de/api/public/reporting/laendertabelle
1642359900,24933,20331,4602,2735,1671,https://www.intensivregister.de/api/public/reporting/laendertabelle
1642370700,24933,20332,4601,2735,1671,https://www.intensivregister.de/api/public/reporting/laendertabelle
1642374300,24933,20329,4604,2736,1671,https://www.intensivregister.de/api/public/reporting/laendertabelle
1642381500,24931,20337,4594,2736,1671,https://www.intensivregister.de/api/public/reporting/laendertabelle
1642385100,24929,20320,4609,2734,1671,https://www.intensivregister.de/api/public/reporting/laendertabelle
1642388700,24930,20320,4610,2733,1671,https://www.intensivregister.de/api/public/reporting/laendertabelle
1642392300,24938,20337,4601,2733,1671,https://www.intensivregister.de/api/public/reporting/laendertabelle
1642395900,24957,20403,4554,2740,1667,https://www.intensivregister.de/api/public/reporting/laendertabelle
1642399500,24985,20389,4596,2742,1658,https://www.intensivregister.de/api/public/reporting/laendertabelle
1642403100,25015,20416,4599,2753,1649,https://www.intensivregister.de/api/public/reporting/laendertabelle
1642406700,25077,20488,4589,2738,1641,https://www.intensivregister.de/api/public/reporting/laendertabelle
1642410300,25078,20501,4577,2741,1645,https://www.intensivregister.de/api/public/reporting/laendertabelle
1642413900,25085,20525,4560,2744,1648,https://www.intensivregister.de/api/public/reporting/laendertabelle
1642417500,25089,20531,4558,2741,1648,https://www.intensivregister.de/api/public/reporting/laendertabelle
1642421100,25088,20526,4562,2742,1647,https://www.intensivregister.de/api/public/reporting/laendertabelle
1642424700,25059,20502,4557,2737,1645,https://www.intensivregister.de/api/public/reporting/laendertabelle
1642428300,25056,20498,4558,2736,1644,https://www.intensivregister.de/api/public/reporting/laendertabelle
1642431900,25056,20494,4562,2735,1644,https://www.intensivregister.de/api/public/reporting/laendertabelle
1642435500,25056,20495,4561,2735,1644,https://www.intensivregister.de/api/public/reporting/laendertabelle
1642439100,25056,20491,4565,2734,1644,https://www.intensivregister.de/api/public/reporting/laendertabelle
1642449900,25056,20492,4564,2735,1644,https://www.intensivregister.de/api/public/reporting/laendertabelle
1642457100,24906,20342,4564,2721,1633,https://www.intensivregister.de/api/public/reporting/laendertabelle
1642460700,24909,20345,4564,2719,1633,https://www.intensivregister.de/api/public/reporting/laendertabelle
1642464300,24908,20342,4566,2720,1633,https://www.intensivregister.de/api/public/reporting/laendertabelle
1642467900,24909,20339,4570,2720,1633,https://www.intensivregister.de/api/public/reporting/laendertabelle
1642471500,24908,20348,4560,2717,1630,https://www.intensivregister.de/api/public/reporting/laendertabelle
1642475100,24908,20354,4554,2718,1630,https://www.intensivregister.de/api/public/reporting/laendertabelle
1642478701,24912,20353,4559,2715,1628,https://www.intensivregister.de/api/public/reporting/laendertabelle
1642482300,24929,20401,4528,2703,1632,https://www.intensivregister.de/api/public/reporting/laendertabelle
1642485900,24928,20482,4446,2698,1628,https://www.intensivregister.de/api/public/reporting/laendertabelle
1642489500,24950,20529,4421,2663,1609,https://www.intensivregister.de/api/public/reporting/laendertabelle
1642493100,25121,20805,4316,2669,1615,https://www.intensivregister.de/api/public/reporting/laendertabelle
1642496700,25127,20868,4259,2669,1622,https://www.intensivregister.de/api/public/reporting/laendertabelle
1642500300,25125,20856,4269,2664,1630,https://www.intensivregister.de/api/public/reporting/laendertabelle
1642503900,25125,20858,4267,2664,1629,https://www.intensivregister.de/api/public/reporting/laendertabelle
1642511100,25125,20857,4268,2661,1629,https://www.intensivregister.de/api/public/reporting/laendertabelle
1642514700,25125,20858,4267,2661,1629,https://www.intensivregister.de/api/public/reporting/laendertabelle
1642518300,25126,20856,4270,2660,1628,https://www.intensivregister.de/api/public/reporting/laendertabelle
1642521900,25128,20862,4266,2662,1628,https://www.intensivregister.de/api/public/reporting/laendertabelle
1642525500,25128,20859,4269,2662,1628,https://www.intensivregister.de/api/public/reporting/laendertabelle
1642529100,25128,20857,4271,2661,1628,https://www.intensivregister.de/api/public/reporting/laendertabelle
1642543500,25128,20858,4270,2661,1628,https://www.intensivregister.de/api/public/reporting/laendertabelle
1642547100,25129,20866,4263,2661,1628,https://www.intensivregister.de/api/public/reporting/laendertabelle
1642550700,25129,20872,4257,2662,1628,https://www.intensivregister.de/api/public/reporting/laendertabelle
1642554300,25128,20873,4255,2662,1628,https://www.intensivregister.de/api/public/reporting/laendertabelle
1642557900,25127,20868,4259,2662,1627,https://www.intensivregister.de/api/public/reporting/laendertabelle
1642561500,25123,20864,4259,2663,1628,https://www.intensivregister.de/api/public/reporting/laendertabelle
1642565100,25118,20858,4260,2658,1627,https://www.intensivregister.de/api/public/reporting/laendertabelle
1642568700,25117,20858,4259,2650,1620,https://www.intensivregister.de/api/public/reporting/laendertabelle
1642572300,25119,20887,4232,2638,1604,https://www.intensivregister.de/api/public/reporting/laendertabelle
1642575900,25132,20947,4185,2595,1573,https://www.intensivregister.de/api/public/reporting/laendertabelle
1642579500,25126,20985,4141,2573,1557,https://www.intensivregister.de/api/public/reporting/laendertabelle
1642583100,25134,21012,4122,2573,1544,https://www.intensivregister.de/api/public/reporting/laendertabelle
1642586700,25137,21017,4120,2572,1542,https://www.intensivregister.de/api/public/reporting/laendertabelle
1642590300,25137,21020,4117,2572,1543,https://www.intensivregister.de/api/public/reporting/laendertabelle
1642593900,25137,21013,4124,2572,1542,https://www.intensivregister.de/api/public/reporting/laendertabelle
1642597500,25137,21007,4130,2572,1542,https://www.intensivregister.de/api/public/reporting/laendertabelle
1642601100,25137,21005,4132,2570,1540,https://www.intensivregister.de/api/public/reporting/laendertabelle
1642608300,25135,21010,4125,2568,1539,https://www.intensivregister.de/api/public/reporting/laendertabelle
1642629900,25135,21009,4126,2568,1538,https://www.intensivregister.de/api/public/reporting/laendertabelle
1642633500,25135,21001,4134,2567,1537,https://www.intensivregister.de/api/public/reporting/laendertabelle
1642637100,25137,20997,4140,2565,1536,https://www.intensivregister.de/api/public/reporting/laendertabelle
1642640700,25137,20998,4139,2564,1535,https://www.intensivregister.de/api/public/reporting/laendertabelle
1642644300,25137,20996,4141,2563,1534,https://www.intensivregister.de/api/public/reporting/laendertabelle
1642647900,25139,20999,4140,2563,1534,https://www.intensivregister.de/api/public/reporting/laendertabelle
1642651500,25142,21007,4135,2565,1535,https://www.intensivregister.de/api/public/reporting/laendertabelle
1642655100,25146,21006,4140,2544,1530,https://www.intensivregister.de/api/public/reporting/laendertabelle
1642658700,25150,20973,4177,2493,1517,https://www.intensivregister.de/api/public/reporting/laendertabelle
1642662300,25153,20958,4195,2445,1513,https://www.intensivregister.de/api/public/reporting/laendertabelle
1642665900,25162,21061,4101,2451,1507,https://www.intensivregister.de/api/public/reporting/laendertabelle
1642669500,25165,21081,4084,2450,1507,https://www.intensivregister.de/api/public/reporting/laendertabelle
1642673100,25167,21068,4099,2448,1513,https://www.intensivregister.de/api/public/reporting/laendertabelle
1642676700,25169,21076,4093,2446,1514,https://www.intensivregister.de/api/public/reporting/laendertabelle
1642680300,25169,21077,4092,2449,1514,https://www.intensivregister.de/api/public/reporting/laendertabelle
1642687500,25169,21076,4093,2449,1513,https://www.intensivregister.de/api/public/reporting/laendertabelle
1642691100,25166,21078,4088,2450,1513,https://www.intensivregister.de/api/public/reporting/laendertabelle
1642698300,25166,21080,4086,2450,1513,https://www.intensivregister.de/api/public/reporting/laendertabelle
1642709100,25166,21078,4088,2450,1514,https://www.intensivregister.de/api/public/reporting/laendertabelle
1642716300,25166,21079,4087,2450,1514,https://www.intensivregister.de/api/public/reporting/laendertabelle
1642719900,25166,21068,4098,2449,1514,https://www.intensivregister.de/api/public/reporting/laendertabelle
1642723500,25165,21066,4099,2449,1515,https://www.intensivregister.de/api/public/reporting/laendertabelle
1642727100,25165,21071,4094,2449,1515,https://www.intensivregister.de/api/public/reporting/laendertabelle
1642730700,25164,21059,4105,2449,1515,https://www.intensivregister.de/api/public/reporting/laendertabelle
1642734300,25164,21063,4101,2446,1514,https://www.intensivregister.de/api/public/reporting/laendertabelle
1642737900,25166,21064,4102,2443,1512,https://www.intensivregister.de/api/public/reporting/laendertabelle
1642741500,25165,21073,4092,2422,1497,https://www.intensivregister.de/api/public/reporting/laendertabelle
1642745100,25165,21111,4054,2430,1480,https://www.intensivregister.de/api/public/reporting/laendertabelle
1642748700,25134,21142,3992,2434,1471,https://www.intensivregister.de/api/public/reporting/laendertabelle
1642752300,25123,21090,4033,2414,1462,https://www.intensivregister.de/api/public/reporting/laendertabelle
1642755900,25129,21079,4050,2410,1455,https://www.intensivregister.de/api/public/reporting/laendertabelle
1642759500,25122,21070,4052,2418,1448,https://www.intensivregister.de/api/public/reporting/laendertabelle
1642763100,25111,21057,4054,2419,1449,https://www.intensivregister.de/api/public/reporting/laendertabelle
1642766700,25112,21056,4056,2421,1447,https://www.intensivregister.de/api/public/reporting/laendertabelle
1642770300,25112,21053,4059,2421,1447,https://www.intensivregister.de/api/public/reporting/laendertabelle
1642773900,25112,21051,4061,2427,1447,https://www.intensivregister.de/api/public/reporting/laendertabelle
1642777500,25112,21051,4061,2426,1445,https://www.intensivregister.de/api/public/reporting/laendertabelle
1642781100,25111,21048,4063,2427,1445,https://www.intensivregister.de/api/public/reporting/laendertabelle
1642791900,25111,21050,4061,2428,1446,https://www.intensivregister.de/api/public/reporting/laendertabelle
1642799100,25111,21051,4060,2428,1446,https://www.intensivregister.de/api/public/reporting/laendertabelle
1642806300,25106,21038,4068,2428,1446,https://www.intensivregister.de/api/public/reporting/laendertabelle
1642809900,25105,21034,4071,2428,1446,https://www.intensivregister.de/api/public/reporting/laendertabelle
1642813500,25105,21037,4068,2428,1446,https://www.intensivregister.de/api/public/reporting/laendertabelle
1642817100,25102,21031,4071,2428,1446,https://www.intensivregister.de/api/public/reporting/laendertabelle
1642820700,25101,21030,4071,2427,1445,https://www.intensivregister.de/api/public/reporting/laendertabelle
1642824300,25102,21033,4069,2427,1445,https://www.intensivregister.de/api/public/reporting/laendertabelle
1642827900,25100,21035,4065,2422,1441,https://www.intensivregister.de/api/public/reporting/laendertabelle
1642831500,25073,20970,4103,2407,1440,https://www.intensivregister.de/api/public/reporting/laendertabelle
1642835100,25032,20877,4155,2405,1432,https://www.intensivregister.de/api/public/reporting/laendertabelle
1642838700,24993,20777,4216,2399,1419,https://www.intensivregister.de/api/public/reporting/laendertabelle
1642842300,24966,20748,4218,2402,1425,https://www.intensivregister.de/api/public/reporting/laendertabelle
1642845900,24924,20685,4239,2399,1423,https://www.intensivregister.de/api/public/reporting/laendertabelle
1642849500,24921,20682,4239,2398,1420,https://www.intensivregister.de/api/public/reporting/laendertabelle
1642853100,24921,20680,4241,2398,1420,https://www.intensivregister.de/api/public/reporting/laendertabelle
1642856700,24920,20676,4244,2398,1420,https://www.intensivregister.de/api/public/reporting/laendertabelle
1642860300,24915,20669,4246,2398,1420,https://www.intensivregister.de/api/public/reporting/laendertabelle
1642863900,24915,20668,4247,2398,1421,https://www.intensivregister.de/api/public/reporting/laendertabelle
1642867500,24915,20667,4248,2398,1421,https://www.intensivregister.de/api/public/reporting/laendertabelle
1642871100,24915,20669,4246,2397,1421,https://www.intensivregister.de/api/public/reporting/laendertabelle
1642874700,24915,20670,4245,2397,1421,https://www.intensivregister.de/api/public/reporting/laendertabelle
1642878300,24915,20669,4246,2396,1419,https://www.intensivregister.de/api/public/reporting/laendertabelle
1642881900,24915,20668,4247,2396,1419,https://www.intensivregister.de/api/public/reporting/laendertabelle
1642885500,24915,20670,4245,2396,1419,https://www.intensivregister.de/api/public/reporting/laendertabelle
1642889100,24915,20673,4242,2396,1419,https://www.intensivregister.de/api/public/reporting/laendertabelle
1642892700,24914,20674,4240,2396,1419,https://www.intensivregister.de/api/public/reporting/laendertabelle
1642896300,24914,20676,4238,2396,1419,https://www.intensivregister.de/api/public/reporting/laendertabelle
1642899900,24914,20678,4236,2397,1421,https://www.intensivregister.de/api/public/reporting/laendertabelle
1642903500,24916,20673,4243,2400,1422,https://www.intensivregister.de/api/public/reporting/laendertabelle
1642907100,24922,20675,4247,2399,1422,https://www.intensivregister.de/api/public/reporting/laendertabelle
1642910700,24922,20672,4250,2400,1422,https://www.intensivregister.de/api/public/reporting/laendertabelle
1642914300,24919,20648,4271,2401,1417,https://www.intensivregister.de/api/public/reporting/laendertabelle
1642917900,24908,20583,4325,2401,1420,https://www.intensivregister.de/api/public/reporting/laendertabelle
1642921500,24912,20507,4405,2404,1414,https://www.intensivregister.de/api/public/reporting/laendertabelle
1642925100,24900,20376,4524,2414,1417,https://www.intensivregister.de/api/public/reporting/laendertabelle
1642928700,24898,20321,4577,2416,1419,https://www.intensivregister.de/api/public/reporting/laendertabelle
1642932300,24887,20306,4581,2426,1423,https://www.intensivregister.de/api/public/reporting/laendertabelle
1642935900,24882,20299,4583,2424,1424,https://www.intensivregister.de/api/public/reporting/laendertabelle
1642939500,24882,20291,4591,2425,1423,https://www.intensivregister.de/api/public/reporting/laendertabelle
1642943100,24882,20292,4590,2425,1423,https://www.intensivregister.de/api/public/reporting/laendertabelle
1642946700,24882,20290,4592,2425,1423,https://www.intensivregister.de/api/public/reporting/laendertabelle
1642950300,24881,20289,4592,2426,1423,https://www.intensivregister.de/api/public/reporting/laendertabelle
1642953900,24881,20290,4591,2426,1423,https://www.intensivregister.de/api/public/reporting/laendertabelle
1642968300,24881,20291,4590,2426,1423,https://www.intensivregister.de/api/public/reporting/laendertabelle
1642975500,24881,20294,4587,2426,1423,https://www.intensivregister.de/api/public/reporting/laendertabelle
1642979100,24881,20293,4588,2426,1423,https://www.intensivregister.de/api/public/reporting/laendertabelle
1642982700,24883,20297,4586,2426,1424,https://www.intensivregister.de/api/public/reporting/laendertabelle
1642986300,24883,20302,4581,2426,1424,https://www.intensivregister.de/api/public/reporting/laendertabelle
1642989900,24880,20307,4573,2426,1424,https://www.intensivregister.de/api/public/reporting/laendertabelle
1642993500,24880,20308,4572,2426,1424,https://www.intensivregister.de/api/public/reporting/laendertabelle
1642997100,24886,20329,4557,2431,1425,https://www.intensivregister.de/api/public/reporting/laendertabelle
1643000700,24899,20376,4523,2432,1418,https://www.intensivregister.de/api/public/reporting/laendertabelle
1643004300,24942,20400,4542,2434,1417,https://www.intensivregister.de/api/public/reporting/laendertabelle
1643007900,25006,20462,4544,2440,1400,https://www.intensivregister.de/api/public/reporting/laendertabelle
1643011500,25003,20495,4508,2433,1391,https://www.intensivregister.de/api/public/reporting/laendertabelle
1643015100,25021,20502,4519,2433,1386,https://www.intensivregister.de/api/public/reporting/laendertabelle
1643018700,25044,20556,4488,2438,1390,https://www.intensivregister.de/api/public/reporting/laendertabelle
1643022300,25023,20536,4487,2435,1388,https://www.intensivregister.de/api/public/reporting/laendertabelle
1643025900,25020,20539,4481,2435,1389,https://www.intensivregister.de/api/public/reporting/laendertabelle
1643029500,25020,20540,4480,2437,1389,https://www.intensivregister.de/api/public/reporting/laendertabelle
1643033100,25020,20538,4482,2432,1385,https://www.intensivregister.de/api/public/reporting/laendertabelle
1643036700,25021,20542,4479,2432,1383,https://www.intensivregister.de/api/public/reporting/laendertabelle
1643040300,25021,20548,4473,2433,1384,https://www.intensivregister.de/api/public/reporting/laendertabelle
1643051100,25025,20553,4472,2437,1385,https://www.intensivregister.de/api/public/reporting/laendertabelle
1643054700,25027,20551,4476,2437,1385,https://www.intensivregister.de/api/public/reporting/laendertabelle
1643058300,25026,20550,4476,2437,1385,https://www.intensivregister.de/api/public/reporting/laendertabelle
1643065500,25030,20555,4475,2438,1386,https://www.intensivregister.de/api/public/reporting/laendertabelle
1643069100,25030,20554,4476,2439,1385,https://www.intensivregister.de/api/public/reporting/laendertabelle
1643072700,25034,20550,4484,2439,1385,https://www.intensivregister.de/api/public/reporting/laendertabelle
1643076300,25031,20550,4481,2437,1384,https://www.intensivregister.de/api/public/reporting/laendertabelle
1643079900,25030,20546,4484,2432,1382,https://www.intensivregister.de/api/public/reporting/laendertabelle
1643083500,25036,20555,4481,2431,1381,https://www.intensivregister.de/api/public/reporting/laendertabelle
1643087100,25034,20597,4437,2435,1382,https://www.intensivregister.de/api/public/reporting/laendertabelle
1643090700,25046,20698,4348,2434,1382,https://www.intensivregister.de/api/public/reporting/laendertabelle
1643094300,25066,20777,4289,2420,1383,https://www.intensivregister.de/api/public/reporting/laendertabelle
1643097900,25069,20856,4213,2415,1369,https://www.intensivregister.de/api/public/reporting/laendertabelle
1643101500,25069,20889,4180,2398,1359,https://www.intensivregister.de/api/public/reporting/laendertabelle
1643105100,25081,20908,4173,2396,1351,https://www.intensivregister.de/api/public/reporting/laendertabelle
1643108700,25080,20900,4180,2395,1351,https://www.intensivregister.de/api/public/reporting/laendertabelle
1643112300,25106,20931,4175,2393,1350,https://www.intensivregister.de/api/public/reporting/laendertabelle
1643115900,25105,20928,4177,2391,1351,https://www.intensivregister.de/api/public/reporting/laendertabelle
1643119500,25105,20931,4174,2394,1352,https://www.intensivregister.de/api/public/reporting/laendertabelle
1643123100,25106,20932,4174,2391,1351,https://www.intensivregister.de/api/public/reporting/laendertabelle
1643126700,25105,20935,4170,2392,1352,https://www.intensivregister.de/api/public/reporting/laendertabelle
1643133900,25105,20936,4169,2392,1352,https://www.intensivregister.de/api/public/reporting/laendertabelle
1643151900,25102,20931,4171,2392,1352,https://www.intensivregister.de/api/public/reporting/laendertabelle
1643155500,25098,20933,4165,2393,1353,https://www.intensivregister.de/api/public/reporting/laendertabelle
1643159100,25098,20931,4167,2392,1353,https://www.intensivregister.de/api/public/reporting/laendertabelle
1643162700,25093,20938,4155,2398,1354,https://www.intensivregister.de/api/public/reporting/laendertabelle
1643166300,25097,20937,4160,2397,1354,https://www.intensivregister.de/api/public/reporting/laendertabelle
1643169900,25098,20932,4166,2398,1352,https://www.intensivregister.de/api/public/reporting/laendertabelle
1643173500,25079,20906,4173,2402,1350,https://www.intensivregister.de/api/public/reporting/laendertabelle
1643177100,25053,20907,4146,2397,1347,https://www.intensivregister.de/api/public/reporting/laendertabelle
1643180700,25065,20948,4117,2393,1339,https://www.intensivregister.de/api/public/reporting/laendertabelle
1643186865,25087,21067,4020,2371,1313,https://www.intensivregister.de/api/public/reporting/laendertabelle
1643187900,25090,21078,4012,2369,1310,https://www.intensivregister.de/api/public/reporting/laendertabelle
1643193692,25078,21078,4000,2363,1311,https://www.intensivregister.de/api/public/reporting/laendertabelle
1643195100,25077,21078,3999,2364,1311,https://www.intensivregister.de/api/public/reporting/laendertabelle
1643198700,25074,21078,3996,2361,1311,https://www.intensivregister.de/api/public/reporting/laendertabelle
1643202300,25076,21083,3993,2363,1311,https://www.intensivregister.de/api/public/reporting/laendertabelle
1643205900,25076,21082,3994,2363,1311,https://www.intensivregister.de/api/public/reporting/laendertabelle
1643209500,25076,21081,3995,2364,1311,https://www.intensivregister.de/api/public/reporting/laendertabelle
1643213100,25076,21080,3996,2365,1312,https://www.intensivregister.de/api/public/reporting/laendertabelle
1643234700,25076,21082,3994,2365,1312,https://www.intensivregister.de/api/public/reporting/laendertabelle
1643238300,25076,21088,3988,2364,1312,https://www.intensivregister.de/api/public/reporting/laendertabelle
1643241900,25078,21088,3990,2363,1312,https://www.intensivregister.de/api/public/reporting/laendertabelle
1643245500,25077,21083,3994,2364,1313,https://www.intensivregister.de/api/public/reporting/laendertabelle
1643249100,25076,21082,3994,2364,1312,https://www.intensivregister.de/api/public/reporting/laendertabelle
1643252700,25074,21092,3982,2361,1312,https://www.intensivregister.de/api/public/reporting/laendertabelle
1643256300,25076,21100,3976,2361,1313,https://www.intensivregister.de/api/public/reporting/laendertabelle
1643259900,25065,21110,3955,2349,1306,https://www.intensivregister.de/api/public/reporting/laendertabelle
1643264654,25058,21092,3966,2320,1305,https://www.intensivregister.de/api/public/reporting/laendertabelle
1643270700,25048,21052,3996,2296,1298,https://www.intensivregister.de/api/public/reporting/laendertabelle
1643274300,25040,21035,4005,2281,1285,https://www.intensivregister.de/api/public/reporting/laendertabelle
1643277900,25035,21016,4019,2272,1283,https://www.intensivregister.de/api/public/reporting/laendertabelle
1643281500,25035,21025,4010,2274,1279,https://www.intensivregister.de/api/public/reporting/laendertabelle
1643285100,25036,21020,4016,2274,1279,https://www.intensivregister.de/api/public/reporting/laendertabelle
1643288700,25036,21019,4017,2272,1279,https://www.intensivregister.de/api/public/reporting/laendertabelle
1643292300,25036,21013,4023,2271,1278,https://www.intensivregister.de/api/public/reporting/laendertabelle
1643295900,25035,21015,4020,2271,1277,https://www.intensivregister.de/api/public/reporting/laendertabelle
1643299500,25035,21017,4018,2271,1277,https://www.intensivregister.de/api/public/reporting/laendertabelle
1643303100,25035,21018,4017,2272,1277,https://www.intensivregister.de/api/public/reporting/laendertabelle
1643313900,25035,21020,4015,2273,1278,https://www.intensivregister.de/api/public/reporting/laendertabelle
1643324700,25036,21019,4017,2273,1278,https://www.intensivregister.de/api/public/reporting/laendertabelle
1643328300,25031,21024,4007,2273,1277,https://www.intensivregister.de/api/public/reporting/laendertabelle
1643331900,25031,21024,4007,2274,1277,https://www.intensivregister.de/api/public/reporting/laendertabelle
1643335500,25028,21013,4015,2274,1277,https://www.intensivregister.de/api/public/reporting/laendertabelle
1643339100,25027,21008,4019,2275,1277,https://www.intensivregister.de/api/public/reporting/laendertabelle
1643342700,25024,20987,4037,2275,1275,https://www.intensivregister.de/api/public/reporting/laendertabelle
1643346300,25030,21002,4028,2268,1277,https://www.intensivregister.de/api/public/reporting/laendertabelle
1643349900,25034,20997,4037,2264,1269,https://www.intensivregister.de/api/public/reporting/laendertabelle
1643353500,25007,20954,4053,2253,1253,https://www.intensivregister.de/api/public/reporting/laendertabelle
1643357100,25003,20971,4032,2253,1254,https://www.intensivregister.de/api/public/reporting/laendertabelle
1643360700,24993,20934,4059,2252,1252,https://www.intensivregister.de/api/public/reporting/laendertabelle
1643364300,24992,20940,4052,2260,1253,https://www.intensivregister.de/api/public/reporting/laendertabelle
1643367900,24987,20938,4049,2261,1252,https://www.intensivregister.de/api/public/reporting/laendertabelle
1643371500,24981,20930,4051,2261,1251,https://www.intensivregister.de/api/public/reporting/laendertabelle
1643375100,24982,20929,4053,2261,1252,https://www.intensivregister.de/api/public/reporting/laendertabelle
1643378700,24982,20923,4059,2259,1249,https://www.intensivregister.de/api/public/reporting/laendertabelle
1643382300,24980,20918,4062,2257,1248,https://www.intensivregister.de/api/public/reporting/laendertabelle
1643385900,24978,20917,4061,2257,1248,https://www.intensivregister.de/api/public/reporting/laendertabelle
1643389500,24978,20916,4062,2258,1248,https://www.intensivregister.de/api/public/reporting/laendertabelle
1643407500,24978,20915,4063,2258,1248,https://www.intensivregister.de/api/public/reporting/laendertabelle
1643411100,24979,20914,4065,2256,1247,https://www.intensivregister.de/api/public/reporting/laendertabelle
1643414700,24979,20909,4070,2255,1247,https://www.intensivregister.de/api/public/reporting/laendertabelle
1643418300,24979,20915,4064,2255,1247,https://www.intensivregister.de/api/public/reporting/laendertabelle
1643421900,24984,20912,4072,2256,1247,https://www.intensivregister.de/api/public/reporting/laendertabelle
1643425500,24983,20914,4069,2255,1247,https://www.intensivregister.de/api/public/reporting/laendertabelle
1643429100,24977,20915,4062,2253,1245,https://www.intensivregister.de/api/public/reporting/laendertabelle
1643432700,24969,20902,4067,2254,1245,https://www.intensivregister.de/api/public/reporting/laendertabelle
1643436300,24950,20857,4093,2245,1246,https://www.intensivregister.de/api/public/reporting/laendertabelle
1643439900,24884,20810,4074,2236,1233,https://www.intensivregister.de/api/public/reporting/laendertabelle
1643443500,24852,20717,4135,2219,1224,https://www.intensivregister.de/api/public/reporting/laendertabelle
1643447100,24812,20668,4144,2226,1224,https://www.intensivregister.de/api/public/reporting/laendertabelle
1643450700,24793,20625,4168,2224,1225,https://www.intensivregister.de/api/public/reporting/laendertabelle
1643454300,24781,20595,4186,2227,1227,https://www.intensivregister.de/api/public/reporting/laendertabelle
1643457900,24780,20596,4184,2226,1224,https://www.intensivregister.de/api/public/reporting/laendertabelle
1643461500,24781,20589,4192,2225,1223,https://www.intensivregister.de/api/public/reporting/laendertabelle
1643465100,24777,20587,4190,2225,1223,https://www.intensivregister.de/api/public/reporting/laendertabelle
1643468700,24777,20589,4188,2225,1223,https://www.intensivregister.de/api/public/reporting/laendertabelle
1643472300,24776,20588,4188,2226,1223,https://www.intensivregister.de/api/public/reporting/laendertabelle
1643475900,24776,20581,4195,2228,1223,https://www.intensivregister.de/api/public/reporting/laendertabelle
1643490300,24776,20582,4194,2228,1223,https://www.intensivregister.de/api/public/reporting/laendertabelle
1643497500,24778,20583,4195,2229,1223,https://www.intensivregister.de/api/public/reporting/laendertabelle
1643501100,24778,20585,4193,2230,1223,https://www.intensivregister.de/api/public/reporting/laendertabelle
1643504700,24778,20582,4196,2230,1223,https://www.intensivregister.de/api/public/reporting/laendertabelle
1643508300,24776,20586,4190,2230,1225,https://www.intensivregister.de/api/public/reporting/laendertabelle
1643511900,24778,20586,4192,2230,1225,https://www.intensivregister.de/api/public/reporting/laendertabelle
1643515500,24773,20575,4198,2231,1227,https://www.intensivregister.de/api/public/reporting/laendertabelle
1643519100,24770,20576,4194,2230,1228,https://www.intensivregister.de/api/public/reporting/laendertabelle
1643522700,24761,20522,4239,2230,1226,https://www.intensivregister.de/api/public/reporting/laendertabelle
1643526300,24722,20403,4319,2254,1215,https://www.intensivregister.de/api/public/reporting/laendertabelle
1643529900,24713,20298,4415,2260,1212,https://www.intensivregister.de/api/public/reporting/laendertabelle
1643533500,24707,20291,4416,2268,1212,https://www.intensivregister.de/api/public/reporting/laendertabelle
1643537100,24695,20240,4455,2268,1213,https://www.intensivregister.de/api/public/reporting/laendertabelle
1643540700,24689,20227,4462,2268,1213,https://www.intensivregister.de/api/public/reporting/laendertabelle
1643544300,24684,20210,4474,2269,1214,https://www.intensivregister.de/api/public/reporting/laendertabelle
1643547900,24684,20210,4474,2271,1215,https://www.intensivregister.de/api/public/reporting/laendertabelle
1643551500,24684,20202,4482,2272,1216,https://www.intensivregister.de/api/public/reporting/laendertabelle
1643555100,24684,20200,4484,2273,1215,https://www.intensivregister.de/api/public/reporting/laendertabelle
1643558700,24684,20201,4483,2274,1215,https://www.intensivregister.de/api/public/reporting/laendertabelle
1643562300,24684,20204,4480,2274,1215,https://www.intensivregister.de/api/public/reporting/laendertabelle
1643569500,24684,20203,4481,2274,1215,https://www.intensivregister.de/api/public/reporting/laendertabelle
1643576700,24684,20205,4479,2275,1215,https://www.intensivregister.de/api/public/reporting/laendertabelle
1643580300,24684,20206,4478,2275,1215,https://www.intensivregister.de/api/public/reporting/laendertabelle
1643583900,24682,20201,4481,2275,1215,https://www.intensivregister.de/api/public/reporting/laendertabelle
1643587500,24681,20205,4476,2274,1215,https://www.intensivregister.de/api/public/reporting/laendertabelle
1643591100,24681,20206,4475,2274,1215,https://www.intensivregister.de/api/public/reporting/laendertabelle
1643594700,24678,20194,4484,2273,1215,https://www.intensivregister.de/api/public/reporting/laendertabelle
1643598300,24677,20198,4479,2280,1216,https://www.intensivregister.de/api/public/reporting/laendertabelle
1643601900,24680,20211,4469,2281,1215,https://www.intensivregister.de/api/public/reporting/laendertabelle
1643605500,24706,20216,4490,2275,1216,https://www.intensivregister.de/api/public/reporting/laendertabelle
1643609100,24746,20261,4485,2275,1214,https://www.intensivregister.de/api/public/reporting/laendertabelle
1643612700,24808,20365,4443,2280,1210,https://www.intensivregister.de/api/public/reporting/laendertabelle
1643616300,24836,20423,4413,2280,1202,https://www.intensivregister.de/api/public/reporting/laendertabelle
1643619900,24849,20440,4409,2290,1201,https://www.intensivregister.de/api/public/reporting/laendertabelle
1643623500,24873,20427,4446,2300,1205,https://www.intensivregister.de/api/public/reporting/laendertabelle
1643627100,24878,20435,4443,2298,1202,https://www.intensivregister.de/api/public/reporting/laendertabelle
1643630700,24878,20436,4442,2299,1202,https://www.intensivregister.de/api/public/reporting/laendertabelle
1643634300,24880,20438,4442,2299,1204,https://www.intensivregister.de/api/public/reporting/laendertabelle
1643637900,24878,20439,4439,2298,1204,https://www.intensivregister.de/api/public/reporting/laendertabelle
1643641500,24879,20441,4438,2299,1204,https://www.intensivregister.de/api/public/reporting/laendertabelle
1643645100,24879,20440,4439,2299,1204,https://www.intensivregister.de/api/public/reporting/laendertabelle
1643648700,24879,20441,4438,2300,1204,https://www.intensivregister.de/api/public/reporting/laendertabelle
1643652300,24879,20439,4440,2301,1205,https://www.intensivregister.de/api/public/reporting/laendertabelle
1643659500,24879,20439,4440,2299,1204,https://www.intensivregister.de/api/public/reporting/laendertabelle
1643670300,24878,20452,4426,2300,1205,https://www.intensivregister.de/api/public/reporting/laendertabelle
1643673900,24878,20458,4420,2301,1205,https://www.intensivregister.de/api/public/reporting/laendertabelle
1643677500,24877,20462,4415,2302,1205,https://www.intensivregister.de/api/public/reporting/laendertabelle
1643681100,24886,20468,4418,2298,1202,https://www.intensivregister.de/api/public/reporting/laendertabelle
1643684700,24886,20470,4416,2297,1203,https://www.intensivregister.de/api/public/reporting/laendertabelle
1643688300,24888,20478,4410,2297,1204,https://www.intensivregister.de/api/public/reporting/laendertabelle
1643691900,24919,20543,4376,2299,1208,https://www.intensivregister.de/api/public/reporting/laendertabelle
1643695500,24944,20668,4276,2307,1213,https://www.intensivregister.de/api/public/reporting/laendertabelle
1643699100,24961,20774,4187,2294,1200,https://www.intensivregister.de/api/public/reporting/laendertabelle
1643702700,24990,20874,4116,2284,1185,https://www.intensivregister.de/api/public/reporting/laendertabelle
1643706300,24986,20954,4032,2270,1180,https://www.intensivregister.de/api/public/reporting/laendertabelle
1643709900,25001,20969,4032,2257,1177,https://www.intensivregister.de/api/public/reporting/laendertabelle
1643713500,24999,20981,4018,2257,1177,https://www.intensivregister.de/api/public/reporting/laendertabelle
1643717100,24992,20977,4015,2260,1178,https://www.intensivregister.de/api/public/reporting/laendertabelle
1643720700,24990,20980,4010,2261,1179,https://www.intensivregister.de/api/public/reporting/laendertabelle
1643724300,24990,20981,4009,2261,1178,https://www.intensivregister.de/api/public/reporting/laendertabelle
1643727900,24988,20980,4008,2262,1179,https://www.intensivregister.de/api/public/reporting/laendertabelle
1643731500,24986,20982,4004,2261,1179,https://www.intensivregister.de/api/public/reporting/laendertabelle
1643735100,24986,20985,4001,2260,1180,https://www.intensivregister.de/api/public/reporting/laendertabelle
1643742300,24986,20987,3999,2261,1181,https://www.intensivregister.de/api/public/reporting/laendertabelle
1643745900,24986,20987,3999,2262,1181,https://www.intensivregister.de/api/public/reporting/laendertabelle
1643749500,24986,20987,3999,2261,1181,https://www.intensivregister.de/api/public/reporting/laendertabelle
1643753100,24988,20987,4001,2261,1181,https://www.intensivregister.de/api/public/reporting/laendertabelle
1643756700,24989,20993,3996,2262,1181,https://www.intensivregister.de/api/public/reporting/laendertabelle
1643760300,24991,20988,4003,2261,1181,https://www.intensivregister.de/api/public/reporting/laendertabelle
1643763900,24992,20990,4002,2261,1181,https://www.intensivregister.de/api/public/reporting/laendertabelle
1643767500,24984,20985,3999,2261,1180,https://www.intensivregister.de/api/public/reporting/laendertabelle
1643774700,24984,20971,4013,2259,1179,https://www.intensivregister.de/api/public/reporting/laendertabelle
1643778300,24988,20999,3989,2254,1173,https://www.intensivregister.de/api/public/reporting/laendertabelle
1643781900,25002,20998,4004,2265,1176,https://www.intensivregister.de/api/public/reporting/laendertabelle
1643785500,25007,21053,3954,2288,1171,https://www.intensivregister.de/api/public/reporting/laendertabelle
1643789100,25028,21080,3948,2302,1175,https://www.intensivregister.de/api/public/reporting/laendertabelle
1643792700,25034,21072,3962,2307,1182,https://www.intensivregister.de/api/public/reporting/laendertabelle
1643796300,25030,21084,3946,2307,1180,https://www.intensivregister.de/api/public/reporting/laendertabelle
1643799900,25033,21090,3943,2308,1181,https://www.intensivregister.de/api/public/reporting/laendertabelle
1643803500,25027,21089,3938,2311,1181,https://www.intensivregister.de/api/public/reporting/laendertabelle
1643807100,25027,21091,3936,2310,1181,https://www.intensivregister.de/api/public/reporting/laendertabelle
1643810700,25029,21091,3938,2311,1180,https://www.intensivregister.de/api/public/reporting/laendertabelle
1643814300,25029,21094,3935,2316,1179,https://www.intensivregister.de/api/public/reporting/laendertabelle
1643817900,25027,21094,3933,2316,1179,https://www.intensivregister.de/api/public/reporting/laendertabelle
1643821500,25027,21093,3934,2314,1179,https://www.intensivregister.de/api/public/reporting/laendertabelle
1643825100,25027,21094,3933,2314,1179,https://www.intensivregister.de/api/public/reporting/laendertabelle
1643828700,25027,21093,3934,2315,1180,https://www.intensivregister.de/api/public/reporting/laendertabelle
1643832300,25027,21093,3934,2317,1180,https://www.intensivregister.de/api/public/reporting/laendertabelle
1643839500,25026,21092,3934,2316,1180,https://www.intensivregister.de/api/public/reporting/laendertabelle
1643843100,25026,21089,3937,2315,1181,https://www.intensivregister.de/api/public/reporting/laendertabelle
1643846700,25032,21093,3939,2315,1179,https://www.intensivregister.de/api/public/reporting/laendertabelle
1643850300,25031,21091,3940,2315,1179,https://www.intensivregister.de/api/public/reporting/laendertabelle
1643853900,25034,21097,3937,2314,1178,https://www.intensivregister.de/api/public/reporting/laendertabelle
1643857500,25031,21095,3936,2314,1178,https://www.intensivregister.de/api/public/reporting/laendertabelle
1643861100,25030,21094,3936,2312,1176,https://www.intensivregister.de/api/public/reporting/laendertabelle
1643864700,25026,21101,3925,2297,1170,https://www.intensivregister.de/api/public/reporting/laendertabelle
1643868300,25027,21081,3946,2293,1156,https://www.intensivregister.de/api/public/reporting/laendertabelle
1643871900,25030,21131,3899,2289,1167,https://www.intensivregister.de/api/public/reporting/laendertabelle
1643875500,25031,21160,3871,2268,1159,https://www.intensivregister.de/api/public/reporting/laendertabelle
1643879100,25034,21189,3845,2261,1148,https://www.intensivregister.de/api/public/reporting/laendertabelle
1643882700,25029,21191,3838,2262,1146,https://www.intensivregister.de/api/public/reporting/laendertabelle
1643886300,25026,21198,3828,2266,1148,https://www.intensivregister.de/api/public/reporting/laendertabelle
1643889900,25023,21194,3829,2266,1149,https://www.intensivregister.de/api/public/reporting/laendertabelle
1643893500,25021,21192,3829,2264,1148,https://www.intensivregister.de/api/public/reporting/laendertabelle
1643897100,25021,21193,3828,2266,1146,https://www.intensivregister.de/api/public/reporting/laendertabelle
1643900700,25021,21191,3830,2265,1145,https://www.intensivregister.de/api/public/reporting/laendertabelle
1643904300,25021,21192,3829,2265,1145,https://www.intensivregister.de/api/public/reporting/laendertabelle
1643907900,25021,21193,3828,2265,1145,https://www.intensivregister.de/api/public/reporting/laendertabelle
1643911500,25021,21195,3826,2265,1145,https://www.intensivregister.de/api/public/reporting/laendertabelle
1643915100,25019,21195,3824,2265,1145,https://www.intensivregister.de/api/public/reporting/laendertabelle
1643922300,25019,21196,3823,2265,1145,https://www.intensivregister.de/api/public/reporting/laendertabelle
1643925900,25020,21199,3821,2265,1145,https://www.intensivregister.de/api/public/reporting/laendertabelle
1643929500,25021,21197,3824,2264,1145,https://www.intensivregister.de/api/public/reporting/laendertabelle
1643933100,25020,21194,3826,2264,1145,https://www.intensivregister.de/api/public/reporting/laendertabelle
1643936700,25018,21189,3829,2264,1145,https://www.intensivregister.de/api/public/reporting/laendertabelle
1643940300,25013,21185,3828,2261,1144,https://www.intensivregister.de/api/public/reporting/laendertabelle
1643943900,25017,21190,3827,2261,1145,https://www.intensivregister.de/api/public/reporting/laendertabelle
1643947500,25012,21184,3828,2264,1146,https://www.intensivregister.de/api/public/reporting/laendertabelle
1643951100,24994,21160,3834,2274,1147,https://www.intensivregister.de/api/public/reporting/laendertabelle
1643954700,24997,21117,3880,2266,1137,https://www.intensivregister.de/api/public/reporting/laendertabelle
1643958300,24981,21114,3867,2272,1132,https://www.intensivregister.de/api/public/reporting/laendertabelle
1643961900,24970,21140,3830,2292,1137,https://www.intensivregister.de/api/public/reporting/laendertabelle
1643965500,24946,21158,3788,2305,1141,https://www.intensivregister.de/api/public/reporting/laendertabelle
1643969100,24945,21161,3784,2311,1143,https://www.intensivregister.de/api/public/reporting/laendertabelle
1643972700,24945,21160,3785,2308,1142,https://www.intensivregister.de/api/public/reporting/laendertabelle
1643976300,24944,21167,3777,2309,1143,https://www.intensivregister.de/api/public/reporting/laendertabelle
1643979900,24946,21168,3778,2309,1143,https://www.intensivregister.de/api/public/reporting/laendertabelle
1643983500,24945,21166,3779,2311,1143,https://www.intensivregister.de/api/public/reporting/laendertabelle
1643987100,24942,21167,3775,2309,1142,https://www.intensivregister.de/api/public/reporting/laendertabelle
1643990700,24942,21168,3774,2311,1142,https://www.intensivregister.de/api/public/reporting/laendertabelle
1643994300,24941,21169,3772,2312,1142,https://www.intensivregister.de/api/public/reporting/laendertabelle
1643997900,24936,21168,3768,2312,1142,https://www.intensivregister.de/api/public/reporting/laendertabelle
1644001500,24936,21168,3768,2311,1142,https://www.intensivregister.de/api/public/reporting/laendertabelle
1644012300,24943,21171,3772,2311,1142,https://www.intensivregister.de/api/public/reporting/laendertabelle
1644015900,24941,21157,3784,2311,1141,https://www.intensivregister.de/api/public/reporting/laendertabelle
1644019500,24941,21154,3787,2312,1142,https://www.intensivregister.de/api/public/reporting/laendertabelle
1644023100,24939,21159,3780,2312,1142,https://www.intensivregister.de/api/public/reporting/laendertabelle
1644026700,24940,21154,3786,2312,1142,https://www.intensivregister.de/api/public/reporting/laendertabelle
1644030300,24940,21154,3786,2313,1143,https://www.intensivregister.de/api/public/reporting/laendertabelle
1644033900,24941,21152,3789,2314,1143,https://www.intensivregister.de/api/public/reporting/laendertabelle
1644037500,24929,21129,3800,2314,1144,https://www.intensivregister.de/api/public/reporting/laendertabelle
1644041100,24919,21086,3833,2314,1139,https://www.intensivregister.de/api/public/reporting/laendertabelle
1644044700,24876,21015,3861,2310,1144,https://www.intensivregister.de/api/public/reporting/laendertabelle
1644048300,24818,20918,3900,2308,1148,https://www.intensivregister.de/api/public/reporting/laendertabelle
1644051900,24790,20846,3944,2314,1154,https://www.intensivregister.de/api/public/reporting/laendertabelle
1644055500,24777,20805,3972,2309,1158,https://www.intensivregister.de/api/public/reporting/laendertabelle
1644059100,24764,20796,3968,2309,1156,https://www.intensivregister.de/api/public/reporting/laendertabelle
1644062700,24759,20787,3972,2310,1155,https://www.intensivregister.de/api/public/reporting/laendertabelle
1644066300,24759,20792,3967,2310,1155,https://www.intensivregister.de/api/public/reporting/laendertabelle
1644069900,24761,20793,3968,2310,1155,https://www.intensivregister.de/api/public/reporting/laendertabelle
1644073500,24761,20794,3967,2310,1155,https://www.intensivregister.de/api/public/reporting/laendertabelle
1644077100,24747,20780,3967,2310,1155,https://www.intensivregister.de/api/public/reporting/laendertabelle
1644080700,24746,20778,3968,2309,1155,https://www.intensivregister.de/api/public/reporting/laendertabelle
1644084300,24745,20776,3969,2308,1154,https://www.intensivregister.de/api/public/reporting/laendertabelle
1644087900,24745,20775,3970,2309,1155,https://www.intensivregister.de/api/public/reporting/laendertabelle
1644102300,24742,20764,3978,2308,1157,https://www.intensivregister.de/api/public/reporting/laendertabelle
1644105900,24746,20764,3982,2309,1157,https://www.intensivregister.de/api/public/reporting/laendertabelle
1644109500,24746,20762,3984,2310,1157,https://www.intensivregister.de/api/public/reporting/laendertabelle
1644113100,24747,20754,3993,2313,1157,https://www.intensivregister.de/api/public/reporting/laendertabelle
1644116700,24749,20752,3997,2315,1157,https://www.intensivregister.de/api/public/reporting/laendertabelle
1644120300,24748,20748,4000,2310,1155,https://www.intensivregister.de/api/public/reporting/laendertabelle
1644123900,24743,20719,4024,2312,1154,https://www.intensivregister.de/api/public/reporting/laendertabelle
1644127500,24728,20684,4044,2313,1155,https://www.intensivregister.de/api/public/reporting/laendertabelle
1644131100,24710,20573,4137,2328,1153,https://www.intensivregister.de/api/public/reporting/laendertabelle
1644134700,24708,20476,4232,2331,1148,https://www.intensivregister.de/api/public/reporting/laendertabelle
1644138300,24695,20414,4281,2335,1151,https://www.intensivregister.de/api/public/reporting/laendertabelle
1644141900,24689,20385,4304,2350,1150,https://www.intensivregister.de/api/public/reporting/laendertabelle
1644145500,24686,20373,4313,2351,1154,https://www.intensivregister.de/api/public/reporting/laendertabelle
1644149100,24683,20364,4319,2349,1154,https://www.intensivregister.de/api/public/reporting/laendertabelle
1644152700,24682,20365,4317,2349,1154,https://www.intensivregister.de/api/public/reporting/laendertabelle
1644156300,24682,20363,4319,2349,1154,https://www.intensivregister.de/api/public/reporting/laendertabelle
1644159900,24682,20362,4320,2349,1154,https://www.intensivregister.de/api/public/reporting/laendertabelle
1644170700,24682,20361,4321,2348,1153,https://www.intensivregister.de/api/public/reporting/laendertabelle
1644174300,24680,20357,4323,2345,1152,https://www.intensivregister.de/api/public/reporting/laendertabelle
1644177900,24680,20357,4323,2346,1152,https://www.intensivregister.de/api/public/reporting/laendertabelle
1644188700,24679,20354,4325,2343,1152,https://www.intensivregister.de/api/public/reporting/laendertabelle
1644192300,24679,20353,4326,2343,1152,https://www.intensivregister.de/api/public/reporting/laendertabelle
1644195900,24682,20355,4327,2345,1153,https://www.intensivregister.de/api/public/reporting/laendertabelle
1644199500,24680,20356,4324,2344,1153,https://www.intensivregister.de/api/public/reporting/laendertabelle
1644203100,24679,20354,4325,2341,1151,https://www.intensivregister.de/api/public/reporting/laendertabelle
1644206700,24685,20367,4318,2342,1151,https://www.intensivregister.de/api/public/reporting/laendertabelle
1644210300,24678,20366,4312,2340,1149,https://www.intensivregister.de/api/public/reporting/laendertabelle
1644213900,24737,20400,4337,2349,1150,https://www.intensivregister.de/api/public/reporting/laendertabelle
1644217500,24772,20443,4329,2359,1166,https://www.intensivregister.de/api/public/reporting/laendertabelle
1644221100,24814,20488,4326,2344,1171,https://www.intensivregister.de/api/public/reporting/laendertabelle
1644224700,24826,20510,4316,2368,1175,https://www.intensivregister.de/api/public/reporting/laendertabelle
1644228300,24800,20501,4299,2374,1184,https://www.intensivregister.de/api/public/reporting/laendertabelle
1644231900,24801,20506,4295,2372,1188,https://www.intensivregister.de/api/public/reporting/laendertabelle
1644235500,24802,20510,4292,2372,1187,https://www.intensivregister.de/api/public/reporting/laendertabelle
1644239100,24806,20517,4289,2373,1187,https://www.intensivregister.de/api/public/reporting/laendertabelle
1644242700,24806,20518,4288,2372,1186,https://www.intensivregister.de/api/public/reporting/laendertabelle
1644246300,24806,20520,4286,2373,1186,https://www.intensivregister.de/api/public/reporting/laendertabelle
1644249900,24804,20533,4271,2373,1185,https://www.intensivregister.de/api/public/reporting/laendertabelle
1644264300,24804,20533,4271,2372,1185,https://www.intensivregister.de/api/public/reporting/laendertabelle
1644271500,24804,20529,4275,2371,1185,https://www.intensivregister.de/api/public/reporting/laendertabelle
1644275100,24811,20533,4278,2369,1184,https://www.intensivregister.de/api/public/reporting/laendertabelle
1644278700,24811,20538,4273,2371,1184,https://www.intensivregister.de/api/public/reporting/laendertabelle
1644282300,24809,20536,4273,2371,1184,https://www.intensivregister.de/api/public/reporting/laendertabelle
1644285900,24807,20537,4270,2369,1184,https://www.intensivregister.de/api/public/reporting/laendertabelle
1644289500,24808,20536,4272,2370,1183,https://www.intensivregister.de/api/public/reporting/laendertabelle
1644293100,24812,20537,4275,2373,1182,https://www.intensivregister.de/api/public/reporting/laendertabelle
1644296700,24818,20660,4158,2376,1178,https://www.intensivregister.de/api/public/reporting/laendertabelle
1644300300,24838,20779,4059,2383,1183,https://www.intensivregister.de/api/public/reporting/laendertabelle
1644303900,24885,20891,3994,2375,1179,https://www.intensivregister.de/api/public/reporting/laendertabelle
1644307500,24923,20969,3954,2392,1171,https://www.intensivregister.de/api/public/reporting/laendertabelle
1644311100,24929,21001,3928,2395,1177,https://www.intensivregister.de/api/public/reporting/laendertabelle
1644314700,24930,21003,3927,2393,1173,https://www.intensivregister.de/api/public/reporting/laendertabelle
1644318300,24930,20999,3931,2392,1175,https://www.intensivregister.de/api/public/reporting/laendertabelle
1644321900,24929,20999,3930,2396,1177,https://www.intensivregister.de/api/public/reporting/laendertabelle
1644325500,24929,20999,3930,2399,1177,https://www.intensivregister.de/api/public/reporting/laendertabelle
1644329100,24929,20998,3931,2401,1178,https://www.intensivregister.de/api/public/reporting/laendertabelle
1644332700,24929,20995,3934,2402,1178,https://www.intensivregister.de/api/public/reporting/laendertabelle
1644336300,24929,20997,3932,2402,1179,https://www.intensivregister.de/api/public/reporting/laendertabelle
1644350700,24929,20997,3932,2403,1179,https://www.intensivregister.de/api/public/reporting/laendertabelle
1644354300,24929,20998,3931,2403,1179,https://www.intensivregister.de/api/public/reporting/laendertabelle
1644357900,24928,20994,3934,2403,1179,https://www.intensivregister.de/api/public/reporting/laendertabelle
1644361500,24928,20991,3937,2404,1179,https://www.intensivregister.de/api/public/reporting/laendertabelle
1644365100,24932,21001,3931,2403,1179,https://www.intensivregister.de/api/public/reporting/laendertabelle
1644368700,24932,21000,3932,2403,1179,https://www.intensivregister.de/api/public/reporting/laendertabelle
1644372300,24932,20997,3935,2403,1179,https://www.intensivregister.de/api/public/reporting/laendertabelle
1644375900,24934,21000,3934,2405,1180,https://www.intensivregister.de/api/public/reporting/laendertabelle
1644379500,24936,21004,3932,2405,1184,https://www.intensivregister.de/api/public/reporting/laendertabelle
1644383100,24928,20977,3951,2391,1177,https://www.intensivregister.de/api/public/reporting/laendertabelle
1644386700,24936,21010,3926,2392,1187,https://www.intensivregister.de/api/public/reporting/laendertabelle
1644390300,24936,21058,3878,2405,1188,https://www.intensivregister.de/api/public/reporting/laendertabelle
1644393900,24961,21103,3858,2409,1175,https://www.intensivregister.de/api/public/reporting/laendertabelle
1644397500,24960,21135,3825,2402,1171,https://www.intensivregister.de/api/public/reporting/laendertabelle
1644401100,24964,21108,3856,2400,1164,https://www.intensivregister.de/api/public/reporting/laendertabelle
1644404700,24978,21137,3841,2398,1165,https://www.intensivregister.de/api/public/reporting/laendertabelle
1644408300,24978,21127,3851,2397,1163,https://www.intensivregister.de/api/public/reporting/laendertabelle
1644411900,24980,21129,3851,2396,1164,https://www.intensivregister.de/api/public/reporting/laendertabelle
1644415500,24980,21134,3846,2398,1165,https://www.intensivregister.de/api/public/reporting/laendertabelle
1644419100,24980,21135,3845,2396,1164,https://www.intensivregister.de/api/public/reporting/laendertabelle
1644422700,24980,21137,3843,2395,1163,https://www.intensivregister.de/api/public/reporting/laendertabelle
1644426300,24978,21135,3843,2395,1163,https://www.intensivregister.de/api/public/reporting/laendertabelle
1644429900,24978,21134,3844,2394,1163,https://www.intensivregister.de/api/public/reporting/laendertabelle
1644433500,24978,21135,3843,2394,1163,https://www.intensivregister.de/api/public/reporting/laendertabelle
1644437100,24978,21139,3839,2393,1162,https://www.intensivregister.de/api/public/reporting/laendertabelle
1644440700,24978,21141,3837,2393,1162,https://www.intensivregister.de/api/public/reporting/laendertabelle
1644444300,24978,21142,3836,2394,1162,https://www.intensivregister.de/api/public/reporting/laendertabelle
1644447900,24977,21137,3840,2391,1161,https://www.intensivregister.de/api/public/reporting/laendertabelle
1644451500,24977,21140,3837,2393,1161,https://www.intensivregister.de/api/public/reporting/laendertabelle
1644455100,24976,21140,3836,2394,1161,https://www.intensivregister.de/api/public/reporting/laendertabelle
1644458700,24976,21138,3838,2394,1161,https://www.intensivregister.de/api/public/reporting/laendertabelle
1644462300,24975,21128,3847,2395,1159,https://www.intensivregister.de/api/public/reporting/laendertabelle
1644465900,24969,21133,3836,2397,1158,https://www.intensivregister.de/api/public/reporting/laendertabelle
1644469500,24965,21153,3812,2407,1159,https://www.intensivregister.de/api/public/reporting/laendertabelle
1644473100,24991,21120,3871,2394,1163,https://www.intensivregister.de/api/public/reporting/laendertabelle
1644476700,25013,21128,3885,2395,1161,https://www.intensivregister.de/api/public/reporting/laendertabelle
1644480300,24999,21122,3877,2390,1167,https://www.intensivregister.de/api/public/reporting/laendertabelle
1644483900,25001,21148,3853,2394,1174,https://www.intensivregister.de/api/public/reporting/laendertabelle
1644487500,25003,21142,3861,2394,1174,https://www.intensivregister.de/api/public/reporting/laendertabelle
1644491100,25005,21157,3848,2395,1175,https://www.intensivregister.de/api/public/reporting/laendertabelle
1644494700,25005,21155,3850,2395,1175,https://www.intensivregister.de/api/public/reporting/laendertabelle
1644498300,25005,21151,3854,2395,1175,https://www.intensivregister.de/api/public/reporting/laendertabelle
1644501900,25005,21149,3856,2395,1175,https://www.intensivregister.de/api/public/reporting/laendertabelle
1644505500,25006,21145,3861,2396,1175,https://www.intensivregister.de/api/public/reporting/laendertabelle
1644509100,25006,21146,3860,2396,1175,https://www.intensivregister.de/api/public/reporting/laendertabelle
1644512700,25006,21145,3861,2395,1174,https://www.intensivregister.de/api/public/reporting/laendertabelle
1644516300,25006,21146,3860,2394,1174,https://www.intensivregister.de/api/public/reporting/laendertabelle
1644519900,25004,21146,3858,2394,1174,https://www.intensivregister.de/api/public/reporting/laendertabelle
1644530700,25003,21148,3855,2394,1174,https://www.intensivregister.de/api/public/reporting/laendertabelle
1644534300,25003,21150,3853,2394,1174,https://www.intensivregister.de/api/public/reporting/laendertabelle
1644537900,25003,21154,3849,2394,1174,https://www.intensivregister.de/api/public/reporting/laendertabelle
1644541500,25003,21157,3846,2396,1175,https://www.intensivregister.de/api/public/reporting/laendertabelle
1644545100,24998,21153,3845,2394,1177,https://www.intensivregister.de/api/public/reporting/laendertabelle
1644548700,24996,21148,3848,2393,1177,https://www.intensivregister.de/api/public/reporting/laendertabelle
1644552300,24993,21127,3866,2392,1176,https://www.intensivregister.de/api/public/reporting/laendertabelle
1644555900,25002,21135,3867,2386,1171,https://www.intensivregister.de/api/public/reporting/laendertabelle
1644559500,24987,21105,3882,2379,1171,https://www.intensivregister.de/api/public/reporting/laendertabelle
1644563100,24955,21082,3873,2371,1160,https://www.intensivregister.de/api/public/reporting/laendertabelle
1644566700,24951,21075,3876,2386,1161,https://www.intensivregister.de/api/public/reporting/laendertabelle
1644570300,24930,21052,3878,2396,1160,https://www.intensivregister.de/api/public/reporting/laendertabelle
1644573900,24920,21034,3886,2403,1164,https://www.intensivregister.de/api/public/reporting/laendertabelle
1644577500,24920,21038,3882,2401,1164,https://www.intensivregister.de/api/public/reporting/laendertabelle
1644581100,24919,21035,3884,2399,1165,https://www.intensivregister.de/api/public/reporting/laendertabelle
1644584700,24923,21041,3882,2401,1165,https://www.intensivregister.de/api/public/reporting/laendertabelle
1644588300,24923,21035,3888,2400,1165,https://www.intensivregister.de/api/public/reporting/laendertabelle
1644591900,24922,21027,3895,2400,1163,https://www.intensivregister.de/api/public/reporting/laendertabelle
1644595500,24922,21027,3895,2401,1164,https://www.intensivregister.de/api/public/reporting/laendertabelle
1644599100,24922,21028,3894,2401,1164,https://www.intensivregister.de/api/public/reporting/laendertabelle
1644602700,24920,21027,3893,2403,1164,https://www.intensivregister.de/api/public/reporting/laendertabelle
1644606300,24920,21029,3891,2406,1165,https://www.intensivregister.de/api/public/reporting/laendertabelle
1644617100,24920,21031,3889,2406,1165,https://www.intensivregister.de/api/public/reporting/laendertabelle
1644620700,24918,21023,3895,2406,1170,https://www.intensivregister.de/api/public/reporting/laendertabelle
1644624300,24918,21016,3902,2404,1170,https://www.intensivregister.de/api/public/reporting/laendertabelle
1644627900,24918,21015,3903,2405,1169,https://www.intensivregister.de/api/public/reporting/laendertabelle
1644631500,24920,21016,3904,2405,1170,https://www.intensivregister.de/api/public/reporting/laendertabelle
1644635100,24915,21004,3911,2407,1171,https://www.intensivregister.de/api/public/reporting/laendertabelle
1644638700,24913,21007,3906,2410,1172,https://www.intensivregister.de/api/public/reporting/laendertabelle
1644642300,24909,21000,3909,2411,1172,https://www.intensivregister.de/api/public/reporting/laendertabelle
1644645900,24861,20915,3946,2419,1175,https://www.intensivregister.de/api/public/reporting/laendertabelle
1644649500,24818,20817,4001,2399,1152,https://www.intensivregister.de/api/public/reporting/laendertabelle
1644653100,24803,20713,4090,2414,1160,https://www.intensivregister.de/api/public/reporting/laendertabelle
1644656700,24773,20621,4152,2391,1148,https://www.intensivregister.de/api/public/reporting/laendertabelle
1644660300,24751,20557,4194,2397,1144,https://www.intensivregister.de/api/public/reporting/laendertabelle
1644663900,24745,20556,4189,2399,1146,https://www.intensivregister.de/api/public/reporting/laendertabelle
1644667500,24745,20552,4193,2401,1147,https://www.intensivregister.de/api/public/reporting/laendertabelle
1644671100,24743,20545,4198,2401,1148,https://www.intensivregister.de/api/public/reporting/laendertabelle
1644674700,24743,20540,4203,2399,1146,https://www.intensivregister.de/api/public/reporting/laendertabelle
1644678300,24741,20540,4201,2399,1146,https://www.intensivregister.de/api/public/reporting/laendertabelle
1644681900,24745,20538,4207,2399,1148,https://www.intensivregister.de/api/public/reporting/laendertabelle
1644685500,24745,20538,4207,2400,1148,https://www.intensivregister.de/api/public/reporting/laendertabelle
1644689100,24745,20537,4208,2400,1148,https://www.intensivregister.de/api/public/reporting/laendertabelle
1644692700,24744,20536,4208,2405,1146,https://www.intensivregister.de/api/public/reporting/laendertabelle
1644696300,24745,20536,4209,2404,1146,https://www.intensivregister.de/api/public/reporting/laendertabelle
1644699900,24745,20536,4209,2405,1146,https://www.intensivregister.de/api/public/reporting/laendertabelle
1644703500,24745,20534,4211,2404,1146,https://www.intensivregister.de/api/public/reporting/laendertabelle
1644707100,24739,20519,4220,2402,1147,https://www.intensivregister.de/api/public/reporting/laendertabelle
1644710700,24740,20515,4225,2403,1147,https://www.intensivregister.de/api/public/reporting/laendertabelle
1644714300,24740,20519,4221,2403,1147,https://www.intensivregister.de/api/public/reporting/laendertabelle
1644721500,24740,20528,4212,2401,1147,https://www.intensivregister.de/api/public/reporting/laendertabelle
1644725100,24740,20532,4208,2399,1147,https://www.intensivregister.de/api/public/reporting/laendertabelle
1644728700,24706,20506,4200,2394,1146,https://www.intensivregister.de/api/public/reporting/laendertabelle
1644732300,24667,20469,4198,2395,1150,https://www.intensivregister.de/api/public/reporting/laendertabelle
1644735900,24647,20412,4235,2414,1148,https://www.intensivregister.de/api/public/reporting/laendertabelle
1644739500,24618,20325,4293,2422,1159,https://www.intensivregister.de/api/public/reporting/laendertabelle
1644743100,24611,20255,4356,2435,1163,https://www.intensivregister.de/api/public/reporting/laendertabelle
1644746700,24611,20226,4385,2427,1150,https://www.intensivregister.de/api/public/reporting/laendertabelle
1644750300,24606,20214,4392,2429,1152,https://www.intensivregister.de/api/public/reporting/laendertabelle
1644753900,24606,20205,4401,2433,1155,https://www.intensivregister.de/api/public/reporting/laendertabelle
1644757500,24606,20208,4398,2435,1155,https://www.intensivregister.de/api/public/reporting/laendertabelle
1644761100,24607,20209,4398,2435,1155,https://www.intensivregister.de/api/public/reporting/laendertabelle
1644764700,24605,20208,4397,2436,1155,https://www.intensivregister.de/api/public/reporting/laendertabelle
1644768300,24605,20208,4397,2437,1155,https://www.intensivregister.de/api/public/reporting/laendertabelle
1644775500,24605,20208,4397,2438,1156,https://www.intensivregister.de/api/public/reporting/laendertabelle
1644779100,24609,20213,4396,2438,1158,https://www.intensivregister.de/api/public/reporting/laendertabelle
1644782700,24613,20220,4393,2441,1157,https://www.intensivregister.de/api/public/reporting/laendertabelle
1644789900,24614,20220,4394,2441,1157,https://www.intensivregister.de/api/public/reporting/laendertabelle
1644793500,24614,20217,4397,2440,1157,https://www.intensivregister.de/api/public/reporting/laendertabelle
1644797100,24616,20220,4396,2440,1157,https://www.intensivregister.de/api/public/reporting/laendertabelle
1644800700,24616,20215,4401,2439,1157,https://www.intensivregister.de/api/public/reporting/laendertabelle
1644804300,24618,20220,4398,2438,1157,https://www.intensivregister.de/api/public/reporting/laendertabelle
1644807900,24620,20227,4393,2440,1157,https://www.intensivregister.de/api/public/reporting/laendertabelle
1644811500,24638,20240,4398,2438,1158,https://www.intensivregister.de/api/public/reporting/laendertabelle
1644815100,24652,20255,4397,2432,1156,https://www.intensivregister.de/api/public/reporting/laendertabelle
1644818700,24716,20287,4429,2421,1148,https://www.intensivregister.de/api/public/reporting/laendertabelle
1644822300,24767,20370,4397,2432,1144,https://www.intensivregister.de/api/public/reporting/laendertabelle
1644825900,24789,20404,4385,2462,1161,https://www.intensivregister.de/api/public/reporting/laendertabelle
1644829500,24789,20424,4365,2470,1165,https://www.intensivregister.de/api/public/reporting/laendertabelle
1644833100,24789,20437,4352,2475,1164,https://www.intensivregister.de/api/public/reporting/laendertabelle
1644836700,24794,20447,4347,2476,1162,https://www.intensivregister.de/api/public/reporting/laendertabelle
1644840300,24794,20440,4354,2476,1161,https://www.intensivregister.de/api/public/reporting/laendertabelle
1644843900,24794,20445,4349,2479,1161,https://www.intensivregister.de/api/public/reporting/laendertabelle
1644847500,24793,20448,4345,2475,1160,https://www.intensivregister.de/api/public/reporting/laendertabelle
1644851100,24793,20448,4345,2479,1161,https://www.intensivregister.de/api/public/reporting/laendertabelle
1644854700,24793,20447,4346,2479,1161,https://www.intensivregister.de/api/public/reporting/laendertabelle
1644858300,24799,20454,4345,2479,1161,https://www.intensivregister.de/api/public/reporting/laendertabelle
1644876300,24799,20453,4346,2479,1161,https://www.intensivregister.de/api/public/reporting/laendertabelle
1644879900,24800,20449,4351,2479,1163,https://www.intensivregister.de/api/public/reporting/laendertabelle
1644883500,24801,20449,4352,2478,1163,https://www.intensivregister.de/api/public/reporting/laendertabelle
1644887100,24801,20445,4356,2479,1165,https://www.intensivregister.de/api/public/reporting/laendertabelle
1644890700,24806,20439,4367,2480,1166,https://www.intensivregister.de/api/public/reporting/laendertabelle
1644894300,24805,20437,4368,2481,1166,https://www.intensivregister.de/api/public/reporting/laendertabelle
1644897900,24800,20429,4371,2479,1164,https://www.intensivregister.de/api/public/reporting/laendertabelle
1644901500,24806,20504,4302,2483,1175,https://www.intensivregister.de/api/public/reporting/laendertabelle
1644905100,24810,20594,4216,2517,1175,https://www.intensivregister.de/api/public/reporting/laendertabelle
1644908700,24848,20752,4096,2498,1179,https://www.intensivregister.de/api/public/reporting/laendertabelle
1644912300,24869,20796,4073,2490,1178,https://www.intensivregister.de/api/public/reporting/laendertabelle
1644915900,24880,20872,4008,2496,1173,https://www.intensivregister.de/api/public/reporting/laendertabelle
1644919500,24890,20889,4001,2494,1176,https://www.intensivregister.de/api/public/reporting/laendertabelle
1644923103,24890,20888,4002,2496,1176,https://www.intensivregister.de/api/public/reporting/laendertabelle
1644926700,24878,20876,4002,2495,1176,https://www.intensivregister.de/api/public/reporting/laendertabelle
1644930300,24878,20878,4000,2497,1176,https://www.intensivregister.de/api/public/reporting/laendertabelle
1644933900,24877,20876,4001,2497,1175,https://www.intensivregister.de/api/public/reporting/laendertabelle
1644937500,24877,20874,4003,2497,1175,https://www.intensivregister.de/api/public/reporting/laendertabelle
1644941100,24877,20876,4001,2497,1175,https://www.intensivregister.de/api/public/reporting/laendertabelle
1644944700,24877,20878,3999,2498,1176,https://www.intensivregister.de/api/public/reporting/laendertabelle
1644948300,24877,20878,3999,2499,1177,https://www.intensivregister.de/api/public/reporting/laendertabelle
1644951900,24877,20878,3999,2496,1175,https://www.intensivregister.de/api/public/reporting/laendertabelle
1644962700,24877,20881,3996,2497,1175,https://www.intensivregister.de/api/public/reporting/laendertabelle
1644966300,24903,20909,3994,2497,1175,https://www.intensivregister.de/api/public/reporting/laendertabelle
1644969900,24906,20915,3991,2500,1176,https://www.intensivregister.de/api/public/reporting/laendertabelle
1644973500,24908,20926,3982,2496,1176,https://www.intensivregister.de/api/public/reporting/laendertabelle
1644977100,24905,20934,3971,2497,1177,https://www.intensivregister.de/api/public/reporting/laendertabelle
1644980700,24902,20931,3971,2497,1177,https://www.intensivregister.de/api/public/reporting/laendertabelle
1644984300,24902,20934,3968,2498,1177,https://www.intensivregister.de/api/public/reporting/laendertabelle
1644987900,24900,20933,3967,2480,1176,https://www.intensivregister.de/api/public/reporting/laendertabelle
1644991500,24931,20976,3955,2450,1183,https://www.intensivregister.de/api/public/reporting/laendertabelle
1644995100,24939,21037,3902,2456,1175,https://www.intensivregister.de/api/public/reporting/laendertabelle
1644998700,24925,21069,3856,2470,1171,https://www.intensivregister.de/api/public/reporting/laendertabelle
1645002300,24946,21081,3865,2475,1171,https://www.intensivregister.de/api/public/reporting/laendertabelle
1645005900,24960,21086,3874,2466,1169,https://www.intensivregister.de/api/public/reporting/laendertabelle
1645009548,24960,21086,3874,2469,1171,https://www.intensivregister.de/api/public/reporting/laendertabelle
1645013100,24962,21087,3875,2468,1171,https://www.intensivregister.de/api/public/reporting/laendertabelle
1645016700,24962,21088,3874,2467,1170,https://www.intensivregister.de/api/public/reporting/laendertabelle
1645020300,24962,21095,3867,2469,1171,https://www.intensivregister.de/api/public/reporting/laendertabelle
1645023900,24973,21102,3871,2470,1171,https://www.intensivregister.de/api/public/reporting/laendertabelle
1645027500,24972,21100,3872,2470,1170,https://www.intensivregister.de/api/public/reporting/laendertabelle
1645038300,24972,21100,3872,2471,1170,https://www.intensivregister.de/api/public/reporting/laendertabelle
1645045500,24972,21102,3870,2471,1170,https://www.intensivregister.de/api/public/reporting/laendertabelle
1645052700,24968,21097,3871,2467,1169,https://www.intensivregister.de/api/public/reporting/laendertabelle
1645056300,24969,21096,3873,2464,1169,https://www.intensivregister.de/api/public/reporting/laendertabelle
1645063500,24968,21094,3874,2467,1170,https://www.intensivregister.de/api/public/reporting/laendertabelle
1645067100,24968,21095,3873,2468,1171,https://www.intensivregister.de/api/public/reporting/laendertabelle
1645070700,24971,21095,3876,2466,1172,https://www.intensivregister.de/api/public/reporting/laendertabelle
1645074300,24976,21093,3883,2457,1168,https://www.intensivregister.de/api/public/reporting/laendertabelle
1645077900,24968,21077,3891,2473,1167,https://www.intensivregister.de/api/public/reporting/laendertabelle
1645081500,24945,21081,3864,2480,1171,https://www.intensivregister.de/api/public/reporting/laendertabelle
1645085100,24945,21084,3861,2477,1170,https://www.intensivregister.de/api/public/reporting/laendertabelle
1645088700,24944,21097,3847,2472,1177,https://www.intensivregister.de/api/public/reporting/laendertabelle
1645092300,24953,21123,3830,2472,1179,https://www.intensivregister.de/api/public/reporting/laendertabelle
1645095986,24945,21124,3821,2472,1178,https://www.intensivregister.de/api/public/reporting/laendertabelle
1645099500,24945,21125,3820,2469,1178,https://www.intensivregister.de/api/public/reporting/laendertabelle
1645103100,24943,21119,3824,2469,1177,https://www.intensivregister.de/api/public/reporting/laendertabelle
1645106700,24945,21120,3825,2468,1176,https://www.intensivregister.de/api/public/reporting/laendertabelle
1645110300,24945,21124,3821,2471,1177,https://www.intensivregister.de/api/public/reporting/laendertabelle
1645113900,24945,21123,3822,2471,1178,https://www.intensivregister.de/api/public/reporting/laendertabelle
1645117500,24945,21121,3824,2471,1178,https://www.intensivregister.de/api/public/reporting/laendertabelle
1645139100,24947,21119,3828,2471,1177,https://www.intensivregister.de/api/public/reporting/laendertabelle
1645142700,24947,21124,3823,2472,1177,https://www.intensivregister.de/api/public/reporting/laendertabelle
1645146300,24946,21127,3819,2473,1177,https://www.intensivregister.de/api/public/reporting/laendertabelle
1645149900,24949,21131,3818,2474,1177,https://www.intensivregister.de/api/public/reporting/laendertabelle
1645153500,24945,21136,3809,2479,1177,https://www.intensivregister.de/api/public/reporting/laendertabelle
1645157100,24945,21138,3807,2472,1176,https://www.intensivregister.de/api/public/reporting/laendertabelle
1645160700,24944,21138,3806,2468,1176,https://www.intensivregister.de/api/public/reporting/laendertabelle
1645164300,24926,21123,3803,2461,1173,https://www.intensivregister.de/api/public/reporting/laendertabelle
1645167900,24906,21110,3796,2434,1177,https://www.intensivregister.de/api/public/reporting/laendertabelle
1645171500,24876,21139,3737,2435,1179,https://www.intensivregister.de/api/public/reporting/laendertabelle
1645175100,24860,21161,3699,2437,1173,https://www.intensivregister.de/api/public/reporting/laendertabelle
1645178700,24845,21115,3730,2436,1176,https://www.intensivregister.de/api/public/reporting/laendertabelle
1645182680,24841,21110,3731,2437,1175,https://www.intensivregister.de/api/public/reporting/laendertabelle
1645185900,24839,21102,3737,2437,1175,https://www.intensivregister.de/api/public/reporting/laendertabelle
1645189500,24838,21101,3737,2439,1175,https://www.intensivregister.de/api/public/reporting/laendertabelle
1645193100,24838,21100,3738,2438,1175,https://www.intensivregister.de/api/public/reporting/laendertabelle
1645196700,24838,21100,3738,2436,1178,https://www.intensivregister.de/api/public/reporting/laendertabelle
1645200300,24838,21103,3735,2435,1178,https://www.intensivregister.de/api/public/reporting/laendertabelle
1645203900,24838,21105,3733,2435,1178,https://www.intensivregister.de/api/public/reporting/laendertabelle
1645211100,24838,21111,3727,2436,1178,https://www.intensivregister.de/api/public/reporting/laendertabelle
1645221900,24833,21104,3729,2433,1177,https://www.intensivregister.de/api/public/reporting/laendertabelle
1645225500,24833,21096,3737,2435,1178,https://www.intensivregister.de/api/public/reporting/laendertabelle
1645229100,24833,21102,3731,2436,1178,https://www.intensivregister.de/api/public/reporting/laendertabelle
1645232700,24832,21098,3734,2436,1178,https://www.intensivregister.de/api/public/reporting/laendertabelle
1645236300,24832,21098,3734,2435,1176,https://www.intensivregister.de/api/public/reporting/laendertabelle
1645239900,24832,21099,3733,2434,1176,https://www.intensivregister.de/api/public/reporting/laendertabelle
1645243500,24831,21093,3738,2430,1173,https://www.intensivregister.de/api/public/reporting/laendertabelle
1645247100,24826,21081,3745,2429,1175,https://www.intensivregister.de/api/public/reporting/laendertabelle
1645250700,24798,21034,3764,2421,1164,https://www.intensivregister.de/api/public/reporting/laendertabelle
1645254300,24783,20954,3829,2414,1162,https://www.intensivregister.de/api/public/reporting/laendertabelle
1645257900,24732,20869,3863,2414,1169,https://www.intensivregister.de/api/public/reporting/laendertabelle
1645261500,24702,20777,3925,2414,1154,https://www.intensivregister.de/api/public/reporting/laendertabelle
1645265100,24704,20740,3964,2419,1155,https://www.intensivregister.de/api/public/reporting/laendertabelle
1645268917,24699,20724,3975,2420,1154,https://www.intensivregister.de/api/public/reporting/laendertabelle
1645272300,24697,20718,3979,2420,1153,https://www.intensivregister.de/api/public/reporting/laendertabelle
1645279500,24694,20709,3985,2417,1152,https://www.intensivregister.de/api/public/reporting/laendertabelle
1645283100,24694,20708,3986,2416,1150,https://www.intensivregister.de/api/public/reporting/laendertabelle
1645286700,24694,20707,3987,2416,1150,https://www.intensivregister.de/api/public/reporting/laendertabelle
1645290300,24694,20707,3987,2415,1150,https://www.intensivregister.de/api/public/reporting/laendertabelle
1645297500,24694,20709,3985,2415,1150,https://www.intensivregister.de/api/public/reporting/laendertabelle
1645301100,24694,20707,3987,2413,1150,https://www.intensivregister.de/api/public/reporting/laendertabelle
1645304700,24693,20707,3986,2413,1150,https://www.intensivregister.de/api/public/reporting/laendertabelle
1645308300,24693,20704,3989,2413,1150,https://www.intensivregister.de/api/public/reporting/laendertabelle
1645311900,24691,20710,3981,2413,1150,https://www.intensivregister.de/api/public/reporting/laendertabelle
1645315500,24692,20706,3986,2413,1152,https://www.intensivregister.de/api/public/reporting/laendertabelle
1645319100,24692,20707,3985,2412,1152,https://www.intensivregister.de/api/public/reporting/laendertabelle
1645322700,24691,20701,3990,2411,1152,https://www.intensivregister.de/api/public/reporting/laendertabelle
1645326300,24691,20702,3989,2412,1151,https://www.intensivregister.de/api/public/reporting/laendertabelle
1645329900,24691,20690,4001,2411,1153,https://www.intensivregister.de/api/public/reporting/laendertabelle
1645333500,24686,20653,4033,2419,1154,https://www.intensivregister.de/api/public/reporting/laendertabelle
1645337100,24679,20593,4086,2422,1154,https://www.intensivregister.de/api/public/reporting/laendertabelle
1645340700,24654,20464,4190,2425,1151,https://www.intensivregister.de/api/public/reporting/laendertabelle
1645344300,24611,20361,4250,2415,1131,https://www.intensivregister.de/api/public/reporting/laendertabelle
1645347900,24587,20315,4272,2414,1135,https://www.intensivregister.de/api/public/reporting/laendertabelle
1645351500,24582,20286,4296,2402,1138,https://www.intensivregister.de/api/public/reporting/laendertabelle
1645356192,24581,20290,4291,2401,1136,https://www.intensivregister.de/api/public/reporting/laendertabelle
1645358700,24581,20296,4285,2402,1138,https://www.intensivregister.de/api/public/reporting/laendertabelle
1645362300,24576,20290,4286,2401,1138,https://www.intensivregister.de/api/public/reporting/laendertabelle
1645365900,24577,20289,4288,2401,1138,https://www.intensivregister.de/api/public/reporting/laendertabelle
1645373100,24577,20286,4291,2401,1138,https://www.intensivregister.de/api/public/reporting/laendertabelle
1645376700,24579,20289,4290,2400,1136,https://www.intensivregister.de/api/public/reporting/laendertabelle
1645380300,24579,20291,4288,2401,1136,https://www.intensivregister.de/api/public/reporting/laendertabelle
1645387500,24576,20289,4287,2400,1136,https://www.intensivregister.de/api/public/reporting/laendertabelle
1645394700,24576,20288,4288,2400,1136,https://www.intensivregister.de/api/public/reporting/laendertabelle
1645398300,24578,20292,4286,2400,1137,https://www.intensivregister.de/api/public/reporting/laendertabelle
1645401900,24574,20287,4287,2399,1135,https://www.intensivregister.de/api/public/reporting/laendertabelle
1645405500,24574,20288,4286,2400,1135,https://www.intensivregister.de/api/public/reporting/laendertabelle
1645409100,24575,20285,4290,2399,1135,https://www.intensivregister.de/api/public/reporting/laendertabelle
1645412700,24576,20288,4288,2400,1136,https://www.intensivregister.de/api/public/reporting/laendertabelle
1645416300,24576,20285,4291,2402,1136,https://www.intensivregister.de/api/public/reporting/laendertabelle
1645419900,24588,20301,4287,2389,1130,https://www.intensivregister.de/api/public/reporting/laendertabelle
1645423500,24656,20338,4318,2389,1135,https://www.intensivregister.de/api/public/reporting/laendertabelle
1645427100,24691,20385,4306,2409,1139,https://www.intensivregister.de/api/public/reporting/laendertabelle
1645430700,24741,20455,4286,2405,1141,https://www.intensivregister.de/api/public/reporting/laendertabelle
1645434300,24749,20515,4234,2420,1146,https://www.intensivregister.de/api/public/reporting/laendertabelle
1645437900,24741,20476,4265,2424,1143,https://www.intensivregister.de/api/public/reporting/laendertabelle
1645441500,24730,20466,4264,2412,1136,https://www.intensivregister.de/api/public/reporting/laendertabelle
1645445100,24730,20462,4268,2412,1136,https://www.intensivregister.de/api/public/reporting/laendertabelle
1645448700,24729,20462,4267,2411,1137,https://www.intensivregister.de/api/public/reporting/laendertabelle
1645452300,24735,20460,4275,2415,1140,https://www.intensivregister.de/api/public/reporting/laendertabelle
1645455900,24739,20462,4277,2415,1140,https://www.intensivregister.de/api/public/reporting/laendertabelle
1645459500,24739,20466,4273,2415,1140,https://www.intensivregister.de/api/public/reporting/laendertabelle
1645463100,24740,20464,4276,2414,1140,https://www.intensivregister.de/api/public/reporting/laendertabelle
1645466700,24740,20464,4276,2412,1140,https://www.intensivregister.de/api/public/reporting/laendertabelle
1645473900,24740,20461,4279,2413,1141,https://www.intensivregister.de/api/public/reporting/laendertabelle
1645481100,24739,20457,4282,2413,1141,https://www.intensivregister.de/api/public/reporting/laendertabelle
1645484700,24740,20460,4280,2411,1141,https://www.intensivregister.de/api/public/reporting/laendertabelle
1645488300,24738,20455,4283,2412,1141,https://www.intensivregister.de/api/public/reporting/laendertabelle
1645491900,24738,20448,4290,2412,1141,https://www.intensivregister.de/api/public/reporting/laendertabelle
1645495500,24738,20448,4290,2409,1140,https://www.intensivregister.de/api/public/reporting/laendertabelle
1645499100,24738,20446,4292,2409,1140,https://www.intensivregister.de/api/public/reporting/laendertabelle
1645502700,24744,20452,4292,2404,1136,https://www.intensivregister.de/api/public/reporting/laendertabelle
1645506300,24744,20484,4260,2403,1134,https://www.intensivregister.de/api/public/reporting/laendertabelle
1645509900,24755,20537,4218,2389,1123,https://www.intensivregister.de/api/public/reporting/laendertabelle
1645513500,24807,20746,4061,2397,1122,https://www.intensivregister.de/api/public/reporting/laendertabelle
1645517100,24809,20809,4000,2402,1113,https://www.intensivregister.de/api/public/reporting/laendertabelle
1645520700,24829,20870,3959,2389,1114,https://www.intensivregister.de/api/public/reporting/laendertabelle
1645524300,24853,20885,3968,2402,1117,https://www.intensivregister.de/api/public/reporting/laendertabelle
1645528363,24854,20882,3972,2404,1117,https://www.intensivregister.de/api/public/reporting/laendertabelle
1645531500,24854,20879,3975,2403,1117,https://www.intensivregister.de/api/public/reporting/laendertabelle
1645535100,24854,20887,3967,2401,1116,https://www.intensivregister.de/api/public/reporting/laendertabelle
1645538700,24853,20889,3964,2402,1116,https://www.intensivregister.de/api/public/reporting/laendertabelle
1645542300,24853,20890,3963,2401,1116,https://www.intensivregister.de/api/public/reporting/laendertabelle
1645545900,24853,20892,3961,2401,1115,https://www.intensivregister.de/api/public/reporting/laendertabelle
1645549500,24854,20891,3963,2401,1115,https://www.intensivregister.de/api/public/reporting/laendertabelle
1645567500,24852,20889,3963,2401,1115,https://www.intensivregister.de/api/public/reporting/laendertabelle
1645571100,24850,20885,3965,2401,1114,https://www.intensivregister.de/api/public/reporting/laendertabelle
1645574700,24852,20882,3970,2401,1115,https://www.intensivregister.de/api/public/reporting/laendertabelle
1645578300,24850,20885,3965,2401,1115,https://www.intensivregister.de/api/public/reporting/laendertabelle
1645581900,24850,20888,3962,2401,1115,https://www.intensivregister.de/api/public/reporting/laendertabelle
1645585500,24845,20891,3954,2402,1114,https://www.intensivregister.de/api/public/reporting/laendertabelle
1645589100,24845,20891,3954,2400,1114,https://www.intensivregister.de/api/public/reporting/laendertabelle
1645592700,24848,20905,3943,2413,1111,https://www.intensivregister.de/api/public/reporting/laendertabelle
1645596300,24854,20950,3904,2402,1109,https://www.intensivregister.de/api/public/reporting/laendertabelle
1645599900,24859,20923,3936,2407,1097,https://www.intensivregister.de/api/public/reporting/laendertabelle
1645603500,24858,20914,3944,2390,1089,https://www.intensivregister.de/api/public/reporting/laendertabelle
1645607100,24869,20967,3902,2394,1087,https://www.intensivregister.de/api/public/reporting/laendertabelle
1645610700,24871,20974,3897,2398,1087,https://www.intensivregister.de/api/public/reporting/laendertabelle
1645614920,24867,20969,3898,2400,1088,https://www.intensivregister.de/api/public/reporting/laendertabelle
1645617900,24867,20972,3895,2401,1088,https://www.intensivregister.de/api/public/reporting/laendertabelle
1645621500,24867,20974,3893,2401,1088,https://www.intensivregister.de/api/public/reporting/laendertabelle
1645625100,24867,20974,3893,2400,1087,https://www.intensivregister.de/api/public/reporting/laendertabelle
1645628700,24867,20974,3893,2398,1087,https://www.intensivregister.de/api/public/reporting/laendertabelle
1645632300,24867,20974,3893,2399,1087,https://www.intensivregister.de/api/public/reporting/laendertabelle
1645657500,24868,20985,3883,2401,1088,https://www.intensivregister.de/api/public/reporting/laendertabelle
1645661100,24868,20993,3875,2401,1087,https://www.intensivregister.de/api/public/reporting/laendertabelle
1645664700,24868,20996,3872,2399,1087,https://www.intensivregister.de/api/public/reporting/laendertabelle
1645668300,24867,20990,3877,2397,1086,https://www.intensivregister.de/api/public/reporting/laendertabelle
1645671900,24867,20991,3876,2396,1086,https://www.intensivregister.de/api/public/reporting/laendertabelle
1645675500,24868,21000,3868,2392,1085,https://www.intensivregister.de/api/public/reporting/laendertabelle
1645679100,24865,20988,3877,2380,1079,https://www.intensivregister.de/api/public/reporting/laendertabelle
1645682700,24873,20971,3902,2347,1070,https://www.intensivregister.de/api/public/reporting/laendertabelle
1645686300,24895,21018,3877,2340,1067,https://www.intensivregister.de/api/public/reporting/laendertabelle
1645689900,24905,21015,3890,2310,1067,https://www.intensivregister.de/api/public/reporting/laendertabelle
1645693500,24917,21070,3847,2295,1060,https://www.intensivregister.de/api/public/reporting/laendertabelle
1645697100,24916,21064,3852,2286,1056,https://www.intensivregister.de/api/public/reporting/laendertabelle
1645701409,24912,21058,3854,2284,1051,https://www.intensivregister.de/api/public/reporting/laendertabelle
1645704300,24909,21055,3854,2281,1052,https://www.intensivregister.de/api/public/reporting/laendertabelle
1645707900,24910,21055,3855,2281,1051,https://www.intensivregister.de/api/public/reporting/laendertabelle
1645711500,24910,21056,3854,2283,1051,https://www.intensivregister.de/api/public/reporting/laendertabelle
1645715100,24910,21055,3855,2283,1051,https://www.intensivregister.de/api/public/reporting/laendertabelle
1645718700,24910,21058,3852,2282,1051,https://www.intensivregister.de/api/public/reporting/laendertabelle
1645736700,24910,21057,3853,2283,1051,https://www.intensivregister.de/api/public/reporting/laendertabelle
1645740300,24910,21059,3851,2283,1051,https://www.intensivregister.de/api/public/reporting/laendertabelle
1645743900,24912,21056,3856,2281,1051,https://www.intensivregister.de/api/public/reporting/laendertabelle
1645747500,24916,21061,3855,2281,1051,https://www.intensivregister.de/api/public/reporting/laendertabelle
1645751100,24917,21066,3851,2282,1051,https://www.intensivregister.de/api/public/reporting/laendertabelle
1645754700,24917,21063,3854,2282,1051,https://www.intensivregister.de/api/public/reporting/laendertabelle
1645758300,24919,21064,3855,2284,1052,https://www.intensivregister.de/api/public/reporting/laendertabelle
1645761900,24916,21040,3876,2287,1052,https://www.intensivregister.de/api/public/reporting/laendertabelle
1645765500,24924,21048,3876,2284,1043,https://www.intensivregister.de/api/public/reporting/laendertabelle
1645769100,24940,21067,3873,2287,1039,https://www.intensivregister.de/api/public/reporting/laendertabelle
1645772700,24934,21097,3837,2305,1038,https://www.intensivregister.de/api/public/reporting/laendertabelle
1645776300,24913,21105,3808,2302,1032,https://www.intensivregister.de/api/public/reporting/laendertabelle
1645779900,24909,21064,3845,2292,1027,https://www.intensivregister.de/api/public/reporting/laendertabelle
1645783500,24894,21063,3831,2290,1026,https://www.intensivregister.de/api/public/reporting/laendertabelle
1645787100,24894,21049,3845,2289,1025,https://www.intensivregister.de/api/public/reporting/laendertabelle
1645790700,24895,21056,3839,2286,1025,https://www.intensivregister.de/api/public/reporting/laendertabelle
1645794300,24892,21051,3841,2286,1025,https://www.intensivregister.de/api/public/reporting/laendertabelle
1645797900,24892,21047,3845,2286,1025,https://www.intensivregister.de/api/public/reporting/laendertabelle
1645801500,24890,21042,3848,2284,1025,https://www.intensivregister.de/api/public/reporting/laendertabelle
1645805100,24889,21040,3849,2283,1025,https://www.intensivregister.de/api/public/reporting/laendertabelle
1645808700,24891,21038,3853,2284,1025,https://www.intensivregister.de/api/public/reporting/laendertabelle
1645815900,24887,21035,3852,2283,1025,https://www.intensivregister.de/api/public/reporting/laendertabelle
1645823100,24883,21026,3857,2282,1024,https://www.intensivregister.de/api/public/reporting/laendertabelle
1645826700,24883,21022,3861,2282,1024,https://www.intensivregister.de/api/public/reporting/laendertabelle
1645830300,24871,20997,3874,2283,1025,https://www.intensivregister.de/api/public/reporting/laendertabelle
1645833900,24867,20993,3874,2282,1024,https://www.intensivregister.de/api/public/reporting/laendertabelle
1645841100,24867,20992,3875,2282,1024,https://www.intensivregister.de/api/public/reporting/laendertabelle
1645844700,24863,20985,3878,2281,1023,https://www.intensivregister.de/api/public/reporting/laendertabelle
1645848300,24859,20981,3878,2283,1023,https://www.intensivregister.de/api/public/reporting/laendertabelle
1645851900,24846,20964,3882,2275,1020,https://www.intensivregister.de/api/public/reporting/laendertabelle
1645855500,24821,20872,3949,2274,1026,https://www.intensivregister.de/api/public/reporting/laendertabelle
1645859100,24785,20784,4001,2255,1023,https://www.intensivregister.de/api/public/reporting/laendertabelle
1645862700,24721,20682,4039,2254,1022,https://www.intensivregister.de/api/public/reporting/laendertabelle
1645866300,24663,20589,4074,2256,1027,https://www.intensivregister.de/api/public/reporting/laendertabelle
1645869900,24648,20574,4074,2255,1029,https://www.intensivregister.de/api/public/reporting/laendertabelle
1645873500,24648,20566,4082,2257,1029,https://www.intensivregister.de/api/public/reporting/laendertabelle
1645877100,24648,20562,4086,2257,1029,https://www.intensivregister.de/api/public/reporting/laendertabelle
1645880700,24652,20568,4084,2254,1030,https://www.intensivregister.de/api/public/reporting/laendertabelle
1645884300,24652,20568,4084,2253,1030,https://www.intensivregister.de/api/public/reporting/laendertabelle
1645887900,24652,20566,4086,2253,1030,https://www.intensivregister.de/api/public/reporting/laendertabelle
1645891500,24652,20565,4087,2255,1030,https://www.intensivregister.de/api/public/reporting/laendertabelle
1645898700,24650,20563,4087,2255,1030,https://www.intensivregister.de/api/public/reporting/laendertabelle
1645905900,24650,20562,4088,2255,1030,https://www.intensivregister.de/api/public/reporting/laendertabelle
1645916700,24651,20556,4095,2256,1030,https://www.intensivregister.de/api/public/reporting/laendertabelle
1645920300,24651,20560,4091,2256,1030,https://www.intensivregister.de/api/public/reporting/laendertabelle
1645923900,24650,20560,4090,2255,1029,https://www.intensivregister.de/api/public/reporting/laendertabelle
1645927500,24649,20558,4091,2255,1028,https://www.intensivregister.de/api/public/reporting/laendertabelle
1645931100,24647,20548,4099,2255,1027,https://www.intensivregister.de/api/public/reporting/laendertabelle
1645934700,24646,20536,4110,2255,1027,https://www.intensivregister.de/api/public/reporting/laendertabelle
1645938300,24648,20537,4111,2256,1029,https://www.intensivregister.de/api/public/reporting/laendertabelle
1645941900,24634,20428,4206,2256,1027,https://www.intensivregister.de/api/public/reporting/laendertabelle
1645945500,24617,20291,4326,2251,1019,https://www.intensivregister.de/api/public/reporting/laendertabelle
1645949100,24587,20179,4408,2254,1026,https://www.intensivregister.de/api/public/reporting/laendertabelle
1645952700,24564,20119,4445,2251,1027,https://www.intensivregister.de/api/public/reporting/laendertabelle
1645956300,24539,20104,4435,2242,1022,https://www.intensivregister.de/api/public/reporting/laendertabelle
1645959900,24539,20113,4426,2237,1021,https://www.intensivregister.de/api/public/reporting/laendertabelle
1645963500,24539,20107,4432,2237,1021,https://www.intensivregister.de/api/public/reporting/laendertabelle
1645967100,24541,20106,4435,2235,1021,https://www.intensivregister.de/api/public/reporting/laendertabelle
1645970700,24541,20100,4441,2235,1021,https://www.intensivregister.de/api/public/reporting/laendertabelle
1645974300,24541,20095,4446,2235,1021,https://www.intensivregister.de/api/public/reporting/laendertabelle
1645977900,24541,20088,4453,2235,1021,https://www.intensivregister.de/api/public/reporting/laendertabelle
1645981500,24542,20089,4453,2235,1021,https://www.intensivregister.de/api/public/reporting/laendertabelle
1645999500,24542,20087,4455,2235,1022,https://www.intensivregister.de/api/public/reporting/laendertabelle
1646003100,24541,20092,4449,2235,1022,https://www.intensivregister.de/api/public/reporting/laendertabelle
1646006700,24539,20099,4440,2235,1024,https://www.intensivregister.de/api/public/reporting/laendertabelle
1646010300,24539,20101,4438,2236,1024,https://www.intensivregister.de/api/public/reporting/laendertabelle
1646013900,24538,20099,4439,2238,1024,https://www.intensivregister.de/api/public/reporting/laendertabelle
1646017500,24540,20097,4443,2237,1024,https://www.intensivregister.de/api/public/reporting/laendertabelle
1646021100,24555,20113,4442,2240,1024,https://www.intensivregister.de/api/public/reporting/laendertabelle
1646024700,24580,20150,4430,2241,1024,https://www.intensivregister.de/api/public/reporting/laendertabelle
1646028300,24645,20200,4445,2254,1020,https://www.intensivregister.de/api/public/reporting/laendertabelle
1646031900,24756,20270,4486,2256,1035,https://www.intensivregister.de/api/public/reporting/laendertabelle
1646035500,24796,20306,4490,2277,1019,https://www.intensivregister.de/api/public/reporting/laendertabelle
1646039100,24812,20347,4465,2287,1020,https://www.intensivregister.de/api/public/reporting/laendertabelle
1646042700,24833,20365,4468,2285,1013,https://www.intensivregister.de/api/public/reporting/laendertabelle
1646046300,24844,20375,4469,2285,1012,https://www.intensivregister.de/api/public/reporting/laendertabelle
1646049900,24843,20373,4470,2284,1012,https://www.intensivregister.de/api/public/reporting/laendertabelle
1646053500,24843,20372,4471,2284,1011,https://www.intensivregister.de/api/public/reporting/laendertabelle
1646057100,24845,20375,4470,2285,1011,https://www.intensivregister.de/api/public/reporting/laendertabelle
1646060700,24845,20374,4471,2283,1011,https://www.intensivregister.de/api/public/reporting/laendertabelle
1646075100,24848,20374,4474,2283,1011,https://www.intensivregister.de/api/public/reporting/laendertabelle
1646085900,24848,20374,4474,2282,1011,https://www.intensivregister.de/api/public/reporting/laendertabelle
1646089500,24846,20379,4467,2283,1011,https://www.intensivregister.de/api/public/reporting/laendertabelle
1646093100,24846,20380,4466,2280,1010,https://www.intensivregister.de/api/public/reporting/laendertabelle
1646096700,24846,20382,4464,2279,1010,https://www.intensivregister.de/api/public/reporting/laendertabelle
1646100300,24851,20384,4467,2278,1010,https://www.intensivregister.de/api/public/reporting/laendertabelle
1646103900,24851,20382,4469,2277,1010,https://www.intensivregister.de/api/public/reporting/laendertabelle
1646107500,24843,20377,4466,2276,1008,https://www.intensivregister.de/api/public/reporting/laendertabelle
1646111100,24846,20430,4416,2295,1005,https://www.intensivregister.de/api/public/reporting/laendertabelle
1646114700,24803,20529,4274,2321,1006,https://www.intensivregister.de/api/public/reporting/laendertabelle
1646118300,24812,20613,4199,2302,975,https://www.intensivregister.de/api/public/reporting/laendertabelle
1646121900,24837,20697,4140,2296,975,https://www.intensivregister.de/api/public/reporting/laendertabelle
1646125500,24847,20712,4135,2292,969,https://www.intensivregister.de/api/public/reporting/laendertabelle
1646129100,24874,20730,4144,2288,964,https://www.intensivregister.de/api/public/reporting/laendertabelle
1646132700,24884,20733,4151,2288,967,https://www.intensivregister.de/api/public/reporting/laendertabelle
1646136300,24894,20737,4157,2286,964,https://www.intensivregister.de/api/public/reporting/laendertabelle
1646139900,24893,20730,4163,2287,964,https://www.intensivregister.de/api/public/reporting/laendertabelle
1646143500,24893,20734,4159,2287,963,https://www.intensivregister.de/api/public/reporting/laendertabelle
1646147100,24893,20735,4158,2287,963,https://www.intensivregister.de/api/public/reporting/laendertabelle
1646150700,24893,20732,4161,2286,963,https://www.intensivregister.de/api/public/reporting/laendertabelle
1646157900,24893,20734,4159,2287,964,https://www.intensivregister.de/api/public/reporting/laendertabelle
1646165100,24893,20736,4157,2287,964,https://www.intensivregister.de/api/public/reporting/laendertabelle
1646172300,24893,20735,4158,2287,964,https://www.intensivregister.de/api/public/reporting/laendertabelle
1646175900,24895,20737,4158,2283,963,https://www.intensivregister.de/api/public/reporting/laendertabelle
1646179500,24895,20739,4156,2283,963,https://www.intensivregister.de/api/public/reporting/laendertabelle
1646183100,24900,20739,4161,2285,965,https://www.intensivregister.de/api/public/reporting/laendertabelle
1646186700,24904,20746,4158,2289,966,https://www.intensivregister.de/api/public/reporting/laendertabelle
1646190300,24903,20743,4160,2290,967,https://www.intensivregister.de/api/public/reporting/laendertabelle
1646193900,24902,20757,4145,2297,971,https://www.intensivregister.de/api/public/reporting/laendertabelle
1646197500,24893,20747,4146,2283,971,https://www.intensivregister.de/api/public/reporting/laendertabelle
1646201100,24916,20766,4150,2258,974,https://www.intensivregister.de/api/public/reporting/laendertabelle
1646204700,24875,20742,4133,2221,965,https://www.intensivregister.de/api/public/reporting/laendertabelle
1646208300,24844,20748,4096,2205,961,https://www.intensivregister.de/api/public/reporting/laendertabelle
1646211900,24865,20767,4098,2204,958,https://www.intensivregister.de/api/public/reporting/laendertabelle
1646215500,24871,20800,4071,2202,955,https://www.intensivregister.de/api/public/reporting/laendertabelle
1646219100,24872,20804,4068,2199,955,https://www.intensivregister.de/api/public/reporting/laendertabelle
1646222700,24870,20800,4070,2194,952,https://www.intensivregister.de/api/public/reporting/laendertabelle
1646226300,24868,20800,4068,2193,952,https://www.intensivregister.de/api/public/reporting/laendertabelle
1646233500,24868,20798,4070,2195,953,https://www.intensivregister.de/api/public/reporting/laendertabelle
1646237100,24869,20801,4068,2195,953,https://www.intensivregister.de/api/public/reporting/laendertabelle
1646247900,24868,20801,4067,2195,953,https://www.intensivregister.de/api/public/reporting/laendertabelle
1646258700,24868,20796,4072,2195,953,https://www.intensivregister.de/api/public/reporting/laendertabelle
1646262300,24868,20792,4076,2195,953,https://www.intensivregister.de/api/public/reporting/laendertabelle
1646265900,24867,20793,4074,2196,953,https://www.intensivregister.de/api/public/reporting/laendertabelle
1646269500,24869,20794,4075,2195,952,https://www.intensivregister.de/api/public/reporting/laendertabelle
1646273100,24869,20794,4075,2196,952,https://www.intensivregister.de/api/public/reporting/laendertabelle
1646276700,24868,20805,4063,2196,954,https://www.intensivregister.de/api/public/reporting/laendertabelle
1646280300,24867,20799,4068,2198,956,https://www.intensivregister.de/api/public/reporting/laendertabelle
1646283900,24884,20794,4090,2189,959,https://www.intensivregister.de/api/public/reporting/laendertabelle
1646287500,24892,20815,4077,2178,959,https://www.intensivregister.de/api/public/reporting/laendertabelle
1646291100,24912,20847,4065,2142,954,https://www.intensivregister.de/api/public/reporting/laendertabelle
1646294700,24905,20864,4041,2146,949,https://www.intensivregister.de/api/public/reporting/laendertabelle
1646298300,24898,20818,4080,2148,942,https://www.intensivregister.de/api/public/reporting/laendertabelle
1646301900,24903,20824,4079,2152,946,https://www.intensivregister.de/api/public/reporting/laendertabelle
1646305500,24896,20822,4074,2152,946,https://www.intensivregister.de/api/public/reporting/laendertabelle
1646309100,24899,20831,4068,2155,946,https://www.intensivregister.de/api/public/reporting/laendertabelle
1646312700,24898,20827,4071,2157,946,https://www.intensivregister.de/api/public/reporting/laendertabelle
1646316300,24898,20826,4072,2158,946,https://www.intensivregister.de/api/public/reporting/laendertabelle
1646319900,24898,20826,4072,2156,947,https://www.intensivregister.de/api/public/reporting/laendertabelle
1646323500,24898,20829,4069,2155,947,https://www.intensivregister.de/api/public/reporting/laendertabelle
1646327100,24898,20828,4070,2154,946,https://www.intensivregister.de/api/public/reporting/laendertabelle
1646348700,24902,20842,4060,2153,946,https://www.intensivregister.de/api/public/reporting/laendertabelle
1646352300,24900,20845,4055,2153,946,https://www.intensivregister.de/api/public/reporting/laendertabelle
1646355900,24900,20842,4058,2156,946,https://www.intensivregister.de/api/public/reporting/laendertabelle
1646359500,24900,20841,4059,2155,945,https://www.intensivregister.de/api/public/reporting/laendertabelle
1646363100,24894,20836,4058,2153,943,https://www.intensivregister.de/api/public/reporting/laendertabelle
1646366700,24893,20831,4062,2153,944,https://www.intensivregister.de/api/public/reporting/laendertabelle
1646370300,24891,20885,4006,2138,937,https://www.intensivregister.de/api/public/reporting/laendertabelle
1646373900,24868,20842,4026,2124,933,https://www.intensivregister.de/api/public/reporting/laendertabelle
1646377500,24840,20842,3998,2096,921,https://www.intensivregister.de/api/public/reporting/laendertabelle
1646381100,24821,20853,3968,2113,926,https://www.intensivregister.de/api/public/reporting/laendertabelle
1646384700,24801,20843,3958,2112,932,https://www.intensivregister.de/api/public/reporting/laendertabelle
1646388300,24793,20828,3965,2106,929,https://www.intensivregister.de/api/public/reporting/laendertabelle
1646391900,24785,20828,3957,2111,928,https://www.intensivregister.de/api/public/reporting/laendertabelle
1646395500,24784,20823,3961,2114,927,https://www.intensivregister.de/api/public/reporting/laendertabelle
1646399100,24782,20816,3966,2114,927,https://www.intensivregister.de/api/public/reporting/laendertabelle
1646402700,24781,20817,3964,2113,925,https://www.intensivregister.de/api/public/reporting/laendertabelle
1646406300,24776,20813,3963,2114,928,https://www.intensivregister.de/api/public/reporting/laendertabelle
1646409900,24776,20811,3965,2114,929,https://www.intensivregister.de/api/public/reporting/laendertabelle
1646413500,24776,20810,3966,2115,929,https://www.intensivregister.de/api/public/reporting/laendertabelle
1646417100,24776,20810,3966,2116,929,https://www.intensivregister.de/api/public/reporting/laendertabelle
1646420700,24776,20810,3966,2117,929,https://www.intensivregister.de/api/public/reporting/laendertabelle
1646427900,24776,20809,3967,2117,929,https://www.intensivregister.de/api/public/reporting/laendertabelle
1646431500,24774,20813,3961,2116,929,https://www.intensivregister.de/api/public/reporting/laendertabelle
1646435100,24776,20807,3969,2112,929,https://www.intensivregister.de/api/public/reporting/laendertabelle
1646438700,24773,20802,3971,2110,930,https://www.intensivregister.de/api/public/reporting/laendertabelle
1646442300,24778,20794,3984,2105,928,https://www.intensivregister.de/api/public/reporting/laendertabelle
1646445900,24778,20791,3987,2105,928,https://www.intensivregister.de/api/public/reporting/laendertabelle
1646449500,24778,20793,3985,2102,928,https://www.intensivregister.de/api/public/reporting/laendertabelle
1646453100,24778,20794,3984,2107,928,https://www.intensivregister.de/api/public/reporting/laendertabelle
1646456700,24784,20809,3975,2113,931,https://www.intensivregister.de/api/public/reporting/laendertabelle
1646460300,24736,20772,3964,2123,932,https://www.intensivregister.de/api/public/reporting/laendertabelle
1646463900,24710,20651,4059,2104,925,https://www.intensivregister.de/api/public/reporting/laendertabelle
1646467500,24681,20587,4094,2094,923,https://www.intensivregister.de/api/public/reporting/laendertabelle
1646471100,24645,20484,4161,2090,921,https://www.intensivregister.de/api/public/reporting/laendertabelle
1646474700,24636,20457,4179,2099,915,https://www.intensivregister.de/api/public/reporting/laendertabelle
1646478300,24620,20438,4182,2099,916,https://www.intensivregister.de/api/public/reporting/laendertabelle
1646481900,24601,20422,4179,2103,917,https://www.intensivregister.de/api/public/reporting/laendertabelle
1646485500,24596,20423,4173,2103,917,https://www.intensivregister.de/api/public/reporting/laendertabelle
1646489100,24596,20422,4174,2102,917,https://www.intensivregister.de/api/public/reporting/laendertabelle
1646492700,24596,20421,4175,2104,918,https://www.intensivregister.de/api/public/reporting/laendertabelle
1646503500,24598,20418,4180,2104,918,https://www.intensivregister.de/api/public/reporting/laendertabelle
1646507100,24598,20417,4181,2103,918,https://www.intensivregister.de/api/public/reporting/laendertabelle
1646510700,24600,20417,4183,2103,918,https://www.intensivregister.de/api/public/reporting/laendertabelle
1646517900,24600,20413,4187,2099,918,https://www.intensivregister.de/api/public/reporting/laendertabelle
1646521500,24598,20406,4192,2098,917,https://www.intensivregister.de/api/public/reporting/laendertabelle
1646525100,24600,20404,4196,2096,918,https://www.intensivregister.de/api/public/reporting/laendertabelle
1646528700,24598,20409,4189,2099,918,https://www.intensivregister.de/api/public/reporting/laendertabelle
1646532300,24598,20406,4192,2099,918,https://www.intensivregister.de/api/public/reporting/laendertabelle
1646535900,24598,20399,4199,2098,918,https://www.intensivregister.de/api/public/reporting/laendertabelle
1646539500,24598,20398,4200,2096,917,https://www.intensivregister.de/api/public/reporting/laendertabelle
1646543100,24589,20355,4234,2099,917,https://www.intensivregister.de/api/public/reporting/laendertabelle
1646546700,24576,20299,4277,2094,918,https://www.intensivregister.de/api/public/reporting/laendertabelle
1646550300,24531,20215,4316,2101,917,https://www.intensivregister.de/api/public/reporting/laendertabelle
1646553900,24512,20139,4373,2104,923,https://www.intensivregister.de/api/public/reporting/laendertabelle
1646557500,24519,20087,4432,2094,922,https://www.intensivregister.de/api/public/reporting/laendertabelle
1646561100,24517,20044,4473,2101,921,https://www.intensivregister.de/api/public/reporting/laendertabelle
1646564700,24509,20039,4470,2103,922,https://www.intensivregister.de/api/public/reporting/laendertabelle
1646568300,24508,20025,4483,2101,923,https://www.intensivregister.de/api/public/reporting/laendertabelle
1646571900,24507,20024,4483,2101,923,https://www.intensivregister.de/api/public/reporting/laendertabelle
1646575500,24505,20021,4484,2102,924,https://www.intensivregister.de/api/public/reporting/laendertabelle
1646589900,24505,20020,4485,2102,924,https://www.intensivregister.de/api/public/reporting/laendertabelle
1646597100,24503,20018,4485,2102,924,https://www.intensivregister.de/api/public/reporting/laendertabelle
1646604300,24503,20011,4492,2102,924,https://www.intensivregister.de/api/public/reporting/laendertabelle
1646607900,24503,20016,4487,2104,924,https://www.intensivregister.de/api/public/reporting/laendertabelle
1646611500,24539,20049,4490,2106,926,https://www.intensivregister.de/api/public/reporting/laendertabelle
1646615100,24542,20052,4490,2105,926,https://www.intensivregister.de/api/public/reporting/laendertabelle
1646618700,24542,20058,4484,2108,926,https://www.intensivregister.de/api/public/reporting/laendertabelle
1646622300,24542,20070,4472,2108,925,https://www.intensivregister.de/api/public/reporting/laendertabelle
1646625900,24545,20084,4461,2115,925,https://www.intensivregister.de/api/public/reporting/laendertabelle
1646629500,24567,20140,4427,2114,924,https://www.intensivregister.de/api/public/reporting/laendertabelle
1646633100,24641,20176,4465,2127,923,https://www.intensivregister.de/api/public/reporting/laendertabelle
1646636700,24688,20186,4502,2137,930,https://www.intensivregister.de/api/public/reporting/laendertabelle
1646640300,24749,20280,4469,2153,929,https://www.intensivregister.de/api/public/reporting/laendertabelle
1646643900,24737,20312,4425,2156,929,https://www.intensivregister.de/api/public/reporting/laendertabelle
1646647500,24735,20279,4456,2156,925,https://www.intensivregister.de/api/public/reporting/laendertabelle
1646651100,24733,20283,4450,2158,927,https://www.intensivregister.de/api/public/reporting/laendertabelle
1646654700,24734,20281,4453,2159,928,https://www.intensivregister.de/api/public/reporting/laendertabelle
1646658300,24735,20292,4443,2158,928,https://www.intensivregister.de/api/public/reporting/laendertabelle
1646661900,24739,20293,4446,2158,928,https://www.intensivregister.de/api/public/reporting/laendertabelle
1646665500,24739,20289,4450,2158,928,https://www.intensivregister.de/api/public/reporting/laendertabelle
1646669100,24741,20289,4452,2159,928,https://www.intensivregister.de/api/public/reporting/laendertabelle
1646672700,24741,20289,4452,2160,928,https://www.intensivregister.de/api/public/reporting/laendertabelle
1646687100,24741,20291,4450,2160,928,https://www.intensivregister.de/api/public/reporting/laendertabelle
1646694300,24741,20304,4437,2161,928,https://www.intensivregister.de/api/public/reporting/laendertabelle
1646697900,24714,20275,4439,2159,928,https://www.intensivregister.de/api/public/reporting/laendertabelle
1646701500,24714,20279,4435,2158,927,https://www.intensivregister.de/api/public/reporting/laendertabelle
1646705100,24713,20281,4432,2158,926,https://www.intensivregister.de/api/public/reporting/laendertabelle
1646708700,24711,20282,4429,2159,926,https://www.intensivregister.de/api/public/reporting/laendertabelle
1646712300,24718,20286,4432,2163,930,https://www.intensivregister.de/api/public/reporting/laendertabelle
1646715900,24731,20303,4428,2172,941,https://www.intensivregister.de/api/public/reporting/laendertabelle
1646719500,24733,20426,4307,2162,926,https://www.intensivregister.de/api/public/reporting/laendertabelle
1646723100,24777,20544,4233,2156,930,https://www.intensivregister.de/api/public/reporting/laendertabelle
1646726700,24806,20587,4219,2152,927,https://www.intensivregister.de/api/public/reporting/laendertabelle
1646730300,24823,20650,4173,2148,933,https://www.intensivregister.de/api/public/reporting/laendertabelle
1646733900,24811,20673,4138,2150,942,https://www.intensivregister.de/api/public/reporting/laendertabelle
1646737500,24812,20685,4127,2151,941,https://www.intensivregister.de/api/public/reporting/laendertabelle
1646741100,24812,20690,4122,2151,941,https://www.intensivregister.de/api/public/reporting/laendertabelle
1646748300,24812,20687,4125,2150,942,https://www.intensivregister.de/api/public/reporting/laendertabelle
1646751900,24812,20687,4125,2151,942,https://www.intensivregister.de/api/public/reporting/laendertabelle
1646755500,24818,20693,4125,2152,942,https://www.intensivregister.de/api/public/reporting/laendertabelle
1646759100,24819,20694,4125,2152,942,https://www.intensivregister.de/api/public/reporting/laendertabelle
1646766300,24819,20688,4131,2151,942,https://www.intensivregister.de/api/public/reporting/laendertabelle
1646777100,24818,20687,4131,2151,942,https://www.intensivregister.de/api/public/reporting/laendertabelle
1646780700,24818,20680,4138,2152,942,https://www.intensivregister.de/api/public/reporting/laendertabelle
1646784300,24817,20680,4137,2152,941,https://www.intensivregister.de/api/public/reporting/laendertabelle
1646787900,24817,20685,4132,2154,942,https://www.intensivregister.de/api/public/reporting/laendertabelle
1646791500,24818,20683,4135,2155,942,https://www.intensivregister.de/api/public/reporting/laendertabelle
1646795100,24818,20686,4132,2155,942,https://www.intensivregister.de/api/public/reporting/laendertabelle
1646798700,24816,20676,4140,2149,939,https://www.intensivregister.de/api/public/reporting/laendertabelle
1646802300,24820,20689,4131,2137,933,https://www.intensivregister.de/api/public/reporting/laendertabelle
1646805900,24824,20694,4130,2131,936,https://www.intensivregister.de/api/public/reporting/laendertabelle
1646809500,24848,20774,4074,2129,936,https://www.intensivregister.de/api/public/reporting/laendertabelle
1646813100,24822,20799,4023,2126,934,https://www.intensivregister.de/api/public/reporting/laendertabelle
1646816700,24862,20829,4033,2119,944,https://www.intensivregister.de/api/public/reporting/laendertabelle
1646820300,24862,20858,4004,2117,943,https://www.intensivregister.de/api/public/reporting/laendertabelle
1646823900,24868,20865,4003,2113,941,https://www.intensivregister.de/api/public/reporting/laendertabelle
1646827500,24863,20866,3997,2108,936,https://www.intensivregister.de/api/public/reporting/laendertabelle
1646831100,24863,20869,3994,2114,937,https://www.intensivregister.de/api/public/reporting/laendertabelle
1646834700,24866,20868,3998,2115,937,https://www.intensivregister.de/api/public/reporting/laendertabelle
1646838300,24866,20868,3998,2117,937,https://www.intensivregister.de/api/public/reporting/laendertabelle
1646841900,24866,20868,3998,2118,936,https://www.intensivregister.de/api/public/reporting/laendertabelle
1646845500,24866,20869,3997,2117,937,https://www.intensivregister.de/api/public/reporting/laendertabelle
1646856300,24866,20863,4003,2115,936,https://www.intensivregister.de/api/public/reporting/laendertabelle
1646859900,24863,20858,4005,2115,936,https://www.intensivregister.de/api/public/reporting/laendertabelle
1646863500,24863,20854,4009,2115,936,https://www.intensivregister.de/api/public/reporting/laendertabelle
1646867100,24863,20853,4010,2117,939,https://www.intensivregister.de/api/public/reporting/laendertabelle
1646870700,24863,20856,4007,2118,939,https://www.intensivregister.de/api/public/reporting/laendertabelle
1646874300,24862,20863,3999,2119,940,https://www.intensivregister.de/api/public/reporting/laendertabelle
1646877900,24862,20867,3995,2119,940,https://www.intensivregister.de/api/public/reporting/laendertabelle
1646881500,24863,20864,3999,2114,942,https://www.intensivregister.de/api/public/reporting/laendertabelle
1646885100,24857,20868,3989,2113,943,https://www.intensivregister.de/api/public/reporting/laendertabelle
1646888700,24848,20862,3986,2108,933,https://www.intensivregister.de/api/public/reporting/laendertabelle
1646892300,24828,20835,3993,2107,930,https://www.intensivregister.de/api/public/reporting/laendertabelle
1646895900,24827,20799,4028,2108,924,https://www.intensivregister.de/api/public/reporting/laendertabelle
1646899500,24826,20798,4028,2116,918,https://www.intensivregister.de/api/public/reporting/laendertabelle
1646903100,24827,20797,4030,2123,912,https://www.intensivregister.de/api/public/reporting/laendertabelle
1646906700,24834,20787,4047,2117,906,https://www.intensivregister.de/api/public/reporting/laendertabelle
1646910300,24832,20788,4044,2115,903,https://www.intensivregister.de/api/public/reporting/laendertabelle
1646913900,24829,20789,4040,2117,903,https://www.intensivregister.de/api/public/reporting/laendertabelle
1646917500,24829,20787,4042,2118,905,https://www.intensivregister.de/api/public/reporting/laendertabelle
1646921100,24824,20779,4045,2118,905,https://www.intensivregister.de/api/public/reporting/laendertabelle
1646924700,24824,20780,4044,2118,905,https://www.intensivregister.de/api/public/reporting/laendertabelle
1646928300,24824,20778,4046,2117,905,https://www.intensivregister.de/api/public/reporting/laendertabelle
1646931900,24824,20780,4044,2117,905,https://www.intensivregister.de/api/public/reporting/laendertabelle
1646935500,24824,20781,4043,2118,905,https://www.intensivregister.de/api/public/reporting/laendertabelle
1646939100,24818,20776,4042,2119,905,https://www.intensivregister.de/api/public/reporting/laendertabelle
1646942700,24818,20774,4044,2118,905,https://www.intensivregister.de/api/public/reporting/laendertabelle
1646949900,24818,20775,4043,2118,905,https://www.intensivregister.de/api/public/reporting/laendertabelle
1646953500,24816,20765,4051,2118,904,https://www.intensivregister.de/api/public/reporting/laendertabelle
1646957100,24818,20761,4057,2116,903,https://www.intensivregister.de/api/public/reporting/laendertabelle
1646960700,24819,20767,4052,2116,905,https://www.intensivregister.de/api/public/reporting/laendertabelle
1646964300,24819,20767,4052,2117,905,https://www.intensivregister.de/api/public/reporting/laendertabelle
1646967900,24819,20770,4049,2120,905,https://www.intensivregister.de/api/public/reporting/laendertabelle
1646971500,24822,20778,4044,2120,905,https://www.intensivregister.de/api/public/reporting/laendertabelle
1646975100,24817,20743,4074,2121,903,https://www.intensivregister.de/api/public/reporting/laendertabelle
1646978700,24794,20737,4057,2102,898,https://www.intensivregister.de/api/public/reporting/laendertabelle
1646982300,24764,20780,3984,2097,895,https://www.intensivregister.de/api/public/reporting/laendertabelle
1646985900,24741,20782,3959,2112,908,https://www.intensivregister.de/api/public/reporting/laendertabelle
1646989500,24734,20797,3937,2116,910,https://www.intensivregister.de/api/public/reporting/laendertabelle
1646993100,24722,20757,3965,2118,904,https://www.intensivregister.de/api/public/reporting/laendertabelle
1646996700,24720,20759,3961,2119,905,https://www.intensivregister.de/api/public/reporting/laendertabelle
1647000300,24720,20746,3974,2119,904,https://www.intensivregister.de/api/public/reporting/laendertabelle
1647003900,24720,20754,3966,2119,905,https://www.intensivregister.de/api/public/reporting/laendertabelle
1647007500,24715,20756,3959,2121,906,https://www.intensivregister.de/api/public/reporting/laendertabelle
1647011100,24711,20753,3958,2122,906,https://www.intensivregister.de/api/public/reporting/laendertabelle
1647014700,24710,20753,3957,2119,904,https://www.intensivregister.de/api/public/reporting/laendertabelle
1647018300,24710,20758,3952,2119,904,https://www.intensivregister.de/api/public/reporting/laendertabelle
1647036300,24710,20759,3951,2118,903,https://www.intensivregister.de/api/public/reporting/laendertabelle
1647039900,24703,20749,3954,2115,903,https://www.intensivregister.de/api/public/reporting/laendertabelle
1647043500,24704,20748,3956,2115,903,https://www.intensivregister.de/api/public/reporting/laendertabelle
1647047100,24704,20747,3957,2114,903,https://www.intensivregister.de/api/public/reporting/laendertabelle
1647050700,24702,20751,3951,2114,903,https://www.intensivregister.de/api/public/reporting/laendertabelle
1647054300,24699,20759,3940,2113,903,https://www.intensivregister.de/api/public/reporting/laendertabelle
1647057900,24694,20753,3941,2110,902,https://www.intensivregister.de/api/public/reporting/laendertabelle
1647061500,24675,20730,3945,2116,899,https://www.intensivregister.de/api/public/reporting/laendertabelle
1647065100,24643,20668,3975,2117,895,https://www.intensivregister.de/api/public/reporting/laendertabelle
1647068700,24548,20578,3970,2128,904,https://www.intensivregister.de/api/public/reporting/laendertabelle
1647072300,24497,20441,4056,2129,896,https://www.intensivregister.de/api/public/reporting/laendertabelle
1647075900,24465,20364,4101,2113,900,https://www.intensivregister.de/api/public/reporting/laendertabelle
1647079500,24446,20316,4130,2113,901,https://www.intensivregister.de/api/public/reporting/laendertabelle
1647083100,24442,20300,4142,2113,901,https://www.intensivregister.de/api/public/reporting/laendertabelle
1647086700,24442,20298,4144,2114,901,https://www.intensivregister.de/api/public/reporting/laendertabelle
1647090300,24439,20292,4147,2114,901,https://www.intensivregister.de/api/public/reporting/laendertabelle
1647093900,24439,20295,4144,2115,903,https://www.intensivregister.de/api/public/reporting/laendertabelle
1647097500,24439,20293,4146,2115,903,https://www.intensivregister.de/api/public/reporting/laendertabelle
1647101100,24438,20294,4144,2117,903,https://www.intensivregister.de/api/public/reporting/laendertabelle
1647108300,24438,20297,4141,2118,904,https://www.intensivregister.de/api/public/reporting/laendertabelle
1647122700,24440,20292,4148,2120,903,https://www.intensivregister.de/api/public/reporting/laendertabelle
1647126300,24442,20290,4152,2123,903,https://www.intensivregister.de/api/public/reporting/laendertabelle
1647129900,24442,20290,4152,2126,903,https://www.intensivregister.de/api/public/reporting/laendertabelle
1647133500,24442,20284,4158,2129,905,https://www.intensivregister.de/api/public/reporting/laendertabelle
1647137100,24442,20286,4156,2129,905,https://www.intensivregister.de/api/public/reporting/laendertabelle
1647140700,24442,20285,4157,2129,905,https://www.intensivregister.de/api/public/reporting/laendertabelle
1647144300,24438,20266,4172,2130,903,https://www.intensivregister.de/api/public/reporting/laendertabelle
1647147900,24435,20247,4188,2128,904,https://www.intensivregister.de/api/public/reporting/laendertabelle
1647151500,24409,20181,4228,2128,911,https://www.intensivregister.de/api/public/reporting/laendertabelle
1647155100,24372,20142,4230,2157,901,https://www.intensivregister.de/api/public/reporting/laendertabelle
1647158700,24371,20089,4282,2181,907,https://www.intensivregister.de/api/public/reporting/laendertabelle
1647162300,24370,20036,4334,2185,906,https://www.intensivregister.de/api/public/reporting/laendertabelle
1647165900,24361,20008,4353,2194,905,https://www.intensivregister.de/api/public/reporting/laendertabelle
1647169500,24358,20000,4358,2194,903,https://www.intensivregister.de/api/public/reporting/laendertabelle
1647173100,24358,19997,4361,2193,903,https://www.intensivregister.de/api/public/reporting/laendertabelle
1647176700,24357,20001,4356,2194,904,https://www.intensivregister.de/api/public/reporting/laendertabelle
1647180300,24357,20007,4350,2195,905,https://www.intensivregister.de/api/public/reporting/laendertabelle
1647183900,24358,20008,4350,2195,905,https://www.intensivregister.de/api/public/reporting/laendertabelle
1647187500,24358,20009,4349,2196,905,https://www.intensivregister.de/api/public/reporting/laendertabelle
1647191100,24358,20008,4350,2195,905,https://www.intensivregister.de/api/public/reporting/laendertabelle
1647198300,24358,20009,4349,2195,905,https://www.intensivregister.de/api/public/reporting/laendertabelle
1647201900,24358,20010,4348,2195,905,https://www.intensivregister.de/api/public/reporting/laendertabelle
1647205500,24358,20011,4347,2195,905,https://www.intensivregister.de/api/public/reporting/laendertabelle
1647209100,24366,20013,4353,2192,905,https://www.intensivregister.de/api/public/reporting/laendertabelle
1647212700,24369,20022,4347,2193,906,https://www.intensivregister.de/api/public/reporting/laendertabelle
1647216300,24367,20022,4345,2194,906,https://www.intensivregister.de/api/public/reporting/laendertabelle
1647219900,24365,20023,4342,2195,907,https://www.intensivregister.de/api/public/reporting/laendertabelle
1647223500,24366,20024,4342,2194,908,https://www.intensivregister.de/api/public/reporting/laendertabelle
1647227100,24366,20025,4341,2194,908,https://www.intensivregister.de/api/public/reporting/laendertabelle
1647230700,24372,20038,4334,2195,907,https://www.intensivregister.de/api/public/reporting/laendertabelle
1647234300,24400,20034,4366,2209,908,https://www.intensivregister.de/api/public/reporting/laendertabelle
1647237900,24417,20006,4411,2231,899,https://www.intensivregister.de/api/public/reporting/laendertabelle
1647241500,24520,20121,4399,2249,903,https://www.intensivregister.de/api/public/reporting/laendertabelle
1647245100,24557,20188,4369,2260,910,https://www.intensivregister.de/api/public/reporting/laendertabelle
1647248700,24573,20234,4339,2271,910,https://www.intensivregister.de/api/public/reporting/laendertabelle
1647252300,24578,20246,4332,2261,913,https://www.intensivregister.de/api/public/reporting/laendertabelle
1647255900,24576,20253,4323,2263,913,https://www.intensivregister.de/api/public/reporting/laendertabelle
1647259500,24577,20260,4317,2261,914,https://www.intensivregister.de/api/public/reporting/laendertabelle
1647263100,24577,20261,4316,2259,915,https://www.intensivregister.de/api/public/reporting/laendertabelle
1647266700,24579,20265,4314,2260,917,https://www.intensivregister.de/api/public/reporting/laendertabelle
1647270300,24580,20274,4306,2261,916,https://www.intensivregister.de/api/public/reporting/laendertabelle
1647273900,24583,20277,4306,2261,916,https://www.intensivregister.de/api/public/reporting/laendertabelle
1647291900,24583,20282,4301,2261,916,https://www.intensivregister.de/api/public/reporting/laendertabelle
1647295500,24582,20280,4302,2259,916,https://www.intensivregister.de/api/public/reporting/laendertabelle
1647299100,24586,20290,4296,2260,914,https://www.intensivregister.de/api/public/reporting/laendertabelle
1647302700,24580,20292,4288,2262,914,https://www.intensivregister.de/api/public/reporting/laendertabelle
1647306300,24580,20290,4290,2262,914,https://www.intensivregister.de/api/public/reporting/laendertabelle
1647309900,24580,20286,4294,2263,914,https://www.intensivregister.de/api/public/reporting/laendertabelle
1647313500,24579,20288,4291,2262,914,https://www.intensivregister.de/api/public/reporting/laendertabelle
1647317100,24580,20300,4280,2263,915,https://www.intensivregister.de/api/public/reporting/laendertabelle
1647320700,24595,20354,4241,2250,921,https://www.intensivregister.de/api/public/reporting/laendertabelle
1647324300,24580,20367,4213,2248,920,https://www.intensivregister.de/api/public/reporting/laendertabelle
1647327900,24604,20546,4058,2285,930,https://www.intensivregister.de/api/public/reporting/laendertabelle
1647331500,24617,20640,3977,2299,926,https://www.intensivregister.de/api/public/reporting/laendertabelle
1647335100,24620,20675,3945,2290,926,https://www.intensivregister.de/api/public/reporting/laendertabelle
1647338700,24638,20720,3918,2296,928,https://www.intensivregister.de/api/public/reporting/laendertabelle
1647342300,24636,20719,3917,2298,927,https://www.intensivregister.de/api/public/reporting/laendertabelle
1647345900,24634,20717,3917,2299,927,https://www.intensivregister.de/api/public/reporting/laendertabelle
1647349500,24634,20721,3913,2298,927,https://www.intensivregister.de/api/public/reporting/laendertabelle
1647353100,24635,20728,3907,2298,928,https://www.intensivregister.de/api/public/reporting/laendertabelle
1647356700,24636,20735,3901,2300,929,https://www.intensivregister.de/api/public/reporting/laendertabelle
1647371100,24636,20736,3900,2300,929,https://www.intensivregister.de/api/public/reporting/laendertabelle
1647378300,24636,20734,3902,2300,929,https://www.intensivregister.de/api/public/reporting/laendertabelle
1647381900,24637,20736,3901,2300,929,https://www.intensivregister.de/api/public/reporting/laendertabelle
1647385500,24638,20736,3902,2300,929,https://www.intensivregister.de/api/public/reporting/laendertabelle
1647389100,24636,20733,3903,2300,929,https://www.intensivregister.de/api/public/reporting/laendertabelle
1647392700,24634,20731,3903,2300,929,https://www.intensivregister.de/api/public/reporting/laendertabelle
1647396300,24634,20732,3902,2301,931,https://www.intensivregister.de/api/public/reporting/laendertabelle
1647399900,24637,20736,3901,2301,931,https://www.intensivregister.de/api/public/reporting/laendertabelle
1647403500,24639,20732,3907,2303,931,https://www.intensivregister.de/api/public/reporting/laendertabelle
1647407100,24634,20768,3866,2305,935,https://www.intensivregister.de/api/public/reporting/laendertabelle
1647410700,24650,20828,3822,2301,929,https://www.intensivregister.de/api/public/reporting/laendertabelle
1647414300,24647,20883,3764,2299,934,https://www.intensivregister.de/api/public/reporting/laendertabelle
1647417900,24655,20882,3773,2288,937,https://www.intensivregister.de/api/public/reporting/laendertabelle
1647421500,24663,20907,3756,2296,934,https://www.intensivregister.de/api/public/reporting/laendertabelle
1647425100,24651,20919,3732,2305,936,https://www.intensivregister.de/api/public/reporting/laendertabelle
1647428700,24644,20919,3725,2308,935,https://www.intensivregister.de/api/public/reporting/laendertabelle
1647432300,24643,20920,3723,2305,934,https://www.intensivregister.de/api/public/reporting/laendertabelle
1647435900,24640,20917,3723,2307,935,https://www.intensivregister.de/api/public/reporting/laendertabelle
1647443142,24641,20918,3723,2304,935,https://www.intensivregister.de/api/public/reporting/laendertabelle
1647450340,24641,20921,3720,2304,935,https://www.intensivregister.de/api/public/reporting/laendertabelle
1647453946,24641,20918,3723,2303,935,https://www.intensivregister.de/api/public/reporting/laendertabelle
1647464741,24643,20920,3723,2302,935,https://www.intensivregister.de/api/public/reporting/laendertabelle
1647471943,24644,20925,3719,2302,934,https://www.intensivregister.de/api/public/reporting/laendertabelle
1647475540,24645,20931,3714,2302,934,https://www.intensivregister.de/api/public/reporting/laendertabelle
1647479147,24645,20930,3715,2301,935,https://www.intensivregister.de/api/public/reporting/laendertabelle
1647482753,24646,20932,3714,2299,934,https://www.intensivregister.de/api/public/reporting/laendertabelle
1647486346,24645,20937,3708,2302,934,https://www.intensivregister.de/api/public/reporting/laendertabelle
1647489942,24644,20934,3710,2299,932,https://www.intensivregister.de/api/public/reporting/laendertabelle
1647493546,24640,20905,3735,2308,939,https://www.intensivregister.de/api/public/reporting/laendertabelle
1647497143,24633,20879,3754,2298,931,https://www.intensivregister.de/api/public/reporting/laendertabelle
1647500747,24625,20850,3775,2287,936,https://www.intensivregister.de/api/public/reporting/laendertabelle
1647504341,24586,20811,3775,2285,935,https://www.intensivregister.de/api/public/reporting/laendertabelle
1647507942,24571,20779,3792,2286,935,https://www.intensivregister.de/api/public/reporting/laendertabelle
1647511546,24565,20799,3766,2283,932,https://www.intensivregister.de/api/public/reporting/laendertabelle
1647515140,24569,20790,3779,2283,933,https://www.intensivregister.de/api/public/reporting/laendertabelle
1647518745,24566,20778,3788,2285,935,https://www.intensivregister.de/api/public/reporting/laendertabelle
1647522340,24566,20774,3792,2281,934,https://www.intensivregister.de/api/public/reporting/laendertabelle
1647525945,24569,20771,3798,2282,934,https://www.intensivregister.de/api/public/reporting/laendertabelle
1647529539,24569,20771,3798,2281,934,https://www.intensivregister.de/api/public/reporting/laendertabelle
1647536748,24569,20771,3798,2280,934,https://www.intensivregister.de/api/public/reporting/laendertabelle
1647543939,24570,20774,3796,2277,932,https://www.intensivregister.de/api/public/reporting/laendertabelle
1647554741,24559,20762,3797,2273,931,https://www.intensivregister.de/api/public/reporting/laendertabelle
1647558349,24558,20751,3807,2269,930,https://www.intensivregister.de/api/public/reporting/laendertabelle
1647561944,24559,20746,3813,2270,930,https://www.intensivregister.de/api/public/reporting/laendertabelle
1647565541,24559,20747,3812,2270,930,https://www.intensivregister.de/api/public/reporting/laendertabelle
1647569147,24556,20749,3807,2273,931,https://www.intensivregister.de/api/public/reporting/laendertabelle
1647572739,24557,20748,3809,2272,931,https://www.intensivregister.de/api/public/reporting/laendertabelle
1647576339,24558,20750,3808,2271,929,https://www.intensivregister.de/api/public/reporting/laendertabelle
1647579944,24556,20746,3810,2272,922,https://www.intensivregister.de/api/public/reporting/laendertabelle
1647583546,24512,20748,3764,2259,914,https://www.intensivregister.de/api/public/reporting/laendertabelle
1647587145,24466,20707,3759,2279,922,https://www.intensivregister.de/api/public/reporting/laendertabelle
1647594350,24427,20658,3769,2294,928,https://www.intensivregister.de/api/public/reporting/laendertabelle
1647597948,24425,20668,3757,2287,924,https://www.intensivregister.de/api/public/reporting/laendertabelle
1647605139,24419,20665,3754,2284,926,https://www.intensivregister.de/api/public/reporting/laendertabelle
1647608742,24419,20667,3752,2287,926,https://www.intensivregister.de/api/public/reporting/laendertabelle
1647612342,24419,20669,3750,2286,927,https://www.intensivregister.de/api/public/reporting/laendertabelle
1647615941,24416,20676,3740,2290,927,https://www.intensivregister.de/api/public/reporting/laendertabelle
1647619542,24416,20677,3739,2290,927,https://www.intensivregister.de/api/public/reporting/laendertabelle
1647623143,24416,20679,3737,2287,926,https://www.intensivregister.de/api/public/reporting/laendertabelle
1647630342,24415,20677,3738,2286,926,https://www.intensivregister.de/api/public/reporting/laendertabelle
1647641141,24414,20673,3741,2286,926,https://www.intensivregister.de/api/public/reporting/laendertabelle
1647644741,24413,20670,3743,2284,924,https://www.intensivregister.de/api/public/reporting/laendertabelle
1647648342,24412,20669,3743,2281,924,https://www.intensivregister.de/api/public/reporting/laendertabelle
1647651942,24411,20659,3752,2281,924,https://www.intensivregister.de/api/public/reporting/laendertabelle
1647655543,24411,20654,3757,2280,924,https://www.intensivregister.de/api/public/reporting/laendertabelle
1647659144,24408,20642,3766,2280,923,https://www.intensivregister.de/api/public/reporting/laendertabelle
1647662746,24409,20640,3769,2283,925,https://www.intensivregister.de/api/public/reporting/laendertabelle
1647666346,24406,20603,3803,2264,931,https://www.intensivregister.de/api/public/reporting/laendertabelle
1647669948,24348,20501,3847,2265,941,https://www.intensivregister.de/api/public/reporting/laendertabelle
1647673540,24322,20426,3896,2262,933,https://www.intensivregister.de/api/public/reporting/laendertabelle
1647677140,24270,20266,4004,2240,917,https://www.intensivregister.de/api/public/reporting/laendertabelle
1647680742,24219,20211,4008,2241,908,https://www.intensivregister.de/api/public/reporting/laendertabelle
1647684343,24198,20182,4016,2244,915,https://www.intensivregister.de/api/public/reporting/laendertabelle
1647687945,24192,20163,4029,2245,914,https://www.intensivregister.de/api/public/reporting/laendertabelle
1647695147,24193,20156,4037,2250,913,https://www.intensivregister.de/api/public/reporting/laendertabelle
1647698748,24194,20156,4038,2250,913,https://www.intensivregister.de/api/public/reporting/laendertabelle
1647702341,24190,20151,4039,2251,913,https://www.intensivregister.de/api/public/reporting/laendertabelle
1647705944,24191,20152,4039,2251,913,https://www.intensivregister.de/api/public/reporting/laendertabelle
1647709545,24191,20153,4038,2251,913,https://www.intensivregister.de/api/public/reporting/laendertabelle
1647713145,24186,20150,4036,2253,913,https://www.intensivregister.de/api/public/reporting/laendertabelle
1647720346,24186,20150,4036,2254,914,https://www.intensivregister.de/api/public/reporting/laendertabelle
1647723944,24186,20150,4036,2255,915,https://www.intensivregister.de/api/public/reporting/laendertabelle
1647727539,24186,20152,4034,2255,915,https://www.intensivregister.de/api/public/reporting/laendertabelle
1647731146,24189,20144,4045,2254,916,https://www.intensivregister.de/api/public/reporting/laendertabelle
1647734739,24189,20152,4037,2255,915,https://www.intensivregister.de/api/public/reporting/laendertabelle
1647738346,24189,20149,4040,2256,915,https://www.intensivregister.de/api/public/reporting/laendertabelle
1647741940,24183,20145,4038,2255,915,https://www.intensivregister.de/api/public/reporting/laendertabelle
1647745548,24181,20144,4037,2255,915,https://www.intensivregister.de/api/public/reporting/laendertabelle
1647749149,24179,20142,4037,2256,915,https://www.intensivregister.de/api/public/reporting/laendertabelle
1647756346,24161,20056,4105,2258,911,https://www.intensivregister.de/api/public/reporting/laendertabelle
1647759946,24162,20003,4159,2267,909,https://www.intensivregister.de/api/public/reporting/laendertabelle
1647763544,24145,19944,4201,2256,904,https://www.intensivregister.de/api/public/reporting/laendertabelle
1647767143,24125,19884,4241,2265,897,https://www.intensivregister.de/api/public/reporting/laendertabelle
1647770743,24118,19857,4261,2272,902,https://www.intensivregister.de/api/public/reporting/laendertabelle
1647774345,24117,19848,4269,2268,902,https://www.intensivregister.de/api/public/reporting/laendertabelle
1647777947,24119,19856,4263,2269,902,https://www.intensivregister.de/api/public/reporting/laendertabelle
1647781539,24119,19850,4269,2268,900,https://www.intensivregister.de/api/public/reporting/laendertabelle
1647785136,24119,19851,4268,2270,900,https://www.intensivregister.de/api/public/reporting/laendertabelle
1647788738,24119,19845,4274,2270,900,https://www.intensivregister.de/api/public/reporting/laendertabelle
1647795942,24119,19842,4277,2271,901,https://www.intensivregister.de/api/public/reporting/laendertabelle
1647799540,24119,19842,4277,2270,901,https://www.intensivregister.de/api/public/reporting/laendertabelle
1647806741,24119,19844,4275,2270,901,https://www.intensivregister.de/api/public/reporting/laendertabelle
1647810342,24119,19845,4274,2271,901,https://www.intensivregister.de/api/public/reporting/laendertabelle
1647813940,24119,19840,4279,2271,901,https://www.intensivregister.de/api/public/reporting/laendertabelle
1647817540,24122,19843,4279,2275,902,https://www.intensivregister.de/api/public/reporting/laendertabelle
1647821141,24120,19847,4273,2274,902,https://www.intensivregister.de/api/public/reporting/laendertabelle
1647824737,24124,19849,4275,2273,902,https://www.intensivregister.de/api/public/reporting/laendertabelle
1647828339,24124,19850,4274,2274,902,https://www.intensivregister.de/api/public/reporting/laendertabelle
1647831944,24128,19850,4278,2277,902,https://www.intensivregister.de/api/public/reporting/laendertabelle
1647835545,24132,19858,4274,2274,901,https://www.intensivregister.de/api/public/reporting/laendertabelle
1647839142,24157,19860,4297,2282,894,https://www.intensivregister.de/api/public/reporting/laendertabelle
1647842739,24237,19948,4289,2284,893,https://www.intensivregister.de/api/public/reporting/laendertabelle
1647846346,24271,20036,4235,2304,887,https://www.intensivregister.de/api/public/reporting/laendertabelle
1647853545,24353,20143,4210,2334,878,https://www.intensivregister.de/api/public/reporting/laendertabelle
1647857145,24350,20145,4205,2346,887,https://www.intensivregister.de/api/public/reporting/laendertabelle
1647864345,24329,20146,4183,2346,885,https://www.intensivregister.de/api/public/reporting/laendertabelle
1647867941,24329,20146,4183,2344,883,https://www.intensivregister.de/api/public/reporting/laendertabelle
1647871574,24329,20146,4183,2343,884,https://www.intensivregister.de/api/public/reporting/laendertabelle
1647878788,24331,20146,4185,2343,885,https://www.intensivregister.de/api/public/reporting/laendertabelle
1647889572,24332,20141,4191,2345,887,https://www.intensivregister.de/api/public/reporting/laendertabelle
1647907578,24329,20140,4189,2347,886,https://www.intensivregister.de/api/public/reporting/laendertabelle
1647911174,24329,20147,4182,2347,886,https://www.intensivregister.de/api/public/reporting/laendertabelle
1647914789,24328,20141,4187,2347,886,https://www.intensivregister.de/api/public/reporting/laendertabelle
1647918391,24328,20156,4172,2345,886,https://www.intensivregister.de/api/public/reporting/laendertabelle
1647921990,24327,20151,4176,2342,885,https://www.intensivregister.de/api/public/reporting/laendertabelle
1647925579,24345,20217,4128,2351,888,https://www.intensivregister.de/api/public/reporting/laendertabelle
1647932791,24461,20387,4074,2372,890,https://www.intensivregister.de/api/public/reporting/laendertabelle
1647936388,24491,20458,4033,2376,885,https://www.intensivregister.de/api/public/reporting/laendertabelle
1647939990,24492,20496,3996,2379,888,https://www.intensivregister.de/api/public/reporting/laendertabelle
1647943568,24491,20516,3975,2381,893,https://www.intensivregister.de/api/public/reporting/laendertabelle
1647947188,24490,20523,3967,2380,894,https://www.intensivregister.de/api/public/reporting/laendertabelle
1647954378,24488,20527,3961,2383,896,https://www.intensivregister.de/api/public/reporting/laendertabelle
1647957996,24488,20524,3964,2383,896,https://www.intensivregister.de/api/public/reporting/laendertabelle
1647965194,24488,20525,3963,2383,896,https://www.intensivregister.de/api/public/reporting/laendertabelle
1647968773,24488,20526,3962,2384,896,https://www.intensivregister.de/api/public/reporting/laendertabelle
1647972389,24488,20525,3963,2383,896,https://www.intensivregister.de/api/public/reporting/laendertabelle
1647975998,24488,20526,3962,2384,897,https://www.intensivregister.de/api/public/reporting/laendertabelle
1647983180,24488,20526,3962,2383,897,https://www.intensivregister.de/api/public/reporting/laendertabelle
1647986778,24488,20525,3963,2383,897,https://www.intensivregister.de/api/public/reporting/laendertabelle
1647990388,24491,20526,3965,2387,898,https://www.intensivregister.de/api/public/reporting/laendertabelle
1647993990,24492,20527,3965,2388,899,https://www.intensivregister.de/api/public/reporting/laendertabelle
1648001167,24492,20533,3959,2388,900,https://www.intensivregister.de/api/public/reporting/laendertabelle
1648004794,24491,20528,3963,2387,900,https://www.intensivregister.de/api/public/reporting/laendertabelle
1648008391,24496,20538,3958,2389,900,https://www.intensivregister.de/api/public/reporting/laendertabelle
1648011969,24499,20544,3955,2389,891,https://www.intensivregister.de/api/public/reporting/laendertabelle
1648015599,24495,20557,3938,2345,884,https://www.intensivregister.de/api/public/reporting/laendertabelle
1648022796,24497,20608,3889,2338,890,https://www.intensivregister.de/api/public/reporting/laendertabelle
1648026390,24499,20601,3898,2331,895,https://www.intensivregister.de/api/public/reporting/laendertabelle
1648033574,24508,20647,3861,2331,896,https://www.intensivregister.de/api/public/reporting/laendertabelle
1648037176,24519,20663,3856,2328,896,https://www.intensivregister.de/api/public/reporting/laendertabelle
1648040793,24525,20670,3855,2327,895,https://www.intensivregister.de/api/public/reporting/laendertabelle
1648044394,24523,20675,3848,2327,895,https://www.intensivregister.de/api/public/reporting/laendertabelle
1648047998,24522,20675,3847,2327,895,https://www.intensivregister.de/api/public/reporting/laendertabelle
1648055173,24522,20674,3848,2329,895,https://www.intensivregister.de/api/public/reporting/laendertabelle
1648076778,24523,20665,3858,2328,894,https://www.intensivregister.de/api/public/reporting/laendertabelle
1648080389,24526,20667,3859,2328,894,https://www.intensivregister.de/api/public/reporting/laendertabelle
1648083994,24526,20663,3863,2329,894,https://www.intensivregister.de/api/public/reporting/laendertabelle
1648087589,24527,20669,3858,2330,895,https://www.intensivregister.de/api/public/reporting/laendertabelle
1648091188,24527,20670,3857,2333,895,https://www.intensivregister.de/api/public/reporting/laendertabelle
1648094787,24527,20676,3851,2330,893,https://www.intensivregister.de/api/public/reporting/laendertabelle
1648098391,24538,20653,3885,2328,887,https://www.intensivregister.de/api/public/reporting/laendertabelle
1648101977,24531,20690,3841,2333,891,https://www.intensivregister.de/api/public/reporting/laendertabelle
1648105567,24557,20678,3879,2308,879,https://www.intensivregister.de/api/public/reporting/laendertabelle
1648109194,24562,20714,3848,2336,889,https://www.intensivregister.de/api/public/reporting/laendertabelle
1648112795,24574,20737,3837,2331,892,https://www.intensivregister.de/api/public/reporting/laendertabelle
1648116393,24573,20706,3867,2328,885,https://www.intensivregister.de/api/public/reporting/laendertabelle
1648119975,24575,20711,3864,2329,887,https://www.intensivregister.de/api/public/reporting/laendertabelle
1648123589,24574,20712,3862,2327,889,https://www.intensivregister.de/api/public/reporting/laendertabelle
1648127196,24571,20706,3865,2326,889,https://www.intensivregister.de/api/public/reporting/laendertabelle
1648134368,24571,20708,3863,2334,889,https://www.intensivregister.de/api/public/reporting/laendertabelle
1648137997,24571,20709,3862,2334,889,https://www.intensivregister.de/api/public/reporting/laendertabelle
1648141579,24571,20710,3861,2334,889,https://www.intensivregister.de/api/public/reporting/laendertabelle
1648159569,24568,20708,3860,2334,889,https://www.intensivregister.de/api/public/reporting/laendertabelle
1648166767,24564,20701,3863,2333,889,https://www.intensivregister.de/api/public/reporting/laendertabelle
1648170387,24565,20704,3861,2333,889,https://www.intensivregister.de/api/public/reporting/laendertabelle
1648173990,24565,20707,3858,2334,889,https://www.intensivregister.de/api/public/reporting/laendertabelle
1648177593,24565,20705,3860,2335,889,https://www.intensivregister.de/api/public/reporting/laendertabelle
1648181194,24560,20703,3857,2333,891,https://www.intensivregister.de/api/public/reporting/laendertabelle
1648184789,24565,20683,3882,2321,884,https://www.intensivregister.de/api/public/reporting/laendertabelle
1648188394,24549,20668,3881,2322,880,https://www.intensivregister.de/api/public/reporting/laendertabelle
1648191994,24502,20600,3902,2311,882,https://www.intensivregister.de/api/public/reporting/laendertabelle
1648199176,24448,20595,3853,2311,861,https://www.intensivregister.de/api/public/reporting/laendertabelle
1648202794,24443,20597,3846,2312,863,https://www.intensivregister.de/api/public/reporting/laendertabelle
1648206378,24443,20593,3850,2313,862,https://www.intensivregister.de/api/public/reporting/laendertabelle
1648210047,24443,20595,3848,2313,862,https://www.intensivregister.de/api/public/reporting/laendertabelle
1648213523,24439,20590,3849,2313,860,https://www.intensivregister.de/api/public/reporting/laendertabelle
1648217124,24439,20592,3847,2307,861,https://www.intensivregister.de/api/public/reporting/laendertabelle
1648220725,24439,20593,3846,2306,861,https://www.intensivregister.de/api/public/reporting/laendertabelle
1648224326,24439,20593,3846,2307,862,https://www.intensivregister.de/api/public/reporting/laendertabelle
1648235117,24433,20594,3839,2307,863,https://www.intensivregister.de/api/public/reporting/laendertabelle
1648245925,24433,20592,3841,2307,863,https://www.intensivregister.de/api/public/reporting/laendertabelle
1648249515,24435,20590,3845,2307,864,https://www.intensivregister.de/api/public/reporting/laendertabelle
1648253114,24434,20586,3848,2308,864,https://www.intensivregister.de/api/public/reporting/laendertabelle
1648256722,24431,20585,3846,2308,864,https://www.intensivregister.de/api/public/reporting/laendertabelle
1648260331,24432,20583,3849,2309,863,https://www.intensivregister.de/api/public/reporting/laendertabelle
1648263926,24432,20581,3851,2313,863,https://www.intensivregister.de/api/public/reporting/laendertabelle
1648267531,24430,20567,3863,2312,863,https://www.intensivregister.de/api/public/reporting/laendertabelle
1648271118,24410,20571,3839,2312,861,https://www.intensivregister.de/api/public/reporting/laendertabelle
1648274723,24365,20498,3867,2312,870,https://www.intensivregister.de/api/public/reporting/laendertabelle
1648278327,24314,20397,3917,2330,883,https://www.intensivregister.de/api/public/reporting/laendertabelle
1648285526,24204,20264,3940,2335,886,https://www.intensivregister.de/api/public/reporting/laendertabelle
1648289122,24196,20267,3929,2333,886,https://www.intensivregister.de/api/public/reporting/laendertabelle
1648296324,24196,20261,3935,2339,887,https://www.intensivregister.de/api/public/reporting/laendertabelle
1648299919,24191,20256,3935,2334,887,https://www.intensivregister.de/api/public/reporting/laendertabelle
1648303525,24191,20255,3936,2334,887,https://www.intensivregister.de/api/public/reporting/laendertabelle
1648310726,24186,20250,3936,2332,886,https://www.intensivregister.de/api/public/reporting/laendertabelle
1648325127,24186,20250,3936,2333,887,https://www.intensivregister.de/api/public/reporting/laendertabelle
1648332320,24191,20252,3939,2333,887,https://www.intensivregister.de/api/public/reporting/laendertabelle
1648339530,24189,20235,3954,2332,888,https://www.intensivregister.de/api/public/reporting/laendertabelle
1648343130,24189,20232,3957,2329,888,https://www.intensivregister.de/api/public/reporting/laendertabelle
1648346729,24190,20237,3953,2328,886,https://www.intensivregister.de/api/public/reporting/laendertabelle
1648350320,24181,20224,3957,2337,890,https://www.intensivregister.de/api/public/reporting/laendertabelle
1648353922,24164,20170,3994,2334,896,https://www.intensivregister.de/api/public/reporting/laendertabelle
1648357533,24146,20051,4095,2323,897,https://www.intensivregister.de/api/public/reporting/laendertabelle
1648364719,24115,19935,4180,2340,898,https://www.intensivregister.de/api/public/reporting/laendertabelle
1648368326,24108,19928,4180,2335,904,https://www.intensivregister.de/api/public/reporting/laendertabelle
1648371924,24115,19940,4175,2338,902,https://www.intensivregister.de/api/public/reporting/laendertabelle
1648379134,24113,19931,4182,2339,904,https://www.intensivregister.de/api/public/reporting/laendertabelle
1648382724,24114,19930,4184,2339,903,https://www.intensivregister.de/api/public/reporting/laendertabelle
1648386315,24114,19929,4185,2339,903,https://www.intensivregister.de/api/public/reporting/laendertabelle
1648393531,24111,19927,4184,2338,903,https://www.intensivregister.de/api/public/reporting/laendertabelle
1648397129,24109,19925,4184,2338,903,https://www.intensivregister.de/api/public/reporting/laendertabelle
1648400727,24109,19920,4189,2338,903,https://www.intensivregister.de/api/public/reporting/laendertabelle
1648407924,24109,19919,4190,2339,902,https://www.intensivregister.de/api/public/reporting/laendertabelle
1648415129,24109,19923,4186,2337,902,https://www.intensivregister.de/api/public/reporting/laendertabelle
1648418726,24109,19925,4184,2337,902,https://www.intensivregister.de/api/public/reporting/laendertabelle
1648425919,24110,19927,4183,2337,902,https://www.intensivregister.de/api/public/reporting/laendertabelle
1648429529,24110,19933,4177,2338,902,https://www.intensivregister.de/api/public/reporting/laendertabelle
1648433117,24127,19940,4187,2341,902,https://www.intensivregister.de/api/public/reporting/laendertabelle
1648436718,24144,19947,4197,2353,913,https://www.intensivregister.de/api/public/reporting/laendertabelle
1648440320,24174,19935,4239,2342,913,https://www.intensivregister.de/api/public/reporting/laendertabelle
1648443923,24276,20020,4256,2335,906,https://www.intensivregister.de/api/public/reporting/laendertabelle
1648447515,24333,20076,4257,2332,901,https://www.intensivregister.de/api/public/reporting/laendertabelle
1648451119,24371,20134,4237,2346,901,https://www.intensivregister.de/api/public/reporting/laendertabelle
1648458317,24386,20124,4262,2355,902,https://www.intensivregister.de/api/public/reporting/laendertabelle
1648461932,24382,20121,4261,2355,902,https://www.intensivregister.de/api/public/reporting/laendertabelle
1648465523,24404,20144,4260,2357,903,https://www.intensivregister.de/api/public/reporting/laendertabelle
1648469127,24408,20149,4259,2359,904,https://www.intensivregister.de/api/public/reporting/laendertabelle
1648476330,24408,20150,4258,2360,904,https://www.intensivregister.de/api/public/reporting/laendertabelle
1648487127,24408,20149,4259,2360,904,https://www.intensivregister.de/api/public/reporting/laendertabelle
1648494331,24408,20145,4263,2360,904,https://www.intensivregister.de/api/public/reporting/laendertabelle
1648497931,24408,20147,4261,2360,904,https://www.intensivregister.de/api/public/reporting/laendertabelle
1648501531,24408,20148,4260,2359,904,https://www.intensivregister.de/api/public/reporting/laendertabelle
1648505132,24408,20152,4256,2361,905,https://www.intensivregister.de/api/public/reporting/laendertabelle
1648508731,24408,20145,4263,2363,905,https://www.intensivregister.de/api/public/reporting/laendertabelle
1648512322,24408,20151,4257,2367,905,https://www.intensivregister.de/api/public/reporting/laendertabelle
1648515922,24408,20153,4255,2369,904,https://www.intensivregister.de/api/public/reporting/laendertabelle
1648519523,24407,20152,4255,2367,903,https://www.intensivregister.de/api/public/reporting/laendertabelle
1648523121,24426,20195,4231,2376,907,https://www.intensivregister.de/api/public/reporting/laendertabelle
1648526730,24452,20296,4156,2372,907,https://www.intensivregister.de/api/public/reporting/laendertabelle
1648530320,24493,20480,4013,2366,902,https://www.intensivregister.de/api/public/reporting/laendertabelle
1648537529,24549,20621,3928,2382,915,https://www.intensivregister.de/api/public/reporting/laendertabelle
1648541130,24560,20652,3908,2375,913,https://www.intensivregister.de/api/public/reporting/laendertabelle
1648544733,24556,20653,3903,2377,913,https://www.intensivregister.de/api/public/reporting/laendertabelle
1648548333,24556,20661,3895,2380,915,https://www.intensivregister.de/api/public/reporting/laendertabelle
1648551932,24556,20659,3897,2380,915,https://www.intensivregister.de/api/public/reporting/laendertabelle
1648555522,24556,20662,3894,2383,914,https://www.intensivregister.de/api/public/reporting/laendertabelle
1648562729,24558,20662,3896,2383,914,https://www.intensivregister.de/api/public/reporting/laendertabelle
1648573517,24558,20665,3893,2385,914,https://www.intensivregister.de/api/public/reporting/laendertabelle
1648584332,24558,20666,3892,2384,914,https://www.intensivregister.de/api/public/reporting/laendertabelle
1648587928,24558,20668,3890,2383,913,https://www.intensivregister.de/api/public/reporting/laendertabelle
1648591518,24558,20669,3889,2383,914,https://www.intensivregister.de/api/public/reporting/laendertabelle
1648598725,24558,20670,3888,2384,915,https://www.intensivregister.de/api/public/reporting/laendertabelle
1648602322,24556,20669,3887,2386,917,https://www.intensivregister.de/api/public/reporting/laendertabelle
1648605916,24556,20667,3889,2382,916,https://www.intensivregister.de/api/public/reporting/laendertabelle
1648609521,24560,20684,3876,2373,912,https://www.intensivregister.de/api/public/reporting/laendertabelle
1648613118,24563,20772,3791,2342,910,https://www.intensivregister.de/api/public/reporting/laendertabelle
1648616717,24567,20762,3805,2340,891,https://www.intensivregister.de/api/public/reporting/laendertabelle
1648623918,24596,20803,3793,2327,882,https://www.intensivregister.de/api/public/reporting/laendertabelle
1648627517,24597,20823,3774,2332,884,https://www.intensivregister.de/api/public/reporting/laendertabelle
1648631121,24600,20828,3772,2333,883,https://www.intensivregister.de/api/public/reporting/laendertabelle
1648634718,24600,20825,3775,2333,884,https://www.intensivregister.de/api/public/reporting/laendertabelle
1648638328,24586,20806,3780,2330,884,https://www.intensivregister.de/api/public/reporting/laendertabelle
1648645522,24585,20813,3772,2334,885,https://www.intensivregister.de/api/public/reporting/laendertabelle
1648652714,24585,20817,3768,2335,886,https://www.intensivregister.de/api/public/reporting/laendertabelle
1648663515,24585,20818,3767,2335,886,https://www.intensivregister.de/api/public/reporting/laendertabelle
1648667132,24585,20818,3767,2337,886,https://www.intensivregister.de/api/public/reporting/laendertabelle
1648670718,24587,20820,3767,2336,886,https://www.intensivregister.de/api/public/reporting/laendertabelle
1648677931,24597,20820,3777,2332,887,https://www.intensivregister.de/api/public/reporting/laendertabelle
1648688717,24595,20818,3777,2329,886,https://www.intensivregister.de/api/public/reporting/laendertabelle
1648695918,24601,20810,3791,2325,885,https://www.intensivregister.de/api/public/reporting/laendertabelle
1648703119,24600,20781,3819,2327,872,https://www.intensivregister.de/api/public/reporting/laendertabelle
1648706721,24584,20792,3792,2314,882,https://www.intensivregister.de/api/public/reporting/laendertabelle
1648713928,24567,20743,3824,2305,873,https://www.intensivregister.de/api/public/reporting/laendertabelle
1648717526,24565,20745,3820,2307,875,https://www.intensivregister.de/api/public/reporting/laendertabelle
1648721128,24554,20738,3816,2309,877,https://www.intensivregister.de/api/public/reporting/laendertabelle
1648728329,24557,20743,3814,2309,876,https://www.intensivregister.de/api/public/reporting/laendertabelle
1648731927,24557,20746,3811,2307,875,https://www.intensivregister.de/api/public/reporting/laendertabelle
1648735517,24557,20748,3809,2311,875,https://www.intensivregister.de/api/public/reporting/laendertabelle
1648760733,24555,20747,3808,2309,875,https://www.intensivregister.de/api/public/reporting/laendertabelle
1648764321,24554,20745,3809,2308,877,https://www.intensivregister.de/api/public/reporting/laendertabelle
1648767929,24552,20739,3813,2311,878,https://www.intensivregister.de/api/public/reporting/laendertabelle
1648775126,24552,20737,3815,2311,878,https://www.intensivregister.de/api/public/reporting/laendertabelle
1648778731,24541,20730,3811,2313,878,https://www.intensivregister.de/api/public/reporting/laendertabelle
1648782321,24532,20768,3764,2313,879,https://www.intensivregister.de/api/public/reporting/laendertabelle
1648785927,24520,20748,3772,2289,871,https://www.intensivregister.de/api/public/reporting/laendertabelle
1648789517,24491,20710,3781,2270,880,https://www.intensivregister.de/api/public/reporting/laendertabelle
1648793122,24421,20637,3784,2273,876,https://www.intensivregister.de/api/public/reporting/laendertabelle
1648800328,24390,20609,3781,2273,880,https://www.intensivregister.de/api/public/reporting/laendertabelle
1648803932,24396,20612,3784,2277,881,https://www.intensivregister.de/api/public/reporting/laendertabelle
1648915516,24198,20232,3966,2214,867,https://www.intensivregister.de/api/public/reporting/laendertabelle
1648922721,24196,20232,3964,2216,868,https://www.intensivregister.de/api/public/reporting/laendertabelle
1648926324,24196,20232,3964,2217,868,https://www.intensivregister.de/api/public/reporting/laendertabelle
1648933521,24216,20239,3977,2220,869,https://www.intensivregister.de/api/public/reporting/laendertabelle
1648940721,24216,20241,3975,2220,869,https://www.intensivregister.de/api/public/reporting/laendertabelle
1648944322,24216,20240,3976,2220,869,https://www.intensivregister.de/api/public/reporting/laendertabelle
1648947916,24214,20240,3974,2221,868,https://www.intensivregister.de/api/public/reporting/laendertabelle
1648951519,24214,20232,3982,2221,868,https://www.intensivregister.de/api/public/reporting/laendertabelle
1648955114,24211,20231,3980,2211,861,https://www.intensivregister.de/api/public/reporting/laendertabelle
1648958721,24199,20202,3997,2216,855,https://www.intensivregister.de/api/public/reporting/laendertabelle
1648962320,24176,20094,4082,2226,853,https://www.intensivregister.de/api/public/reporting/laendertabelle
1648965919,24145,19984,4161,2216,845,https://www.intensivregister.de/api/public/reporting/laendertabelle
1648969520,24135,19932,4203,2217,842,https://www.intensivregister.de/api/public/reporting/laendertabelle
1648976722,24114,19893,4221,2212,847,https://www.intensivregister.de/api/public/reporting/laendertabelle
1648980320,24114,19894,4220,2209,846,https://www.intensivregister.de/api/public/reporting/laendertabelle
1648983917,24112,19892,4220,2207,846,https://www.intensivregister.de/api/public/reporting/laendertabelle
1648991121,24109,19884,4225,2208,847,https://www.intensivregister.de/api/public/reporting/laendertabelle
1648998318,24103,19886,4217,2213,847,https://www.intensivregister.de/api/public/reporting/laendertabelle
1649005523,24103,19886,4217,2212,847,https://www.intensivregister.de/api/public/reporting/laendertabelle
1649009121,24103,19887,4216,2213,848,https://www.intensivregister.de/api/public/reporting/laendertabelle
1649019918,24104,19897,4207,2212,847,https://www.intensivregister.de/api/public/reporting/laendertabelle
1649023521,24104,19889,4215,2209,848,https://www.intensivregister.de/api/public/reporting/laendertabelle
1649027117,24103,19887,4216,2208,849,https://www.intensivregister.de/api/public/reporting/laendertabelle
1649030724,24101,19885,4216,2208,849,https://www.intensivregister.de/api/public/reporting/laendertabelle
1649034318,24101,19881,4220,2209,848,https://www.intensivregister.de/api/public/reporting/laendertabelle
1649037920,24108,19891,4217,2212,848,https://www.intensivregister.de/api/public/reporting/laendertabelle
1649041514,24126,19882,4244,2215,848,https://www.intensivregister.de/api/public/reporting/laendertabelle
1649045118,24216,19942,4274,2226,859,https://www.intensivregister.de/api/public/reporting/laendertabelle
1649052315,24361,20109,4252,2217,862,https://www.intensivregister.de/api/public/reporting/laendertabelle
1649055920,24402,20142,4260,2226,855,https://www.intensivregister.de/api/public/reporting/laendertabelle
1649059519,24414,20160,4254,2235,856,https://www.intensivregister.de/api/public/reporting/laendertabelle
1649066719,24421,20155,4266,2231,853,https://www.intensivregister.de/api/public/reporting/laendertabelle
1649073923,24418,20150,4268,2231,855,https://www.intensivregister.de/api/public/reporting/laendertabelle
1649077523,24418,20148,4270,2231,855,https://www.intensivregister.de/api/public/reporting/laendertabelle
1649084715,24418,20149,4269,2231,855,https://www.intensivregister.de/api/public/reporting/laendertabelle
1649088320,24418,20151,4267,2234,855,https://www.intensivregister.de/api/public/reporting/laendertabelle
1649091915,24418,20146,4272,2233,855,https://www.intensivregister.de/api/public/reporting/laendertabelle
1649099119,24418,20148,4270,2231,853,https://www.intensivregister.de/api/public/reporting/laendertabelle
1649109918,24415,20146,4269,2234,854,https://www.intensivregister.de/api/public/reporting/laendertabelle
1649113533,24409,20135,4274,2235,854,https://www.intensivregister.de/api/public/reporting/laendertabelle
1649117116,24408,20143,4265,2234,854,https://www.intensivregister.de/api/public/reporting/laendertabelle
1649120731,24409,20151,4258,2230,853,https://www.intensivregister.de/api/public/reporting/laendertabelle
1649124316,24407,20161,4246,2231,854,https://www.intensivregister.de/api/public/reporting/laendertabelle
1649131526,24476,20352,4124,2199,841,https://www.intensivregister.de/api/public/reporting/laendertabelle
1649135117,24509,20474,4035,2171,833,https://www.intensivregister.de/api/public/reporting/laendertabelle
1649138721,24524,20556,3968,2148,831,https://www.intensivregister.de/api/public/reporting/laendertabelle
1649142331,24512,20629,3883,2158,831,https://www.intensivregister.de/api/public/reporting/laendertabelle
1649145932,24510,20631,3879,2161,829,https://www.intensivregister.de/api/public/reporting/laendertabelle
1649153121,24510,20642,3868,2163,830,https://www.intensivregister.de/api/public/reporting/laendertabelle
1649156714,24510,20639,3871,2165,830,https://www.intensivregister.de/api/public/reporting/laendertabelle
1649160332,24508,20640,3868,2166,831,https://www.intensivregister.de/api/public/reporting/laendertabelle
1649163917,24508,20642,3866,2166,831,https://www.intensivregister.de/api/public/reporting/laendertabelle
1649167516,24508,20641,3867,2167,832,https://www.intensivregister.de/api/public/reporting/laendertabelle
1649171123,24509,20647,3862,2167,832,https://www.intensivregister.de/api/public/reporting/laendertabelle
1649174719,24509,20648,3861,2167,832,https://www.intensivregister.de/api/public/reporting/laendertabelle
1649178316,24509,20654,3855,2167,832,https://www.intensivregister.de/api/public/reporting/laendertabelle
1649189117,24509,20651,3858,2167,832,https://www.intensivregister.de/api/public/reporting/laendertabelle
1649196322,24513,20653,3860,2166,831,https://www.intensivregister.de/api/public/reporting/laendertabelle
1649199930,24513,20654,3859,2166,832,https://www.intensivregister.de/api/public/reporting/laendertabelle
1649203526,24517,20655,3862,2166,832,https://www.intensivregister.de/api/public/reporting/laendertabelle
1649207128,24512,20660,3852,2168,832,https://www.intensivregister.de/api/public/reporting/laendertabelle
1649210720,24514,20652,3862,2166,835,https://www.intensivregister.de/api/public/reporting/laendertabelle
1649214315,24514,20658,3856,2150,828,https://www.intensivregister.de/api/public/reporting/laendertabelle
1649221543,24526,20702,3824,2136,814,https://www.intensivregister.de/api/public/reporting/laendertabelle
1649225118,24508,20704,3804,2125,824,https://www.intensivregister.de/api/public/reporting/laendertabelle
1649228729,24518,20750,3768,2120,836,https://www.intensivregister.de/api/public/reporting/laendertabelle
1649235931,24552,20781,3771,2112,832,https://www.intensivregister.de/api/public/reporting/laendertabelle
1649239517,24551,20773,3778,2113,834,https://www.intensivregister.de/api/public/reporting/laendertabelle
1649243123,24553,20771,3782,2113,834,https://www.intensivregister.de/api/public/reporting/laendertabelle
1649246718,24554,20774,3780,2112,833,https://www.intensivregister.de/api/public/reporting/laendertabelle
1649250357,24554,20784,3770,2115,833,https://www.intensivregister.de/api/public/reporting/laendertabelle
1649261119,24554,20785,3769,2115,833,https://www.intensivregister.de/api/public/reporting/laendertabelle
1649264723,24554,20784,3770,2115,833,https://www.intensivregister.de/api/public/reporting/laendertabelle
1649279118,24552,20782,3770,2114,833,https://www.intensivregister.de/api/public/reporting/laendertabelle
1649286317,24553,20778,3775,2113,833,https://www.intensivregister.de/api/public/reporting/laendertabelle
1649289920,24553,20789,3764,2113,833,https://www.intensivregister.de/api/public/reporting/laendertabelle
1649293535,24557,20793,3764,2113,836,https://www.intensivregister.de/api/public/reporting/laendertabelle
1649297117,24557,20788,3769,2110,833,https://www.intensivregister.de/api/public/reporting/laendertabelle
1649300720,24553,20766,3787,2107,831,https://www.intensivregister.de/api/public/reporting/laendertabelle
1649304334,24542,20797,3745,2097,825,https://www.intensivregister.de/api/public/reporting/laendertabelle
1649307926,24548,20808,3740,2071,819,https://www.intensivregister.de/api/public/reporting/laendertabelle
1649311531,24553,20839,3714,2074,813,https://www.intensivregister.de/api/public/reporting/laendertabelle
1649318732,24564,20838,3726,2052,810,https://www.intensivregister.de/api/public/reporting/laendertabelle
1649322328,24564,20833,3731,2052,809,https://www.intensivregister.de/api/public/reporting/laendertabelle
1649325923,24538,20811,3727,2052,806,https://www.intensivregister.de/api/public/reporting/laendertabelle
1649329529,24538,20815,3723,2052,805,https://www.intensivregister.de/api/public/reporting/laendertabelle
1649333122,24539,20806,3733,2048,804,https://www.intensivregister.de/api/public/reporting/laendertabelle
1649336728,24539,20804,3735,2048,804,https://www.intensivregister.de/api/public/reporting/laendertabelle
1649343931,24539,20798,3741,2049,806,https://www.intensivregister.de/api/public/reporting/laendertabelle
1649351121,24539,20799,3740,2049,806,https://www.intensivregister.de/api/public/reporting/laendertabelle
1649354715,24546,20804,3742,2049,806,https://www.intensivregister.de/api/public/reporting/laendertabelle
1649361921,24546,20806,3740,2049,806,https://www.intensivregister.de/api/public/reporting/laendertabelle
1649369118,24539,20797,3742,2050,806,https://www.intensivregister.de/api/public/reporting/laendertabelle
1649376324,24539,20799,3740,2049,806,https://www.intensivregister.de/api/public/reporting/laendertabelle
1649379916,24538,20800,3738,2049,805,https://www.intensivregister.de/api/public/reporting/laendertabelle
1649383520,24535,20803,3732,2042,800,https://www.intensivregister.de/api/public/reporting/laendertabelle
1649387114,24535,20816,3719,2035,796,https://www.intensivregister.de/api/public/reporting/laendertabelle
1649394317,24494,20712,3782,2048,791,https://www.intensivregister.de/api/public/reporting/laendertabelle
1649397923,24462,20682,3780,2029,797,https://www.intensivregister.de/api/public/reporting/laendertabelle
1649401528,24455,20675,3780,2040,784,https://www.intensivregister.de/api/public/reporting/laendertabelle
1649405116,24422,20649,3773,2029,780,https://www.intensivregister.de/api/public/reporting/laendertabelle
1649412315,24423,20653,3770,2025,782,https://www.intensivregister.de/api/public/reporting/laendertabelle
1649415920,24397,20631,3766,2025,782,https://www.intensivregister.de/api/public/reporting/laendertabelle
1649423116,24394,20631,3763,2020,783,https://www.intensivregister.de/api/public/reporting/laendertabelle
1649430323,24395,20633,3762,2018,782,https://www.intensivregister.de/api/public/reporting/laendertabelle
1649433931,24395,20633,3762,2019,783,https://www.intensivregister.de/api/public/reporting/laendertabelle
1649444723,24392,20633,3759,2019,783,https://www.intensivregister.de/api/public/reporting/laendertabelle
1649448327,24392,20631,3761,2019,783,https://www.intensivregister.de/api/public/reporting/laendertabelle
1649451929,24388,20611,3777,2019,784,https://www.intensivregister.de/api/public/reporting/laendertabelle
1649455524,24387,20612,3775,2019,784,https://www.intensivregister.de/api/public/reporting/laendertabelle
1649462728,24386,20620,3766,2017,785,https://www.intensivregister.de/api/public/reporting/laendertabelle
1649466319,24384,20617,3767,2016,782,https://www.intensivregister.de/api/public/reporting/laendertabelle
1649469923,24383,20616,3767,2015,782,https://www.intensivregister.de/api/public/reporting/laendertabelle
1649473514,24391,20603,3788,2011,772,https://www.intensivregister.de/api/public/reporting/laendertabelle
1649477129,24360,20544,3816,2004,776,https://www.intensivregister.de/api/public/reporting/laendertabelle
1649480723,24318,20474,3844,1995,766,https://www.intensivregister.de/api/public/reporting/laendertabelle
1649487930,24287,20347,3940,1985,762,https://www.intensivregister.de/api/public/reporting/laendertabelle
1649491515,24271,20285,3986,1986,764,https://www.intensivregister.de/api/public/reporting/laendertabelle
1649495120,24276,20300,3976,1989,768,https://www.intensivregister.de/api/public/reporting/laendertabelle
1649498714,24276,20295,3981,1990,769,https://www.intensivregister.de/api/public/reporting/laendertabelle
1649502342,24272,20294,3978,1989,769,https://www.intensivregister.de/api/public/reporting/laendertabelle
1649505917,24273,20292,3981,1989,769,https://www.intensivregister.de/api/public/reporting/laendertabelle
1649513130,24272,20289,3983,1991,769,https://www.intensivregister.de/api/public/reporting/laendertabelle
1649516716,24272,20290,3982,1991,769,https://www.intensivregister.de/api/public/reporting/laendertabelle
1649523916,24271,20284,3987,1991,769,https://www.intensivregister.de/api/public/reporting/laendertabelle
1649527515,24269,20282,3987,1991,769,https://www.intensivregister.de/api/public/reporting/laendertabelle
1649538329,24268,20274,3994,1994,769,https://www.intensivregister.de/api/public/reporting/laendertabelle
1649541918,24266,20268,3998,1992,769,https://www.intensivregister.de/api/public/reporting/laendertabelle
1649545517,24254,20257,3997,1992,769,https://www.intensivregister.de/api/public/reporting/laendertabelle
1649556328,24251,20252,3999,1989,770,https://www.intensivregister.de/api/public/reporting/laendertabelle
1649559923,24249,20221,4028,1982,769,https://www.intensivregister.de/api/public/reporting/laendertabelle
1649563518,24233,20195,4038,1979,770,https://www.intensivregister.de/api/public/reporting/laendertabelle
1649567122,24213,20107,4106,1980,770,https://www.intensivregister.de/api/public/reporting/laendertabelle
1649570729,24175,20036,4139,1995,765,https://www.intensivregister.de/api/public/reporting/laendertabelle
1649577921,24110,19900,4210,1991,759,https://www.intensivregister.de/api/public/reporting/laendertabelle
1649581527,24126,19908,4218,1990,758,https://www.intensivregister.de/api/public/reporting/laendertabelle
1649588728,24126,19895,4231,1989,758,https://www.intensivregister.de/api/public/reporting/laendertabelle
1649595929,24125,19891,4234,1987,759,https://www.intensivregister.de/api/public/reporting/laendertabelle
1649599516,24126,19892,4234,1987,759,https://www.intensivregister.de/api/public/reporting/laendertabelle
1649610314,24126,19891,4235,1988,759,https://www.intensivregister.de/api/public/reporting/laendertabelle
1649613921,24099,19872,4227,1989,758,https://www.intensivregister.de/api/public/reporting/laendertabelle
1649624728,24101,19885,4216,1991,758,https://www.intensivregister.de/api/public/reporting/laendertabelle
1649631931,24100,19871,4229,1990,759,https://www.intensivregister.de/api/public/reporting/laendertabelle
1649639131,24102,19880,4222,1990,759,https://www.intensivregister.de/api/public/reporting/laendertabelle
1649642714,24118,19892,4226,1993,758,https://www.intensivregister.de/api/public/reporting/laendertabelle
1649649921,24127,19899,4228,1996,754,https://www.intensivregister.de/api/public/reporting/laendertabelle
1649653528,24173,19961,4212,1994,748,https://www.intensivregister.de/api/public/reporting/laendertabelle
1649657128,24236,20013,4223,1988,758,https://www.intensivregister.de/api/public/reporting/laendertabelle
1649660727,24250,20039,4211,1981,762,https://www.intensivregister.de/api/public/reporting/laendertabelle
1649664317,24279,20063,4216,1981,762,https://www.intensivregister.de/api/public/reporting/laendertabelle
1649667916,24279,20072,4207,1984,762,https://www.intensivregister.de/api/public/reporting/laendertabelle
1649675133,24279,20076,4203,1981,761,https://www.intensivregister.de/api/public/reporting/laendertabelle
1649682321,24279,20074,4205,1980,761,https://www.intensivregister.de/api/public/reporting/laendertabelle
1649689529,24268,20067,4201,1980,761,https://www.intensivregister.de/api/public/reporting/laendertabelle
1649693114,24268,20067,4201,1979,761,https://www.intensivregister.de/api/public/reporting/laendertabelle
1649703921,24268,20064,4204,1981,760,https://www.intensivregister.de/api/public/reporting/laendertabelle
1649711121,24269,20071,4198,1981,758,https://www.intensivregister.de/api/public/reporting/laendertabelle
1649714728,24268,20072,4196,1981,758,https://www.intensivregister.de/api/public/reporting/laendertabelle
1649718315,24269,20073,4196,1980,758,https://www.intensivregister.de/api/public/reporting/laendertabelle
1649721922,24266,20074,4192,1980,758,https://www.intensivregister.de/api/public/reporting/laendertabelle
1649725516,24263,20076,4187,1978,757,https://www.intensivregister.de/api/public/reporting/laendertabelle
1649732718,24285,20141,4144,1974,765,https://www.intensivregister.de/api/public/reporting/laendertabelle
1649736321,24290,20201,4089,1929,754,https://www.intensivregister.de/api/public/reporting/laendertabelle
1649739924,24360,20322,4038,1922,755,https://www.intensivregister.de/api/public/reporting/laendertabelle
1649743523,24387,20399,3988,1922,757,https://www.intensivregister.de/api/public/reporting/laendertabelle
1649750729,24359,20390,3969,1910,756,https://www.intensivregister.de/api/public/reporting/laendertabelle
1649757928,24355,20384,3971,1905,754,https://www.intensivregister.de/api/public/reporting/laendertabelle
1649761525,24352,20385,3967,1911,753,https://www.intensivregister.de/api/public/reporting/laendertabelle
1649765122,24352,20384,3968,1911,753,https://www.intensivregister.de/api/public/reporting/laendertabelle
1649768715,24352,20380,3972,1910,753,https://www.intensivregister.de/api/public/reporting/laendertabelle
1649772320,24354,20381,3973,1911,754,https://www.intensivregister.de/api/public/reporting/laendertabelle
1649775925,24354,20382,3972,1910,754,https://www.intensivregister.de/api/public/reporting/laendertabelle
1649786733,24354,20382,3972,1909,755,https://www.intensivregister.de/api/public/reporting/laendertabelle
1649790318,24354,20381,3973,1909,755,https://www.intensivregister.de/api/public/reporting/laendertabelle
1649797531,24353,20389,3964,1911,756,https://www.intensivregister.de/api/public/reporting/laendertabelle
1649801116,24349,20384,3965,1911,755,https://www.intensivregister.de/api/public/reporting/laendertabelle
1649804722,24350,20388,3962,1910,755,https://www.intensivregister.de/api/public/reporting/laendertabelle
1649808319,24353,20389,3964,1909,755,https://www.intensivregister.de/api/public/reporting/laendertabelle
1649815531,24358,20382,3976,1899,753,https://www.intensivregister.de/api/public/reporting/laendertabelle
1649822723,24335,20397,3938,1874,748,https://www.intensivregister.de/api/public/reporting/laendertabelle
1649829920,24336,20478,3858,1843,734,https://www.intensivregister.de/api/public/reporting/laendertabelle
1649833520,24329,20494,3835,1847,738,https://www.intensivregister.de/api/public/reporting/laendertabelle
1649840726,24353,20506,3847,1848,739,https://www.intensivregister.de/api/public/reporting/laendertabelle
1649844324,24345,20497,3848,1850,739,https://www.intensivregister.de/api/public/reporting/laendertabelle
1649851531,24343,20500,3843,1847,738,https://www.intensivregister.de/api/public/reporting/laendertabelle
1649858733,24354,20510,3844,1845,738,https://www.intensivregister.de/api/public/reporting/laendertabelle
1649873125,24354,20511,3843,1845,738,https://www.intensivregister.de/api/public/reporting/laendertabelle
1649883927,24368,20510,3858,1844,738,https://www.intensivregister.de/api/public/reporting/laendertabelle
1649891132,24370,20498,3872,1842,736,https://www.intensivregister.de/api/public/reporting/laendertabelle
1649894727,24370,20499,3871,1841,736,https://www.intensivregister.de/api/public/reporting/laendertabelle
1649898349,24368,20499,3869,1841,736,https://www.intensivregister.de/api/public/reporting/laendertabelle
1649905531,24365,20508,3857,1827,737,https://www.intensivregister.de/api/public/reporting/laendertabelle
1649912724,24363,20405,3958,1807,719,https://www.intensivregister.de/api/public/reporting/laendertabelle
1649916331,24368,20386,3982,1817,718,https://www.intensivregister.de/api/public/reporting/laendertabelle
1649919930,24368,20399,3969,1821,718,https://www.intensivregister.de/api/public/reporting/laendertabelle
1649927125,24364,20385,3979,1815,711,https://www.intensivregister.de/api/public/reporting/laendertabelle
1649930733,24364,20382,3982,1815,710,https://www.intensivregister.de/api/public/reporting/laendertabelle
1649937929,24363,20382,3981,1813,710,https://www.intensivregister.de/api/public/reporting/laendertabelle
1649945134,24361,20382,3979,1812,709,https://www.intensivregister.de/api/public/reporting/laendertabelle
1649959528,24354,20378,3976,1813,709,https://www.intensivregister.de/api/public/reporting/laendertabelle
1649966730,24355,20376,3979,1814,709,https://www.intensivregister.de/api/public/reporting/laendertabelle
1649970326,24353,20370,3983,1815,709,https://www.intensivregister.de/api/public/reporting/laendertabelle
1649977529,24353,20366,3987,1815,709,https://www.intensivregister.de/api/public/reporting/laendertabelle
1649981116,24354,20364,3990,1813,709,https://www.intensivregister.de/api/public/reporting/laendertabelle
1649984734,24353,20361,3992,1813,709,https://www.intensivregister.de/api/public/reporting/laendertabelle
1649988319,24353,20369,3984,1813,708,https://www.intensivregister.de/api/public/reporting/laendertabelle
1649991927,24337,20349,3988,1817,711,https://www.intensivregister.de/api/public/reporting/laendertabelle
1649995524,24331,20315,4016,1818,717,https://www.intensivregister.de/api/public/reporting/laendertabelle
1649999119,24270,20202,4068,1822,713,https://www.intensivregister.de/api/public/reporting/laendertabelle
1650002724,24244,20117,4127,1807,719,https://www.intensivregister.de/api/public/reporting/laendertabelle
1650006322,24267,20111,4156,1806,721,https://www.intensivregister.de/api/public/reporting/laendertabelle
1650013526,24256,20063,4193,1791,713,https://www.intensivregister.de/api/public/reporting/laendertabelle
1650017134,24250,20061,4189,1791,713,https://www.intensivregister.de/api/public/reporting/laendertabelle
1650024326,24250,20055,4195,1791,716,https://www.intensivregister.de/api/public/reporting/laendertabelle
1650027924,24250,20056,4194,1791,716,https://www.intensivregister.de/api/public/reporting/laendertabelle
1650035118,24248,20053,4195,1789,717,https://www.intensivregister.de/api/public/reporting/laendertabelle
1650038724,24248,20051,4197,1789,717,https://www.intensivregister.de/api/public/reporting/laendertabelle
1650045932,24248,20044,4204,1786,716,https://www.intensivregister.de/api/public/reporting/laendertabelle
1650053133,24248,20042,4206,1785,716,https://www.intensivregister.de/api/public/reporting/laendertabelle
1650060331,24252,20050,4202,1783,716,https://www.intensivregister.de/api/public/reporting/laendertabelle
1650063926,24251,20051,4200,1782,716,https://www.intensivregister.de/api/public/reporting/laendertabelle
1650067520,24249,20047,4202,1782,716,https://www.intensivregister.de/api/public/reporting/laendertabelle
1650071124,24254,20042,4212,1780,716,https://www.intensivregister.de/api/public/reporting/laendertabelle
1650074731,24253,20032,4221,1778,715,https://www.intensivregister.de/api/public/reporting/laendertabelle
1650078326,24245,20018,4227,1777,717,https://www.intensivregister.de/api/public/reporting/laendertabelle
1650081930,24242,19908,4334,1773,714,https://www.intensivregister.de/api/public/reporting/laendertabelle
1650089128,24169,19646,4523,1739,693,https://www.intensivregister.de/api/public/reporting/laendertabelle
1650092722,24167,19579,4588,1740,692,https://www.intensivregister.de/api/public/reporting/laendertabelle
1650096328,24157,19517,4640,1743,693,https://www.intensivregister.de/api/public/reporting/laendertabelle
1650099923,24151,19506,4645,1746,694,https://www.intensivregister.de/api/public/reporting/laendertabelle
1650107131,24153,19500,4653,1748,694,https://www.intensivregister.de/api/public/reporting/laendertabelle
1650114331,24160,19507,4653,1753,694,https://www.intensivregister.de/api/public/reporting/laendertabelle
1650121531,24160,19510,4650,1753,694,https://www.intensivregister.de/api/public/reporting/laendertabelle
1650128731,24160,19512,4648,1755,695,https://www.intensivregister.de/api/public/reporting/laendertabelle
1650135921,24160,19513,4647,1755,695,https://www.intensivregister.de/api/public/reporting/laendertabelle
1650139526,24158,19511,4647,1752,697,https://www.intensivregister.de/api/public/reporting/laendertabelle
1650143133,24158,19499,4659,1752,698,https://www.intensivregister.de/api/public/reporting/laendertabelle
1650150323,24160,19495,4665,1752,698,https://www.intensivregister.de/api/public/reporting/laendertabelle
1650153927,24158,19492,4666,1750,698,https://www.intensivregister.de/api/public/reporting/laendertabelle
1650157522,24158,19496,4662,1751,699,https://www.intensivregister.de/api/public/reporting/laendertabelle
1650161134,24155,19493,4662,1752,699,https://www.intensivregister.de/api/public/reporting/laendertabelle
1650164724,24155,19499,4656,1751,699,https://www.intensivregister.de/api/public/reporting/laendertabelle
1650168326,24145,19492,4653,1761,700,https://www.intensivregister.de/api/public/reporting/laendertabelle
1650171929,24143,19438,4705,1760,701,https://www.intensivregister.de/api/public/reporting/laendertabelle
1650175519,24143,19453,4690,1756,705,https://www.intensivregister.de/api/public/reporting/laendertabelle
1650179131,24137,19379,4758,1770,703,https://www.intensivregister.de/api/public/reporting/laendertabelle
1650182733,24126,19370,4756,1770,702,https://www.intensivregister.de/api/public/reporting/laendertabelle
1650186315,24116,19361,4755,1771,703,https://www.intensivregister.de/api/public/reporting/laendertabelle
1650189917,24116,19364,4752,1771,703,https://www.intensivregister.de/api/public/reporting/laendertabelle
1650197131,24112,19354,4758,1770,705,https://www.intensivregister.de/api/public/reporting/laendertabelle
1650200733,24113,19351,4762,1770,705,https://www.intensivregister.de/api/public/reporting/laendertabelle
1650204324,24113,19350,4763,1771,706,https://www.intensivregister.de/api/public/reporting/laendertabelle
1650211516,24113,19347,4766,1772,706,https://www.intensivregister.de/api/public/reporting/laendertabelle
1650215127,24113,19348,4765,1772,706,https://www.intensivregister.de/api/public/reporting/laendertabelle
1650218729,24113,19349,4764,1774,706,https://www.intensivregister.de/api/public/reporting/laendertabelle
1650225931,24114,19347,4767,1773,706,https://www.intensivregister.de/api/public/reporting/laendertabelle
1650229531,24118,19337,4781,1772,705,https://www.intensivregister.de/api/public/reporting/laendertabelle
1650233122,24120,19332,4788,1770,703,https://www.intensivregister.de/api/public/reporting/laendertabelle
1650240324,24117,19331,4786,1770,703,https://www.intensivregister.de/api/public/reporting/laendertabelle
1650243916,24117,19324,4793,1769,703,https://www.intensivregister.de/api/public/reporting/laendertabelle
1650247531,24116,19320,4796,1769,703,https://www.intensivregister.de/api/public/reporting/laendertabelle
1650251114,24126,19331,4795,1773,704,https://www.intensivregister.de/api/public/reporting/laendertabelle
1650254726,24127,19297,4830,1766,703,https://www.intensivregister.de/api/public/reporting/laendertabelle
1650258319,24138,19312,4826,1771,699,https://www.intensivregister.de/api/public/reporting/laendertabelle
1650261922,24126,19321,4805,1773,703,https://www.intensivregister.de/api/public/reporting/laendertabelle
1650265526,24130,19335,4795,1767,695,https://www.intensivregister.de/api/public/reporting/laendertabelle
1650269125,24128,19337,4791,1761,697,https://www.intensivregister.de/api/public/reporting/laendertabelle
1650276323,24144,19349,4795,1766,696,https://www.intensivregister.de/api/public/reporting/laendertabelle
1650279930,24144,19343,4801,1765,697,https://www.intensivregister.de/api/public/reporting/laendertabelle
1650283527,24143,19344,4799,1765,697,https://www.intensivregister.de/api/public/reporting/laendertabelle
1650287131,24144,19344,4800,1764,696,https://www.intensivregister.de/api/public/reporting/laendertabelle
1650294326,24142,19337,4805,1763,697,https://www.intensivregister.de/api/public/reporting/laendertabelle
1650301527,24142,19339,4803,1763,697,https://www.intensivregister.de/api/public/reporting/laendertabelle
1650308718,24142,19338,4804,1762,697,https://www.intensivregister.de/api/public/reporting/laendertabelle
1650315931,24144,19344,4800,1759,695,https://www.intensivregister.de/api/public/reporting/laendertabelle
1650323125,24146,19343,4803,1760,695,https://www.intensivregister.de/api/public/reporting/laendertabelle
1650326724,24148,19347,4801,1761,695,https://www.intensivregister.de/api/public/reporting/laendertabelle
1650330329,24148,19346,4802,1761,695,https://www.intensivregister.de/api/public/reporting/laendertabelle
1650333917,24157,19374,4783,1763,697,https://www.intensivregister.de/api/public/reporting/laendertabelle
1650337514,24164,19438,4726,1778,694,https://www.intensivregister.de/api/public/reporting/laendertabelle
1650341134,24227,19534,4693,1782,690,https://www.intensivregister.de/api/public/reporting/laendertabelle
1650344732,24295,19654,4641,1798,697,https://www.intensivregister.de/api/public/reporting/laendertabelle
1650351930,24361,19793,4568,1800,691,https://www.intensivregister.de/api/public/reporting/laendertabelle
1650355530,24363,19801,4562,1799,693,https://www.intensivregister.de/api/public/reporting/laendertabelle
1650359120,24357,19807,4550,1797,693,https://www.intensivregister.de/api/public/reporting/laendertabelle
1650366319,24349,19803,4546,1798,693,https://www.intensivregister.de/api/public/reporting/laendertabelle
1650369931,24356,19810,4546,1798,693,https://www.intensivregister.de/api/public/reporting/laendertabelle
1650373529,24356,19816,4540,1799,693,https://www.intensivregister.de/api/public/reporting/laendertabelle
1650377117,24357,19818,4539,1799,694,https://www.intensivregister.de/api/public/reporting/laendertabelle
1650384321,24357,19821,4536,1798,695,https://www.intensivregister.de/api/public/reporting/laendertabelle
1650398729,24357,19822,4535,1799,695,https://www.intensivregister.de/api/public/reporting/laendertabelle
1650402325,24362,19820,4542,1798,695,https://www.intensivregister.de/api/public/reporting/laendertabelle
1650405933,24360,19817,4543,1797,696,https://www.intensivregister.de/api/public/reporting/laendertabelle
1650416720,24355,19821,4534,1797,696,https://www.intensivregister.de/api/public/reporting/laendertabelle
1650420322,24354,19831,4523,1796,697,https://www.intensivregister.de/api/public/reporting/laendertabelle
1650423924,24367,19874,4493,1785,699,https://www.intensivregister.de/api/public/reporting/laendertabelle
1650427527,24378,19999,4379,1771,701,https://www.intensivregister.de/api/public/reporting/laendertabelle
1650431119,24391,20085,4306,1758,706,https://www.intensivregister.de/api/public/reporting/laendertabelle
1650434722,24397,20193,4204,1733,700,https://www.intensivregister.de/api/public/reporting/laendertabelle
1650441919,24380,20253,4127,1732,699,https://www.intensivregister.de/api/public/reporting/laendertabelle
1650449128,24376,20260,4116,1730,700,https://www.intensivregister.de/api/public/reporting/laendertabelle
1650452733,24376,20261,4115,1730,700,https://www.intensivregister.de/api/public/reporting/laendertabelle
1650456318,24374,20257,4117,1731,700,https://www.intensivregister.de/api/public/reporting/laendertabelle
1650459921,24377,20267,4110,1731,700,https://www.intensivregister.de/api/public/reporting/laendertabelle
1650463515,24377,20267,4110,1733,700,https://www.intensivregister.de/api/public/reporting/laendertabelle
1650470731,24377,20268,4109,1733,700,https://www.intensivregister.de/api/public/reporting/laendertabelle
1650481529,24375,20265,4110,1733,700,https://www.intensivregister.de/api/public/reporting/laendertabelle
1650485132,24375,20268,4107,1734,700,https://www.intensivregister.de/api/public/reporting/laendertabelle
1650488725,24373,20267,4106,1732,700,https://www.intensivregister.de/api/public/reporting/laendertabelle
1650495924,24375,20264,4111,1730,700,https://www.intensivregister.de/api/public/reporting/laendertabelle
1650499528,24378,20266,4112,1730,700,https://www.intensivregister.de/api/public/reporting/laendertabelle
1650503130,24378,20268,4110,1731,700,https://www.intensivregister.de/api/public/reporting/laendertabelle
1650506733,24380,20255,4125,1730,699,https://www.intensivregister.de/api/public/reporting/laendertabelle
1650510316,24388,20319,4069,1704,689,https://www.intensivregister.de/api/public/reporting/laendertabelle
1650513921,24382,20356,4026,1680,675,https://www.intensivregister.de/api/public/reporting/laendertabelle
1650517524,24366,20373,3993,1668,667,https://www.intensivregister.de/api/public/reporting/laendertabelle
1650524730,24375,20429,3946,1654,659,https://www.intensivregister.de/api/public/reporting/laendertabelle
1650528332,24393,20417,3976,1647,657,https://www.intensivregister.de/api/public/reporting/laendertabelle
1650531925,24387,20407,3980,1647,658,https://www.intensivregister.de/api/public/reporting/laendertabelle
1650539131,24386,20407,3979,1644,658,https://www.intensivregister.de/api/public/reporting/laendertabelle
1650542732,24386,20403,3983,1644,658,https://www.intensivregister.de/api/public/reporting/laendertabelle
1650549920,24375,20387,3988,1643,655,https://www.intensivregister.de/api/public/reporting/laendertabelle
1650553524,24374,20387,3987,1644,655,https://www.intensivregister.de/api/public/reporting/laendertabelle
1650560728,24374,20388,3986,1644,655,https://www.intensivregister.de/api/public/reporting/laendertabelle
1650571530,24374,20386,3988,1643,654,https://www.intensivregister.de/api/public/reporting/laendertabelle
1650575115,24374,20387,3987,1643,652,https://www.intensivregister.de/api/public/reporting/laendertabelle
1650578716,24372,20388,3984,1643,651,https://www.intensivregister.de/api/public/reporting/laendertabelle
1650582320,24374,20390,3984,1644,651,https://www.intensivregister.de/api/public/reporting/laendertabelle
1650585932,24374,20393,3981,1643,651,https://www.intensivregister.de/api/public/reporting/laendertabelle
1650589517,24376,20400,3976,1643,651,https://www.intensivregister.de/api/public/reporting/laendertabelle
1650593120,24367,20399,3968,1640,650,https://www.intensivregister.de/api/public/reporting/laendertabelle
1650596722,24368,20412,3956,1642,650,https://www.intensivregister.de/api/public/reporting/laendertabelle
1650600330,24376,20414,3962,1644,644,https://www.intensivregister.de/api/public/reporting/laendertabelle
1650607530,24346,20316,4030,1635,636,https://www.intensivregister.de/api/public/reporting/laendertabelle
1650611132,24336,20319,4017,1618,632,https://www.intensivregister.de/api/public/reporting/laendertabelle
1650614722,24330,20317,4013,1613,628,https://www.intensivregister.de/api/public/reporting/laendertabelle
1650618324,24330,20329,4001,1618,630,https://www.intensivregister.de/api/public/reporting/laendertabelle
1650621933,24326,20333,3993,1618,630,https://www.intensivregister.de/api/public/reporting/laendertabelle
1650625513,24325,20326,3999,1617,631,https://www.intensivregister.de/api/public/reporting/laendertabelle
1650632715,24325,20321,4004,1615,631,https://www.intensivregister.de/api/public/reporting/laendertabelle
1650639934,24325,20324,4001,1616,631,https://www.intensivregister.de/api/public/reporting/laendertabelle
1650654330,24325,20325,4000,1616,631,https://www.intensivregister.de/api/public/reporting/laendertabelle
1650661529,24324,20327,3997,1613,631,https://www.intensivregister.de/api/public/reporting/laendertabelle
1650665127,24325,20327,3998,1613,631,https://www.intensivregister.de/api/public/reporting/laendertabelle
1650668716,24326,20333,3993,1613,631,https://www.intensivregister.de/api/public/reporting/laendertabelle
1650672333,24325,20330,3995,1613,630,https://www.intensivregister.de/api/public/reporting/laendertabelle
1650675922,24325,20336,3989,1613,630,https://www.intensivregister.de/api/public/reporting/laendertabelle
1650683125,24319,20333,3986,1616,632,https://www.intensivregister.de/api/public/reporting/laendertabelle
1650686714,24277,20259,4018,1611,633,https://www.intensivregister.de/api/public/reporting/laendertabelle
1650690325,24225,20162,4063,1596,622,https://www.intensivregister.de/api/public/reporting/laendertabelle
1650697525,24158,20023,4135,1614,632,https://www.intensivregister.de/api/public/reporting/laendertabelle
1650701125,24159,20007,4152,1615,637,https://www.intensivregister.de/api/public/reporting/laendertabelle
1650708334,24157,19982,4175,1614,636,https://www.intensivregister.de/api/public/reporting/laendertabelle
1650711931,24157,19980,4177,1614,635,https://www.intensivregister.de/api/public/reporting/laendertabelle
1650715518,24157,19978,4179,1614,635,https://www.intensivregister.de/api/public/reporting/laendertabelle
1650719127,24157,19979,4178,1614,635,https://www.intensivregister.de/api/public/reporting/laendertabelle
1650722715,24153,19976,4177,1613,635,https://www.intensivregister.de/api/public/reporting/laendertabelle
1650733524,24150,19975,4175,1613,635,https://www.intensivregister.de/api/public/reporting/laendertabelle
1650737133,24148,19975,4173,1613,634,https://www.intensivregister.de/api/public/reporting/laendertabelle
1650740732,24145,19974,4171,1612,634,https://www.intensivregister.de/api/public/reporting/laendertabelle
1650744330,24138,19969,4169,1612,634,https://www.intensivregister.de/api/public/reporting/laendertabelle
1650747918,24138,19962,4176,1613,634,https://www.intensivregister.de/api/public/reporting/laendertabelle
1650751517,24132,19950,4182,1613,634,https://www.intensivregister.de/api/public/reporting/laendertabelle
1650758716,24132,19949,4183,1616,635,https://www.intensivregister.de/api/public/reporting/laendertabelle
1650762332,24132,19945,4187,1615,634,https://www.intensivregister.de/api/public/reporting/laendertabelle
1650769529,24134,19927,4207,1609,638,https://www.intensivregister.de/api/public/reporting/laendertabelle
1650773127,24124,19899,4225,1597,635,https://www.intensivregister.de/api/public/reporting/laendertabelle
1650776719,24102,19809,4293,1597,644,https://www.intensivregister.de/api/public/reporting/laendertabelle
1650783919,24080,19708,4372,1569,637,https://www.intensivregister.de/api/public/reporting/laendertabelle
1650787531,24084,19689,4395,1571,633,https://www.intensivregister.de/api/public/reporting/laendertabelle
1650791141,24083,19693,4390,1574,631,https://www.intensivregister.de/api/public/reporting/laendertabelle
1650794731,24083,19688,4395,1574,632,https://www.intensivregister.de/api/public/reporting/laendertabelle
1650798333,24083,19685,4398,1574,632,https://www.intensivregister.de/api/public/reporting/laendertabelle
1650805515,24080,19680,4400,1575,631,https://www.intensivregister.de/api/public/reporting/laendertabelle
1650812728,24080,19681,4399,1575,631,https://www.intensivregister.de/api/public/reporting/laendertabelle
1650819921,24080,19682,4398,1574,631,https://www.intensivregister.de/api/public/reporting/laendertabelle
1650834333,24079,19680,4399,1576,630,https://www.intensivregister.de/api/public/reporting/laendertabelle
1650837913,24078,19677,4401,1576,630,https://www.intensivregister.de/api/public/reporting/laendertabelle
1650841516,24078,19680,4398,1574,630,https://www.intensivregister.de/api/public/reporting/laendertabelle
1650845117,24078,19684,4394,1574,630,https://www.intensivregister.de/api/public/reporting/laendertabelle
1650848718,24080,19685,4395,1574,630,https://www.intensivregister.de/api/public/reporting/laendertabelle
1650855921,24106,19719,4387,1570,628,https://www.intensivregister.de/api/public/reporting/laendertabelle
1650859523,24183,19763,4420,1570,624,https://www.intensivregister.de/api/public/reporting/laendertabelle
1650863126,24248,19835,4413,1573,616,https://www.intensivregister.de/api/public/reporting/laendertabelle
1650870333,24133,19751,4382,1573,615,https://www.intensivregister.de/api/public/reporting/laendertabelle
1650873925,24139,19767,4372,1578,618,https://www.intensivregister.de/api/public/reporting/laendertabelle
1650881123,24148,19784,4364,1578,617,https://www.intensivregister.de/api/public/reporting/laendertabelle
1650884718,24154,19791,4363,1577,616,https://www.intensivregister.de/api/public/reporting/laendertabelle
1650888323,24156,19791,4365,1576,616,https://www.intensivregister.de/api/public/reporting/laendertabelle
1650891917,24156,19787,4369,1579,617,https://www.intensivregister.de/api/public/reporting/laendertabelle
1650895531,24155,19788,4367,1580,617,https://www.intensivregister.de/api/public/reporting/laendertabelle
1650899114,24155,19786,4369,1580,617,https://www.intensivregister.de/api/public/reporting/laendertabelle
1650920728,24160,19794,4366,1580,617,https://www.intensivregister.de/api/public/reporting/laendertabelle
1650931531,24162,19805,4357,1581,617,https://www.intensivregister.de/api/public/reporting/laendertabelle
1650935122,24162,19807,4355,1583,617,https://www.intensivregister.de/api/public/reporting/laendertabelle
1650938731,24168,19821,4347,1584,617,https://www.intensivregister.de/api/public/reporting/laendertabelle
1650942331,24176,19886,4290,1577,611,https://www.intensivregister.de/api/public/reporting/laendertabelle
1650945924,24201,20006,4195,1559,594,https://www.intensivregister.de/api/public/reporting/laendertabelle
1650953126,24258,20199,4059,1522,593,https://www.intensivregister.de/api/public/reporting/laendertabelle
1650956727,24287,20252,4035,1517,597,https://www.intensivregister.de/api/public/reporting/laendertabelle
1650960319,24288,20285,4003,1520,597,https://www.intensivregister.de/api/public/reporting/laendertabelle
1650967522,24284,20288,3996,1521,597,https://www.intensivregister.de/api/public/reporting/laendertabelle
1650971124,24284,20288,3996,1522,598,https://www.intensivregister.de/api/public/reporting/laendertabelle
1650985522,24284,20295,3989,1522,598,https://www.intensivregister.de/api/public/reporting/laendertabelle
1650999929,24284,20293,3991,1521,597,https://www.intensivregister.de/api/public/reporting/laendertabelle
1651007124,24287,20288,3999,1523,597,https://www.intensivregister.de/api/public/reporting/laendertabelle
1651010721,24288,20294,3994,1522,597,https://www.intensivregister.de/api/public/reporting/laendertabelle
1651014330,24290,20293,3997,1522,597,https://www.intensivregister.de/api/public/reporting/laendertabelle
1651021529,24289,20297,3992,1520,597,https://www.intensivregister.de/api/public/reporting/laendertabelle
1651025128,24293,20309,3984,1518,596,https://www.intensivregister.de/api/public/reporting/laendertabelle
1651028716,24312,20307,4005,1504,598,https://www.intensivregister.de/api/public/reporting/laendertabelle
1651035922,24302,20381,3921,1468,598,https://www.intensivregister.de/api/public/reporting/laendertabelle
1651039521,24326,20438,3888,1450,593,https://www.intensivregister.de/api/public/reporting/laendertabelle
1651046720,24316,20467,3849,1452,594,https://www.intensivregister.de/api/public/reporting/laendertabelle
1651046720,24324,20487,3837,1443,586,https://www.intensivregister.de/api/public/reporting/laendertabelle
1651050330,24337,20484,3853,1444,588,https://www.intensivregister.de/api/public/reporting/laendertabelle
1651057527,24337,20489,3848,1442,589,https://www.intensivregister.de/api/public/reporting/laendertabelle
1651061135,24337,20499,3838,1442,589,https://www.intensivregister.de/api/public/reporting/laendertabelle
1651068329,24337,20505,3832,1442,589,https://www.intensivregister.de/api/public/reporting/laendertabelle
1651089937,24337,20504,3833,1442,589,https://www.intensivregister.de/api/public/reporting/laendertabelle
1651093530,24338,20507,3831,1441,589,https://www.intensivregister.de/api/public/reporting/laendertabelle
1651097135,24337,20505,3832,1441,588,https://www.intensivregister.de/api/public/reporting/laendertabelle
1651100723,24337,20502,3835,1441,588,https://www.intensivregister.de/api/public/reporting/laendertabelle
1651107918,24338,20512,3826,1442,588,https://www.intensivregister.de/api/public/reporting/laendertabelle
1651111526,24339,20503,3836,1441,587,https://www.intensivregister.de/api/public/reporting/laendertabelle
1651118732,24333,20460,3873,1403,574,https://www.intensivregister.de/api/public/reporting/laendertabelle
1651125932,24324,20461,3863,1398,565,https://www.intensivregister.de/api/public/reporting/laendertabelle
1651129528,24324,20422,3902,1391,563,https://www.intensivregister.de/api/public/reporting/laendertabelle
1651133133,24295,20392,3903,1407,568,https://www.intensivregister.de/api/public/reporting/laendertabelle
1651136726,24296,20383,3913,1404,569,https://www.intensivregister.de/api/public/reporting/laendertabelle
1651140331,24295,20382,3913,1399,565,https://www.intensivregister.de/api/public/reporting/laendertabelle
1651143928,24295,20381,3914,1400,565,https://www.intensivregister.de/api/public/reporting/laendertabelle
1651147532,24295,20385,3910,1400,565,https://www.intensivregister.de/api/public/reporting/laendertabelle
1651154736,24295,20383,3912,1400,565,https://www.intensivregister.de/api/public/reporting/laendertabelle
1651165527,24296,20383,3913,1402,565,https://www.intensivregister.de/api/public/reporting/laendertabelle
1651176328,24297,20381,3916,1402,565,https://www.intensivregister.de/api/public/reporting/laendertabelle
1651179934,24293,20380,3913,1403,565,https://www.intensivregister.de/api/public/reporting/laendertabelle
1651183531,24296,20381,3915,1402,564,https://www.intensivregister.de/api/public/reporting/laendertabelle
1651187135,24293,20377,3916,1402,564,https://www.intensivregister.de/api/public/reporting/laendertabelle
1651190728,24294,20380,3914,1402,564,https://www.intensivregister.de/api/public/reporting/laendertabelle
1651194331,24295,20379,3916,1404,564,https://www.intensivregister.de/api/public/reporting/laendertabelle
1651197934,24294,20385,3909,1400,564,https://www.intensivregister.de/api/public/reporting/laendertabelle
1651205129,24268,20388,3880,1401,560,https://www.intensivregister.de/api/public/reporting/laendertabelle
1651212336,24219,20374,3845,1381,554,https://www.intensivregister.de/api/public/reporting/laendertabelle
1651219536,24199,20393,3806,1379,546,https://www.intensivregister.de/api/public/reporting/laendertabelle
1651223130,24196,20409,3787,1377,545,https://www.intensivregister.de/api/public/reporting/laendertabelle
1651226735,24194,20415,3779,1379,545,https://www.intensivregister.de/api/public/reporting/laendertabelle
1651230338,24195,20422,3773,1378,544,https://www.intensivregister.de/api/public/reporting/laendertabelle
1651233929,24188,20424,3764,1378,544,https://www.intensivregister.de/api/public/reporting/laendertabelle
1651237531,24185,20422,3763,1380,545,https://www.intensivregister.de/api/public/reporting/laendertabelle
1651241133,24183,20420,3763,1379,545,https://www.intensivregister.de/api/public/reporting/laendertabelle
1651248332,24183,20422,3761,1379,545,https://www.intensivregister.de/api/public/reporting/laendertabelle
1651255535,24183,20421,3762,1379,545,https://www.intensivregister.de/api/public/reporting/laendertabelle
1651262737,24182,20420,3762,1379,545,https://www.intensivregister.de/api/public/reporting/laendertabelle
1651266337,24185,20404,3781,1380,546,https://www.intensivregister.de/api/public/reporting/laendertabelle
1651269937,24184,20412,3772,1380,546,https://www.intensivregister.de/api/public/reporting/laendertabelle
1651280730,24184,20408,3776,1380,545,https://www.intensivregister.de/api/public/reporting/laendertabelle
1651284323,24182,20399,3783,1379,544,https://www.intensivregister.de/api/public/reporting/laendertabelle
1651287931,24180,20374,3806,1371,541,https://www.intensivregister.de/api/public/reporting/laendertabelle
1651295130,24127,20307,3820,1352,525,https://www.intensivregister.de/api/public/reporting/laendertabelle
1651298731,24102,20262,3840,1348,519,https://www.intensivregister.de/api/public/reporting/laendertabelle
1651302333,24087,20226,3861,1346,519,https://www.intensivregister.de/api/public/reporting/laendertabelle
1651305929,24079,20176,3903,1353,519,https://www.intensivregister.de/api/public/reporting/laendertabelle
1651309521,24076,20163,3913,1352,518,https://www.intensivregister.de/api/public/reporting/laendertabelle
1651313129,24078,20160,3918,1352,519,https://www.intensivregister.de/api/public/reporting/laendertabelle
1651316731,24076,20154,3922,1352,518,https://www.intensivregister.de/api/public/reporting/laendertabelle
1651323932,24038,20107,3931,1352,518,https://www.intensivregister.de/api/public/reporting/laendertabelle
1651327536,24035,20103,3932,1352,518,https://www.intensivregister.de/api/public/reporting/laendertabelle
1651331137,24035,20102,3933,1352,518,https://www.intensivregister.de/api/public/reporting/laendertabelle
1651334728,24035,20101,3934,1352,517,https://www.intensivregister.de/api/public/reporting/laendertabelle
1651341919,24035,20100,3935,1352,517,https://www.intensivregister.de/api/public/reporting/laendertabelle
1651349136,24036,20102,3934,1352,517,https://www.intensivregister.de/api/public/reporting/laendertabelle
1651352732,24029,20090,3939,1354,517,https://www.intensivregister.de/api/public/reporting/laendertabelle
1651356335,24008,20073,3935,1355,518,https://www.intensivregister.de/api/public/reporting/laendertabelle
1651359921,24008,20074,3934,1355,518,https://www.intensivregister.de/api/public/reporting/laendertabelle
1651363524,24009,20074,3935,1354,518,https://www.intensivregister.de/api/public/reporting/laendertabelle
1651367133,24007,20069,3938,1353,517,https://www.intensivregister.de/api/public/reporting/laendertabelle
1651370735,24006,20072,3934,1352,516,https://www.intensivregister.de/api/public/reporting/laendertabelle
1651374337,24004,20047,3957,1353,518,https://www.intensivregister.de/api/public/reporting/laendertabelle
1651377934,23985,19945,4040,1350,513,https://www.intensivregister.de/api/public/reporting/laendertabelle
1651381530,23972,19855,4117,1335,506,https://www.intensivregister.de/api/public/reporting/laendertabelle
1651388728,23933,19702,4231,1331,506,https://www.intensivregister.de/api/public/reporting/laendertabelle
1651392330,23928,19702,4226,1339,507,https://www.intensivregister.de/api/public/reporting/laendertabelle
1651395933,23927,19683,4244,1338,507,https://www.intensivregister.de/api/public/reporting/laendertabelle
1651399537,23923,19671,4252,1332,505,https://www.intensivregister.de/api/public/reporting/laendertabelle
1651406731,23925,19665,4260,1332,505,https://www.intensivregister.de/api/public/reporting/laendertabelle
1651410335,23925,19670,4255,1332,505,https://www.intensivregister.de/api/public/reporting/laendertabelle
1651413937,23925,19670,4255,1333,505,https://www.intensivregister.de/api/public/reporting/laendertabelle
1651417530,23925,19671,4254,1333,504,https://www.intensivregister.de/api/public/reporting/laendertabelle
1651424731,23926,19674,4252,1333,504,https://www.intensivregister.de/api/public/reporting/laendertabelle
1651431936,23926,19676,4250,1333,504,https://www.intensivregister.de/api/public/reporting/laendertabelle
1651435520,23926,19673,4253,1333,504,https://www.intensivregister.de/api/public/reporting/laendertabelle
1651439122,23925,19676,4249,1333,504,https://www.intensivregister.de/api/public/reporting/laendertabelle
1651442720,23925,19677,4248,1332,504,https://www.intensivregister.de/api/public/reporting/laendertabelle
1651446332,23925,19678,4247,1333,505,https://www.intensivregister.de/api/public/reporting/laendertabelle
1651453527,23932,19686,4246,1334,505,https://www.intensivregister.de/api/public/reporting/laendertabelle
1651457131,23936,19705,4231,1333,507,https://www.intensivregister.de/api/public/reporting/laendertabelle
1651460735,24002,19789,4213,1342,502,https://www.intensivregister.de/api/public/reporting/laendertabelle
1651467934,24129,19873,4256,1322,497,https://www.intensivregister.de/api/public/reporting/laendertabelle
1651471537,24204,19954,4250,1318,496,https://www.intensivregister.de/api/public/reporting/laendertabelle
1651478734,24244,19952,4292,1323,495,https://www.intensivregister.de/api/public/reporting/laendertabelle
1651482337,24244,19952,4292,1324,496,https://www.intensivregister.de/api/public/reporting/laendertabelle
1651489527,24243,19940,4303,1319,495,https://www.intensivregister.de/api/public/reporting/laendertabelle
1651496728,24243,19938,4305,1320,494,https://www.intensivregister.de/api/public/reporting/laendertabelle
1651514730,24243,19939,4304,1320,494,https://www.intensivregister.de/api/public/reporting/laendertabelle
1651521937,24243,19938,4305,1320,494,https://www.intensivregister.de/api/public/reporting/laendertabelle
1651525529,24245,19939,4306,1323,495,https://www.intensivregister.de/api/public/reporting/laendertabelle
1651529130,24251,19939,4312,1326,495,https://www.intensivregister.de/api/public/reporting/laendertabelle
1651536331,24255,19950,4305,1328,493,https://www.intensivregister.de/api/public/reporting/laendertabelle
1651539934,24255,19949,4306,1329,493,https://www.intensivregister.de/api/public/reporting/laendertabelle
1651543529,24262,19960,4302,1330,493,https://www.intensivregister.de/api/public/reporting/laendertabelle
1651550728,24325,20186,4139,1319,494,https://www.intensivregister.de/api/public/reporting/laendertabelle
1651554323,24342,20295,4047,1277,478,https://www.intensivregister.de/api/public/reporting/laendertabelle
1651561528,24391,20382,4009,1275,479,https://www.intensivregister.de/api/public/reporting/laendertabelle
1651565128,24401,20414,3987,1280,478,https://www.intensivregister.de/api/public/reporting/laendertabelle
1651572323,24363,20392,3971,1276,476,https://www.intensivregister.de/api/public/reporting/laendertabelle
1651579518,24361,20391,3970,1275,476,https://www.intensivregister.de/api/public/reporting/laendertabelle
1651579518,24362,20397,3965,1275,476,https://www.intensivregister.de/api/public/reporting/laendertabelle
1651583123,24362,20401,3961,1272,476,https://www.intensivregister.de/api/public/reporting/laendertabelle
1651586717,24362,20403,3959,1272,476,https://www.intensivregister.de/api/public/reporting/laendertabelle
1651590319,24361,20403,3958,1272,476,https://www.intensivregister.de/api/public/reporting/laendertabelle
1651611925,24361,20405,3956,1273,476,https://www.intensivregister.de/api/public/reporting/laendertabelle
1651615527,24359,20395,3964,1274,476,https://www.intensivregister.de/api/public/reporting/laendertabelle
1651619120,24359,20399,3960,1274,476,https://www.intensivregister.de/api/public/reporting/laendertabelle
1651622722,24361,20415,3946,1272,476,https://www.intensivregister.de/api/public/reporting/laendertabelle
1651626324,24359,20415,3944,1271,476,https://www.intensivregister.de/api/public/reporting/laendertabelle
1651633523,24358,20397,3961,1256,474,https://www.intensivregister.de/api/public/reporting/laendertabelle
1651637128,24368,20427,3941,1255,476,https://www.intensivregister.de/api/public/reporting/laendertabelle
1651640715,24394,20495,3899,1247,477,https://www.intensivregister.de/api/public/reporting/laendertabelle
1651647928,24429,20509,3920,1214,472,https://www.intensivregister.de/api/public/reporting/laendertabelle
1651651518,24434,20514,3920,1216,469,https://www.intensivregister.de/api/public/reporting/laendertabelle
1651655122,24448,20531,3917,1217,470,https://www.intensivregister.de/api/public/reporting/laendertabelle
1651662316,24448,20533,3915,1213,469,https://www.intensivregister.de/api/public/reporting/laendertabelle
1651665930,24449,20535,3914,1205,467,https://www.intensivregister.de/api/public/reporting/laendertabelle
1651669522,24460,20542,3918,1204,467,https://www.intensivregister.de/api/public/reporting/laendertabelle
1651676714,24460,20544,3916,1204,467,https://www.intensivregister.de/api/public/reporting/laendertabelle
1651683926,24459,20546,3913,1205,467,https://www.intensivregister.de/api/public/reporting/laendertabelle
1651691114,24459,20542,3917,1205,467,https://www.intensivregister.de/api/public/reporting/laendertabelle
1651694734,24459,20543,3916,1206,467,https://www.intensivregister.de/api/public/reporting/laendertabelle
1651701923,24453,20532,3921,1206,466,https://www.intensivregister.de/api/public/reporting/laendertabelle
1651705521,24453,20530,3923,1205,466,https://www.intensivregister.de/api/public/reporting/laendertabelle
1651709126,24450,20525,3925,1202,465,https://www.intensivregister.de/api/public/reporting/laendertabelle
1651712724,24450,20527,3923,1202,465,https://www.intensivregister.de/api/public/reporting/laendertabelle
1651716324,24455,20531,3924,1203,464,https://www.intensivregister.de/api/public/reporting/laendertabelle
1651719925,24464,20549,3915,1203,465,https://www.intensivregister.de/api/public/reporting/laendertabelle
1651723526,24440,20487,3953,1198,460,https://www.intensivregister.de/api/public/reporting/laendertabelle
1651730722,24422,20456,3966,1187,456,https://www.intensivregister.de/api/public/reporting/laendertabelle
1651734333,24412,20436,3976,1180,456,https://www.intensivregister.de/api/public/reporting/laendertabelle
1651737934,24399,20428,3971,1179,455,https://www.intensivregister.de/api/public/reporting/laendertabelle
1651745131,24391,20429,3962,1175,454,https://www.intensivregister.de/api/public/reporting/laendertabelle
1651752322,24395,20431,3964,1173,453,https://www.intensivregister.de/api/public/reporting/laendertabelle
1651755921,24395,20430,3965,1174,453,https://www.intensivregister.de/api/public/reporting/laendertabelle
1651763126,24395,20430,3965,1173,453,https://www.intensivregister.de/api/public/reporting/laendertabelle
1651773922,24393,20427,3966,1174,454,https://www.intensivregister.de/api/public/reporting/laendertabelle
1651781120,24393,20426,3967,1174,454,https://www.intensivregister.de/api/public/reporting/laendertabelle
1651788320,24391,20428,3963,1172,454,https://www.intensivregister.de/api/public/reporting/laendertabelle
1651791929,24391,20425,3966,1171,454,https://www.intensivregister.de/api/public/reporting/laendertabelle
1651795517,24391,20429,3962,1171,454,https://www.intensivregister.de/api/public/reporting/laendertabelle
1651799125,24391,20430,3961,1171,454,https://www.intensivregister.de/api/public/reporting/laendertabelle
1651802719,24391,20438,3953,1172,453,https://www.intensivregister.de/api/public/reporting/laendertabelle
1651806317,24381,20426,3955,1164,453,https://www.intensivregister.de/api/public/reporting/laendertabelle
1651809914,24358,20430,3928,1160,457,https://www.intensivregister.de/api/public/reporting/laendertabelle
1651817125,24321,20461,3860,1118,452,https://www.intensivregister.de/api/public/reporting/laendertabelle
1651820722,24299,20459,3840,1117,448,https://www.intensivregister.de/api/public/reporting/laendertabelle
1651824325,24288,20466,3822,1117,444,https://www.intensivregister.de/api/public/reporting/laendertabelle
1651831523,24279,20468,3811,1116,445,https://www.intensivregister.de/api/public/reporting/laendertabelle
1651835127,24279,20470,3809,1114,445,https://www.intensivregister.de/api/public/reporting/laendertabelle
1651838719,24278,20468,3810,1113,445,https://www.intensivregister.de/api/public/reporting/laendertabelle
1651842327,24278,20469,3809,1112,445,https://www.intensivregister.de/api/public/reporting/laendertabelle
1651849521,24279,20469,3810,1111,445,https://www.intensivregister.de/api/public/reporting/laendertabelle
1651860319,24279,20468,3811,1111,445,https://www.intensivregister.de/api/public/reporting/laendertabelle
1651867521,24275,20464,3811,1111,445,https://www.intensivregister.de/api/public/reporting/laendertabelle
1651871119,24275,20467,3808,1110,445,https://www.intensivregister.de/api/public/reporting/laendertabelle
1651874728,24272,20453,3819,1110,445,https://www.intensivregister.de/api/public/reporting/laendertabelle
1651881933,24271,20453,3818,1112,446,https://www.intensivregister.de/api/public/reporting/laendertabelle
1651889120,24265,20441,3824,1109,446,https://www.intensivregister.de/api/public/reporting/laendertabelle
1651892725,24256,20430,3826,1105,446,https://www.intensivregister.de/api/public/reporting/laendertabelle
1651896328,24224,20333,3891,1095,439,https://www.intensivregister.de/api/public/reporting/laendertabelle
1651903526,24154,20178,3976,1093,433,https://www.intensivregister.de/api/public/reporting/laendertabelle
1651910727,24103,20055,4048,1077,434,https://www.intensivregister.de/api/public/reporting/laendertabelle
1651917924,24112,20056,4056,1078,435,https://www.intensivregister.de/api/public/reporting/laendertabelle
1651925123,24112,20048,4064,1078,435,https://www.intensivregister.de/api/public/reporting/laendertabelle
1651928722,24108,20050,4058,1078,435,https://www.intensivregister.de/api/public/reporting/laendertabelle
1651935913,24108,20047,4061,1078,436,https://www.intensivregister.de/api/public/reporting/laendertabelle
1651939524,24108,20046,4062,1078,436,https://www.intensivregister.de/api/public/reporting/laendertabelle
1651943117,24106,20045,4061,1080,438,https://www.intensivregister.de/api/public/reporting/laendertabelle
1651946717,24106,20042,4064,1080,438,https://www.intensivregister.de/api/public/reporting/laendertabelle
1651953924,24103,20033,4070,1080,438,https://www.intensivregister.de/api/public/reporting/laendertabelle
1651961124,24102,20015,4087,1079,438,https://www.intensivregister.de/api/public/reporting/laendertabelle
1651968313,24100,20011,4089,1079,438,https://www.intensivregister.de/api/public/reporting/laendertabelle
1651971929,24100,20005,4095,1080,438,https://www.intensivregister.de/api/public/reporting/laendertabelle
1651979125,24092,19951,4141,1083,440,https://www.intensivregister.de/api/public/reporting/laendertabelle
1651982718,24089,19889,4200,1085,438,https://www.intensivregister.de/api/public/reporting/laendertabelle
1651986321,24047,19747,4300,1091,438,https://www.intensivregister.de/api/public/reporting/laendertabelle
1651993526,24023,19660,4363,1090,434,https://www.intensivregister.de/api/public/reporting/laendertabelle
1651997120,24019,19637,4382,1090,436,https://www.intensivregister.de/api/public/reporting/laendertabelle
1652004317,24014,19624,4390,1089,436,https://www.intensivregister.de/api/public/reporting/laendertabelle
1652011534,24014,19621,4393,1089,436,https://www.intensivregister.de/api/public/reporting/laendertabelle
1652015117,24014,19617,4397,1089,436,https://www.intensivregister.de/api/public/reporting/laendertabelle
1652018721,24014,19617,4397,1088,436,https://www.intensivregister.de/api/public/reporting/laendertabelle
1652025919,24014,19617,4397,1089,437,https://www.intensivregister.de/api/public/reporting/laendertabelle
1652029515,24014,19615,4399,1089,437,https://www.intensivregister.de/api/public/reporting/laendertabelle
1652036731,24015,19616,4399,1089,436,https://www.intensivregister.de/api/public/reporting/laendertabelle
1652040329,24015,19617,4398,1088,436,https://www.intensivregister.de/api/public/reporting/laendertabelle
1652043928,24017,19615,4402,1089,436,https://www.intensivregister.de/api/public/reporting/laendertabelle
1652047526,24016,19620,4396,1088,435,https://www.intensivregister.de/api/public/reporting/laendertabelle
1652054715,24016,19622,4394,1089,435,https://www.intensivregister.de/api/public/reporting/laendertabelle
1652058324,24016,19629,4387,1089,435,https://www.intensivregister.de/api/public/reporting/laendertabelle
1652061924,24025,19648,4377,1089,435,https://www.intensivregister.de/api/public/reporting/laendertabelle
1652065514,24044,19688,4356,1091,433,https://www.intensivregister.de/api/public/reporting/laendertabelle
1652069115,24091,19719,4372,1090,437,https://www.intensivregister.de/api/public/reporting/laendertabelle
1652072716,24188,19787,4401,1089,422,https://www.intensivregister.de/api/public/reporting/laendertabelle
1652076324,24168,19774,4394,1085,423,https://www.intensivregister.de/api/public/reporting/laendertabelle
1652083524,24253,19894,4359,1094,420,https://www.intensivregister.de/api/public/reporting/laendertabelle
1652087124,24255,19893,4362,1095,420,https://www.intensivregister.de/api/public/reporting/laendertabelle
1652090735,24254,19896,4358,1096,419,https://www.intensivregister.de/api/public/reporting/laendertabelle
1652094324,24254,19897,4357,1097,420,https://www.intensivregister.de/api/public/reporting/laendertabelle
1652097934,24253,19897,4356,1096,420,https://www.intensivregister.de/api/public/reporting/laendertabelle
1652101523,24252,19896,4356,1096,420,https://www.intensivregister.de/api/public/reporting/laendertabelle
1652108724,24250,19892,4358,1096,420,https://www.intensivregister.de/api/public/reporting/laendertabelle
1652126720,24251,19900,4351,1096,420,https://www.intensivregister.de/api/public/reporting/laendertabelle
1652130316,24252,19906,4346,1098,420,https://www.intensivregister.de/api/public/reporting/laendertabelle
1652133932,24252,19909,4343,1098,420,https://www.intensivregister.de/api/public/reporting/laendertabelle
1652137518,24252,19910,4342,1098,420,https://www.intensivregister.de/api/public/reporting/laendertabelle
1652141127,24252,19911,4341,1098,420,https://www.intensivregister.de/api/public/reporting/laendertabelle
1652144742,24253,19912,4341,1095,420,https://www.intensivregister.de/api/public/reporting/laendertabelle
1652148319,24252,19933,4319,1099,420,https://www.intensivregister.de/api/public/reporting/laendertabelle
1652151929,24283,20034,4249,1091,414,https://www.intensivregister.de/api/public/reporting/laendertabelle
1652155530,24324,20107,4217,1096,414,https://www.intensivregister.de/api/public/reporting/laendertabelle
1652159124,24381,20278,4103,1087,408,https://www.intensivregister.de/api/public/reporting/laendertabelle
1652162719,24386,20340,4046,1080,407,https://www.intensivregister.de/api/public/reporting/laendertabelle
1652166316,24404,20372,4032,1067,405,https://www.intensivregister.de/api/public/reporting/laendertabelle
1652169929,24409,20398,4011,1063,407,https://www.intensivregister.de/api/public/reporting/laendertabelle
1652173522,24408,20400,4008,1059,404,https://www.intensivregister.de/api/public/reporting/laendertabelle
1652177115,24400,20398,4002,1057,404,https://www.intensivregister.de/api/public/reporting/laendertabelle
1652180723,24408,20406,4002,1057,404,https://www.intensivregister.de/api/public/reporting/laendertabelle
1652187914,24408,20411,3997,1057,404,https://www.intensivregister.de/api/public/reporting/laendertabelle
1652191533,24406,20409,3997,1056,404,https://www.intensivregister.de/api/public/reporting/laendertabelle
1652205924,24406,20407,3999,1056,404,https://www.intensivregister.de/api/public/reporting/laendertabelle
1652213120,24406,20406,4000,1056,404,https://www.intensivregister.de/api/public/reporting/laendertabelle
1652216717,24409,20403,4006,1056,404,https://www.intensivregister.de/api/public/reporting/laendertabelle
1652220323,24406,20406,4000,1055,404,https://www.intensivregister.de/api/public/reporting/laendertabelle
1652223933,24406,20411,3995,1055,404,https://www.intensivregister.de/api/public/reporting/laendertabelle
1652227515,24405,20411,3994,1055,404,https://www.intensivregister.de/api/public/reporting/laendertabelle
1652231123,24405,20410,3995,1055,404,https://www.intensivregister.de/api/public/reporting/laendertabelle
1652234718,24407,20416,3991,1055,403,https://www.intensivregister.de/api/public/reporting/laendertabelle
1652238313,24404,20440,3964,1055,405,https://www.intensivregister.de/api/public/reporting/laendertabelle
1652241931,24422,20521,3901,1046,396,https://www.intensivregister.de/api/public/reporting/laendertabelle
1652245531,24441,20595,3846,1037,392,https://www.intensivregister.de/api/public/reporting/laendertabelle
1652252732,24456,20646,3810,1035,392,https://www.intensivregister.de/api/public/reporting/laendertabelle
1652256319,24453,20649,3804,1034,390,https://www.intensivregister.de/api/public/reporting/laendertabelle
1652259929,24452,20643,3809,1034,390,https://www.intensivregister.de/api/public/reporting/laendertabelle
1652267118,24458,20646,3812,1036,390,https://www.intensivregister.de/api/public/reporting/laendertabelle
1652274316,24456,20651,3805,1036,390,https://www.intensivregister.de/api/public/reporting/laendertabelle
1652277916,24456,20650,3806,1037,390,https://www.intensivregister.de/api/public/reporting/laendertabelle
1652281514,24458,20648,3810,1038,391,https://www.intensivregister.de/api/public/reporting/laendertabelle
1652303124,24460,20649,3811,1040,392,https://www.intensivregister.de/api/public/reporting/laendertabelle
1652306729,24463,20653,3810,1038,391,https://www.intensivregister.de/api/public/reporting/laendertabelle
1652310314,24462,20648,3814,1039,391,https://www.intensivregister.de/api/public/reporting/laendertabelle
1652313930,24463,20655,3808,1039,391,https://www.intensivregister.de/api/public/reporting/laendertabelle
1652317525,24463,20653,3810,1038,391,https://www.intensivregister.de/api/public/reporting/laendertabelle
1652321117,24465,20651,3814,1037,391,https://www.intensivregister.de/api/public/reporting/laendertabelle
1652324726,24460,20646,3814,1025,393,https://www.intensivregister.de/api/public/reporting/laendertabelle
1652328316,24463,20627,3836,1010,390,https://www.intensivregister.de/api/public/reporting/laendertabelle
1652335523,24460,20674,3786,1003,389,https://www.intensivregister.de/api/public/reporting/laendertabelle
1652342718,24466,20722,3744,1002,392,https://www.intensivregister.de/api/public/reporting/laendertabelle
1652349925,24469,20717,3752,1000,392,https://www.intensivregister.de/api/public/reporting/laendertabelle
1652357122,24470,20709,3761,1002,393,https://www.intensivregister.de/api/public/reporting/laendertabelle
1652360721,24470,20707,3763,1002,393,https://www.intensivregister.de/api/public/reporting/laendertabelle
1652364328,24471,20707,3764,1002,393,https://www.intensivregister.de/api/public/reporting/laendertabelle
1652385915,24469,20701,3768,1001,393,https://www.intensivregister.de/api/public/reporting/laendertabelle
1652393123,24468,20704,3764,1003,392,https://www.intensivregister.de/api/public/reporting/laendertabelle
1652396713,24468,20696,3772,1003,392,https://www.intensivregister.de/api/public/reporting/laendertabelle
1652403928,24469,20686,3783,999,390,https://www.intensivregister.de/api/public/reporting/laendertabelle
1652407529,24478,20690,3788,998,391,https://www.intensivregister.de/api/public/reporting/laendertabelle
1652411125,24483,20709,3774,994,392,https://www.intensivregister.de/api/public/reporting/laendertabelle
1652418316,24404,20687,3717,975,387,https://www.intensivregister.de/api/public/reporting/laendertabelle
1652421925,24372,20656,3716,975,395,https://www.intensivregister.de/api/public/reporting/laendertabelle
1652425528,24354,20651,3703,981,394,https://www.intensivregister.de/api/public/reporting/laendertabelle
1652432733,24338,20625,3713,976,394,https://www.intensivregister.de/api/public/reporting/laendertabelle
1652439932,24341,20635,3706,975,395,https://www.intensivregister.de/api/public/reporting/laendertabelle
1652447122,24341,20638,3703,974,395,https://www.intensivregister.de/api/public/reporting/laendertabelle
1652450722,24338,20634,3704,976,396,https://www.intensivregister.de/api/public/reporting/laendertabelle
1652454314,24338,20633,3705,974,394,https://www.intensivregister.de/api/public/reporting/laendertabelle
1652475925,24337,20610,3727,976,394,https://www.intensivregister.de/api/public/reporting/laendertabelle
1652483124,24340,20607,3733,977,394,https://www.intensivregister.de/api/public/reporting/laendertabelle
1652483124,24340,20606,3734,977,394,https://www.intensivregister.de/api/public/reporting/laendertabelle
1652486714,24340,20601,3739,976,394,https://www.intensivregister.de/api/public/reporting/laendertabelle
1652490314,24339,20603,3736,976,395,https://www.intensivregister.de/api/public/reporting/laendertabelle
1652493914,24335,20588,3747,974,396,https://www.intensivregister.de/api/public/reporting/laendertabelle
1652501124,24286,20490,3796,966,394,https://www.intensivregister.de/api/public/reporting/laendertabelle
1652508327,24176,20313,3863,950,386,https://www.intensivregister.de/api/public/reporting/laendertabelle
1652511929,24150,20250,3900,945,381,https://www.intensivregister.de/api/public/reporting/laendertabelle
1652519123,24138,20204,3934,942,382,https://www.intensivregister.de/api/public/reporting/laendertabelle
1652522715,24114,20181,3933,941,381,https://www.intensivregister.de/api/public/reporting/laendertabelle
1652529922,24114,20180,3934,941,381,https://www.intensivregister.de/api/public/reporting/laendertabelle
1652533514,24112,20172,3940,940,381,https://www.intensivregister.de/api/public/reporting/laendertabelle
1652537118,24112,20166,3946,940,381,https://www.intensivregister.de/api/public/reporting/laendertabelle
1652544321,24112,20164,3948,940,381,https://www.intensivregister.de/api/public/reporting/laendertabelle
1652551517,24112,20163,3949,940,381,https://www.intensivregister.de/api/public/reporting/laendertabelle
1652558733,24112,20165,3947,940,381,https://www.intensivregister.de/api/public/reporting/laendertabelle
1652562316,24109,20141,3968,941,381,https://www.intensivregister.de/api/public/reporting/laendertabelle
1652565918,24105,20135,3970,941,382,https://www.intensivregister.de/api/public/reporting/laendertabelle
1652569531,24105,20134,3971,942,382,https://www.intensivregister.de/api/public/reporting/laendertabelle
1652573123,24105,20133,3972,942,382,https://www.intensivregister.de/api/public/reporting/laendertabelle
1652580318,24103,20138,3965,945,382,https://www.intensivregister.de/api/public/reporting/laendertabelle
1652583923,24112,20117,3995,943,382,https://www.intensivregister.de/api/public/reporting/laendertabelle
1652587516,24092,20055,4037,942,380,https://www.intensivregister.de/api/public/reporting/laendertabelle
1652594714,24057,19908,4149,923,381,https://www.intensivregister.de/api/public/reporting/laendertabelle
1652601930,24060,19829,4231,924,380,https://www.intensivregister.de/api/public/reporting/laendertabelle
1652609126,24051,19826,4225,922,381,https://www.intensivregister.de/api/public/reporting/laendertabelle
1652612719,24049,19820,4229,922,381,https://www.intensivregister.de/api/public/reporting/laendertabelle
1652616323,24049,19820,4229,921,381,https://www.intensivregister.de/api/public/reporting/laendertabelle
1652619923,24050,19819,4231,920,381,https://www.intensivregister.de/api/public/reporting/laendertabelle
1652623527,24050,19818,4232,920,381,https://www.intensivregister.de/api/public/reporting/laendertabelle
1652630720,24054,19813,4241,920,382,https://www.intensivregister.de/api/public/reporting/laendertabelle
1652648730,24058,19822,4236,923,384,https://www.intensivregister.de/api/public/reporting/laendertabelle
1652655927,24058,19827,4231,922,384,https://www.intensivregister.de/api/public/reporting/laendertabelle
1652663124,24062,19834,4228,921,384,https://www.intensivregister.de/api/public/reporting/laendertabelle
1652666723,24078,19856,4222,921,383,https://www.intensivregister.de/api/public/reporting/laendertabelle
1652673914,24103,19870,4233,928,386,https://www.intensivregister.de/api/public/reporting/laendertabelle
1652677515,24162,19922,4240,933,381,https://www.intensivregister.de/api/public/reporting/laendertabelle
1652684717,24198,19935,4263,939,380,https://www.intensivregister.de/api/public/reporting/laendertabelle
1652688334,24194,19939,4255,943,378,https://www.intensivregister.de/api/public/reporting/laendertabelle
1652695514,24201,19944,4257,944,379,https://www.intensivregister.de/api/public/reporting/laendertabelle
1652699119,24201,19947,4254,945,379,https://www.intensivregister.de/api/public/reporting/laendertabelle
1652706323,24201,19946,4255,946,380,https://www.intensivregister.de/api/public/reporting/laendertabelle
1652709925,24217,19963,4254,947,380,https://www.intensivregister.de/api/public/reporting/laendertabelle
1652735127,24217,19952,4265,946,380,https://www.intensivregister.de/api/public/reporting/laendertabelle
1652738729,24219,19954,4265,946,380,https://www.intensivregister.de/api/public/reporting/laendertabelle
1652742322,24216,19948,4268,948,381,https://www.intensivregister.de/api/public/reporting/laendertabelle
1652745915,24216,19952,4264,948,381,https://www.intensivregister.de/api/public/reporting/laendertabelle
1652749519,24219,19955,4264,949,382,https://www.intensivregister.de/api/public/reporting/laendertabelle
1652753113,24218,19956,4262,948,384,https://www.intensivregister.de/api/public/reporting/laendertabelle
1652756729,24241,20030,4211,943,386,https://www.intensivregister.de/api/public/reporting/laendertabelle
1652763914,24251,20197,4054,933,382,https://www.intensivregister.de/api/public/reporting/laendertabelle
1652767523,24265,20315,3950,947,382,https://www.intensivregister.de/api/public/reporting/laendertabelle
1652771121,24271,20376,3895,945,380,https://www.intensivregister.de/api/public/reporting/laendertabelle
1652774719,24293,20416,3877,944,380,https://www.intensivregister.de/api/public/reporting/laendertabelle
1652781927,24303,20439,3864,943,380,https://www.intensivregister.de/api/public/reporting/laendertabelle
1652785527,24303,20437,3866,943,380,https://www.intensivregister.de/api/public/reporting/laendertabelle
1652792730,24303,20441,3862,944,380,https://www.intensivregister.de/api/public/reporting/laendertabelle
1652810714,24303,20442,3861,945,380,https://www.intensivregister.de/api/public/reporting/laendertabelle
1652821520,24303,20446,3857,943,379,https://www.intensivregister.de/api/public/reporting/laendertabelle
1652825129,24305,20447,3858,943,379,https://www.intensivregister.de/api/public/reporting/laendertabelle
1652828721,24305,20452,3853,944,379,https://www.intensivregister.de/api/public/reporting/laendertabelle
1652832322,24307,20453,3854,944,379,https://www.intensivregister.de/api/public/reporting/laendertabelle
1652835913,24298,20447,3851,943,377,https://www.intensivregister.de/api/public/reporting/laendertabelle
1652843128,24301,20459,3842,949,371,https://www.intensivregister.de/api/public/reporting/laendertabelle
1652846726,24297,20427,3870,932,367,https://www.intensivregister.de/api/public/reporting/laendertabelle
1652853931,24219,20459,3760,908,356,https://www.intensivregister.de/api/public/reporting/laendertabelle
1652857522,24212,20489,3723,907,360,https://www.intensivregister.de/api/public/reporting/laendertabelle
1652864732,24217,20477,3740,906,361,https://www.intensivregister.de/api/public/reporting/laendertabelle
1652868321,24218,20490,3728,902,361,https://www.intensivregister.de/api/public/reporting/laendertabelle
1652875519,24218,20493,3725,902,361,https://www.intensivregister.de/api/public/reporting/laendertabelle
1652879126,24218,20492,3726,902,361,https://www.intensivregister.de/api/public/reporting/laendertabelle
1652889917,24218,20491,3727,902,361,https://www.intensivregister.de/api/public/reporting/laendertabelle
1652900722,24218,20492,3726,902,363,https://www.intensivregister.de/api/public/reporting/laendertabelle
1652904320,24214,20489,3725,902,363,https://www.intensivregister.de/api/public/reporting/laendertabelle
1652911522,24214,20481,3733,901,363,https://www.intensivregister.de/api/public/reporting/laendertabelle
1652918716,24214,20487,3727,901,363,https://www.intensivregister.de/api/public/reporting/laendertabelle
1652922322,24209,20477,3732,900,363,https://www.intensivregister.de/api/public/reporting/laendertabelle
1652925927,24207,20475,3732,894,362,https://www.intensivregister.de/api/public/reporting/laendertabelle
1652929523,24199,20455,3744,886,359,https://www.intensivregister.de/api/public/reporting/laendertabelle
1652933116,24170,20428,3742,882,359,https://www.intensivregister.de/api/public/reporting/laendertabelle
1652940330,24199,20439,3760,873,355,https://www.intensivregister.de/api/public/reporting/laendertabelle
1652947517,24236,20482,3754,873,358,https://www.intensivregister.de/api/public/reporting/laendertabelle
1652951124,24235,20482,3753,872,358,https://www.intensivregister.de/api/public/reporting/laendertabelle
1652954731,24239,20488,3751,872,358,https://www.intensivregister.de/api/public/reporting/laendertabelle
1652958315,24242,20489,3753,872,359,https://www.intensivregister.de/api/public/reporting/laendertabelle
1652961921,24243,20490,3753,872,359,https://www.intensivregister.de/api/public/reporting/laendertabelle
1652969122,24244,20490,3754,870,358,https://www.intensivregister.de/api/public/reporting/laendertabelle
1652983523,24243,20487,3756,869,357,https://www.intensivregister.de/api/public/reporting/laendertabelle
1652990722,24243,20488,3755,869,357,https://www.intensivregister.de/api/public/reporting/laendertabelle
1652997922,24242,20484,3758,870,357,https://www.intensivregister.de/api/public/reporting/laendertabelle
1653001518,24240,20489,3751,870,357,https://www.intensivregister.de/api/public/reporting/laendertabelle
1653008727,24241,20484,3757,870,357,https://www.intensivregister.de/api/public/reporting/laendertabelle
1653012320,24238,20483,3755,866,357,https://www.intensivregister.de/api/public/reporting/laendertabelle
1653019532,24237,20481,3756,852,355,https://www.intensivregister.de/api/public/reporting/laendertabelle
1653026730,24217,20485,3732,829,354,https://www.intensivregister.de/api/public/reporting/laendertabelle
1653030321,24170,20449,3721,819,352,https://www.intensivregister.de/api/public/reporting/laendertabelle
1653037533,24124,20414,3710,819,353,https://www.intensivregister.de/api/public/reporting/laendertabelle
1653044718,24123,20428,3695,818,352,https://www.intensivregister.de/api/public/reporting/laendertabelle
1653048320,24123,20427,3696,818,352,https://www.intensivregister.de/api/public/reporting/laendertabelle
1653051914,24122,20427,3695,818,352,https://www.intensivregister.de/api/public/reporting/laendertabelle
1653055516,24122,20426,3696,818,352,https://www.intensivregister.de/api/public/reporting/laendertabelle
1653059119,24122,20426,3696,817,352,https://www.intensivregister.de/api/public/reporting/laendertabelle
1653080733,24128,20424,3704,817,352,https://www.intensivregister.de/api/public/reporting/laendertabelle
1653084323,24128,20428,3700,821,354,https://www.intensivregister.de/api/public/reporting/laendertabelle
1653087915,24129,20425,3704,819,354,https://www.intensivregister.de/api/public/reporting/laendertabelle
1653091528,24129,20422,3707,820,354,https://www.intensivregister.de/api/public/reporting/laendertabelle
1653095122,24131,20422,3709,819,354,https://www.intensivregister.de/api/public/reporting/laendertabelle
1653098723,24132,20421,3711,819,354,https://www.intensivregister.de/api/public/reporting/laendertabelle
1653105931,24099,20363,3736,810,348,https://www.intensivregister.de/api/public/reporting/laendertabelle
1653109514,24051,20216,3835,798,343,https://www.intensivregister.de/api/public/reporting/laendertabelle
1653113127,23996,20125,3871,793,332,https://www.intensivregister.de/api/public/reporting/laendertabelle
1653116720,23947,20048,3899,802,336,https://www.intensivregister.de/api/public/reporting/laendertabelle
1653120333,23935,20022,3913,802,334,https://www.intensivregister.de/api/public/reporting/laendertabelle
1653127519,23934,20015,3919,800,334,https://www.intensivregister.de/api/public/reporting/laendertabelle
1653131122,23928,20011,3917,800,334,https://www.intensivregister.de/api/public/reporting/laendertabelle
1653134722,23926,20005,3921,801,334,https://www.intensivregister.de/api/public/reporting/laendertabelle
1653138324,23915,19987,3928,801,334,https://www.intensivregister.de/api/public/reporting/laendertabelle
1653141927,23913,19980,3933,802,335,https://www.intensivregister.de/api/public/reporting/laendertabelle
1653149122,23912,19972,3940,803,335,https://www.intensivregister.de/api/public/reporting/laendertabelle
1653159927,23911,19971,3940,803,335,https://www.intensivregister.de/api/public/reporting/laendertabelle
1653167131,23911,19973,3938,803,335,https://www.intensivregister.de/api/public/reporting/laendertabelle
1653170722,23911,19974,3937,802,334,https://www.intensivregister.de/api/public/reporting/laendertabelle
1653174323,23911,19968,3943,801,334,https://www.intensivregister.de/api/public/reporting/laendertabelle
1653181518,23904,19974,3930,803,335,https://www.intensivregister.de/api/public/reporting/laendertabelle
1653185127,23906,19968,3938,804,335,https://www.intensivregister.de/api/public/reporting/laendertabelle
1653188721,23899,19953,3946,805,335,https://www.intensivregister.de/api/public/reporting/laendertabelle
1653195929,23899,19895,4004,803,336,https://www.intensivregister.de/api/public/reporting/laendertabelle
1653195929,23878,19824,4054,798,334,https://www.intensivregister.de/api/public/reporting/laendertabelle
1653203118,23839,19627,4212,808,326,https://www.intensivregister.de/api/public/reporting/laendertabelle
1653206722,23823,19586,4237,815,325,https://www.intensivregister.de/api/public/reporting/laendertabelle
1653210325,23817,19579,4238,814,324,https://www.intensivregister.de/api/public/reporting/laendertabelle
1653213913,23810,19577,4233,815,324,https://www.intensivregister.de/api/public/reporting/laendertabelle
1653221123,23810,19575,4235,814,324,https://www.intensivregister.de/api/public/reporting/laendertabelle
1653228332,23810,19558,4252,815,325,https://www.intensivregister.de/api/public/reporting/laendertabelle
1653235521,23811,19561,4250,816,325,https://www.intensivregister.de/api/public/reporting/laendertabelle
1653239121,23811,19564,4247,816,325,https://www.intensivregister.de/api/public/reporting/laendertabelle
1653246318,23811,19562,4249,816,325,https://www.intensivregister.de/api/public/reporting/laendertabelle
1653253516,23814,19568,4246,816,325,https://www.intensivregister.de/api/public/reporting/laendertabelle
1653257116,23814,19569,4245,816,326,https://www.intensivregister.de/api/public/reporting/laendertabelle
1653260716,23814,19569,4245,817,326,https://www.intensivregister.de/api/public/reporting/laendertabelle
1653264325,23815,19566,4249,816,325,https://www.intensivregister.de/api/public/reporting/laendertabelle
1653267925,23811,19561,4250,816,325,https://www.intensivregister.de/api/public/reporting/laendertabelle
1653271524,23813,19557,4256,814,325,https://www.intensivregister.de/api/public/reporting/laendertabelle
1653275116,23842,19613,4229,818,323,https://www.intensivregister.de/api/public/reporting/laendertabelle
1653278716,23935,19647,4288,818,320,https://www.intensivregister.de/api/public/reporting/laendertabelle
1653282326,24004,19703,4301,805,320,https://www.intensivregister.de/api/public/reporting/laendertabelle
1653289529,24063,19728,4335,795,314,https://www.intensivregister.de/api/public/reporting/laendertabelle
1653296719,24106,19765,4341,794,315,https://www.intensivregister.de/api/public/reporting/laendertabelle
1653303928,24111,19793,4318,788,315,https://www.intensivregister.de/api/public/reporting/laendertabelle
1653307518,24110,19794,4316,789,315,https://www.intensivregister.de/api/public/reporting/laendertabelle
1653311117,24108,19792,4316,788,315,https://www.intensivregister.de/api/public/reporting/laendertabelle
1653318319,24108,19797,4311,788,315,https://www.intensivregister.de/api/public/reporting/laendertabelle
1653329117,24108,19799,4309,788,315,https://www.intensivregister.de/api/public/reporting/laendertabelle
1653339923,24106,19801,4305,788,315,https://www.intensivregister.de/api/public/reporting/laendertabelle
1653343524,24112,19806,4306,788,317,https://www.intensivregister.de/api/public/reporting/laendertabelle
1653347124,24110,19812,4298,789,319,https://www.intensivregister.de/api/public/reporting/laendertabelle
1653350733,24109,19806,4303,790,319,https://www.intensivregister.de/api/public/reporting/laendertabelle
1653357932,24117,19843,4274,788,319,https://www.intensivregister.de/api/public/reporting/laendertabelle
1653361523,24134,19912,4222,771,319,https://www.intensivregister.de/api/public/reporting/laendertabelle
1653365114,24134,20035,4099,759,319,https://www.intensivregister.de/api/public/reporting/laendertabelle
1653368724,24172,20222,3950,756,316,https://www.intensivregister.de/api/public/reporting/laendertabelle
1653372333,24369,20482,3887,746,321,https://www.intensivregister.de/api/public/reporting/laendertabelle
1653379519,24402,20588,3814,741,324,https://www.intensivregister.de/api/public/reporting/laendertabelle
1653386729,24391,20585,3806,738,324,https://www.intensivregister.de/api/public/reporting/laendertabelle
1653390327,24391,20592,3799,740,324,https://www.intensivregister.de/api/public/reporting/laendertabelle
1653393926,24393,20594,3799,738,324,https://www.intensivregister.de/api/public/reporting/laendertabelle
1653397525,24393,20599,3794,739,324,https://www.intensivregister.de/api/public/reporting/laendertabelle
1653411929,24393,20600,3793,739,324,https://www.intensivregister.de/api/public/reporting/laendertabelle
1653422733,24393,20602,3791,739,324,https://www.intensivregister.de/api/public/reporting/laendertabelle
1653429931,24391,20595,3796,738,325,https://www.intensivregister.de/api/public/reporting/laendertabelle
1653433520,24391,20606,3785,738,325,https://www.intensivregister.de/api/public/reporting/laendertabelle
1653437119,24393,20610,3783,737,323,https://www.intensivregister.de/api/public/reporting/laendertabelle
1653440725,24400,20610,3790,737,323,https://www.intensivregister.de/api/public/reporting/laendertabelle
1653444317,24393,20614,3779,736,322,https://www.intensivregister.de/api/public/reporting/laendertabelle
1653451521,24402,20676,3726,732,321,https://www.intensivregister.de/api/public/reporting/laendertabelle
1653458715,24391,20664,3727,726,315,https://www.intensivregister.de/api/public/reporting/laendertabelle
1653465916,24415,20649,3766,719,312,https://www.intensivregister.de/api/public/reporting/laendertabelle
1653469523,24414,20653,3761,720,313,https://www.intensivregister.de/api/public/reporting/laendertabelle
1653476732,24415,20651,3764,721,313,https://www.intensivregister.de/api/public/reporting/laendertabelle
1653480316,24415,20649,3766,721,313,https://www.intensivregister.de/api/public/reporting/laendertabelle
1653483924,24416,20646,3770,721,313,https://www.intensivregister.de/api/public/reporting/laendertabelle
1653494724,24418,20647,3771,721,313,https://www.intensivregister.de/api/public/reporting/laendertabelle
1653498330,24418,20647,3771,722,313,https://www.intensivregister.de/api/public/reporting/laendertabelle
1653509120,24419,20648,3771,721,313,https://www.intensivregister.de/api/public/reporting/laendertabelle
1653512724,24413,20640,3773,720,311,https://www.intensivregister.de/api/public/reporting/laendertabelle
1653516328,24414,20643,3771,720,311,https://www.intensivregister.de/api/public/reporting/laendertabelle
1653523518,24412,20640,3772,721,312,https://www.intensivregister.de/api/public/reporting/laendertabelle
1653527131,24412,20643,3769,721,312,https://www.intensivregister.de/api/public/reporting/laendertabelle
1653534317,24401,20623,3778,720,312,https://www.intensivregister.de/api/public/reporting/laendertabelle
1653537933,24404,20619,3785,721,313,https://www.intensivregister.de/api/public/reporting/laendertabelle
1653541517,24355,20547,3808,710,300,https://www.intensivregister.de/api/public/reporting/laendertabelle
1653545121,24335,20553,3782,706,296,https://www.intensivregister.de/api/public/reporting/laendertabelle
1653552322,24318,20448,3870,704,294,https://www.intensivregister.de/api/public/reporting/laendertabelle
1653555916,24318,20457,3861,705,295,https://www.intensivregister.de/api/public/reporting/laendertabelle
1653559523,24319,20446,3873,704,295,https://www.intensivregister.de/api/public/reporting/laendertabelle
1653563128,24323,20450,3873,704,295,https://www.intensivregister.de/api/public/reporting/laendertabelle
1653566733,24321,20452,3869,704,295,https://www.intensivregister.de/api/public/reporting/laendertabelle
1653570326,24319,20450,3869,705,296,https://www.intensivregister.de/api/public/reporting/laendertabelle
1653577528,24319,20451,3868,705,296,https://www.intensivregister.de/api/public/reporting/laendertabelle
1653581114,24320,20452,3868,705,296,https://www.intensivregister.de/api/public/reporting/laendertabelle
1653584729,24319,20450,3869,705,296,https://www.intensivregister.de/api/public/reporting/laendertabelle
1653599119,24317,20443,3874,705,296,https://www.intensivregister.de/api/public/reporting/laendertabelle
1653606320,24320,20428,3892,705,296,https://www.intensivregister.de/api/public/reporting/laendertabelle
1653609924,24320,20433,3887,704,296,https://www.intensivregister.de/api/public/reporting/laendertabelle
1653613518,24322,20434,3888,705,296,https://www.intensivregister.de/api/public/reporting/laendertabelle
1653617124,24324,20419,3905,706,296,https://www.intensivregister.de/api/public/reporting/laendertabelle
1653624325,24331,20237,4094,701,293,https://www.intensivregister.de/api/public/reporting/laendertabelle
1653631529,24316,20110,4206,698,291,https://www.intensivregister.de/api/public/reporting/laendertabelle
1653638727,24261,20027,4234,704,287,https://www.intensivregister.de/api/public/reporting/laendertabelle
1653645918,24245,19996,4249,703,287,https://www.intensivregister.de/api/public/reporting/laendertabelle
1653649528,24244,19995,4249,702,286,https://www.intensivregister.de/api/public/reporting/laendertabelle
1653653127,24244,19998,4246,702,286,https://www.intensivregister.de/api/public/reporting/laendertabelle
1653656728,24242,19997,4245,701,286,https://www.intensivregister.de/api/public/reporting/laendertabelle
1653663928,24242,19996,4246,701,286,https://www.intensivregister.de/api/public/reporting/laendertabelle
1653685526,24241,19989,4252,698,283,https://www.intensivregister.de/api/public/reporting/laendertabelle
1653692716,24245,19980,4265,697,283,https://www.intensivregister.de/api/public/reporting/laendertabelle
1653696322,24244,19972,4272,697,283,https://www.intensivregister.de/api/public/reporting/laendertabelle
1653699932,24246,19967,4279,698,283,https://www.intensivregister.de/api/public/reporting/laendertabelle
1653707121,24242,19952,4290,701,283,https://www.intensivregister.de/api/public/reporting/laendertabelle
1653714317,24201,19846,4355,683,274,https://www.intensivregister.de/api/public/reporting/laendertabelle
1653717914,24172,19818,4354,671,272,https://www.intensivregister.de/api/public/reporting/laendertabelle
1653725129,24133,19827,4306,669,272,https://www.intensivregister.de/api/public/reporting/laendertabelle
1653728726,24132,19837,4295,669,272,https://www.intensivregister.de/api/public/reporting/laendertabelle
1653732313,24130,19840,4290,669,272,https://www.intensivregister.de/api/public/reporting/laendertabelle
1653735921,24130,19836,4294,667,272,https://www.intensivregister.de/api/public/reporting/laendertabelle
1653739518,24132,19836,4296,667,272,https://www.intensivregister.de/api/public/reporting/laendertabelle
1653743113,24129,19832,4297,667,272,https://www.intensivregister.de/api/public/reporting/laendertabelle
1653750327,24133,19830,4303,666,271,https://www.intensivregister.de/api/public/reporting/laendertabelle
1653757522,24131,19831,4300,665,271,https://www.intensivregister.de/api/public/reporting/laendertabelle
1653761118,24131,19829,4302,665,271,https://www.intensivregister.de/api/public/reporting/laendertabelle
1653764715,24132,19829,4303,665,271,https://www.intensivregister.de/api/public/reporting/laendertabelle
1653768321,24132,19825,4307,665,271,https://www.intensivregister.de/api/public/reporting/laendertabelle
1653775525,24131,19822,4309,663,271,https://www.intensivregister.de/api/public/reporting/laendertabelle
1653779115,24129,19810,4319,663,271,https://www.intensivregister.de/api/public/reporting/laendertabelle
1653782722,24129,19811,4318,663,271,https://www.intensivregister.de/api/public/reporting/laendertabelle
1653789926,24129,19815,4314,661,271,https://www.intensivregister.de/api/public/reporting/laendertabelle
1653793515,24123,19790,4333,662,271,https://www.intensivregister.de/api/public/reporting/laendertabelle
1653797121,24110,19754,4356,660,271,https://www.intensivregister.de/api/public/reporting/laendertabelle
1653800719,24092,19756,4336,662,264,https://www.intensivregister.de/api/public/reporting/laendertabelle
1653804327,24086,19702,4384,665,267,https://www.intensivregister.de/api/public/reporting/laendertabelle
1653807924,24061,19621,4440,658,261,https://www.intensivregister.de/api/public/reporting/laendertabelle
1653811520,24048,19589,4459,656,260,https://www.intensivregister.de/api/public/reporting/laendertabelle
1653815118,24046,19568,4478,657,260,https://www.intensivregister.de/api/public/reporting/laendertabelle
1653818715,24029,19554,4475,656,259,https://www.intensivregister.de/api/public/reporting/laendertabelle
1653825929,24026,19550,4476,656,259,https://www.intensivregister.de/api/public/reporting/laendertabelle
1653829515,24039,19564,4475,657,259,https://www.intensivregister.de/api/public/reporting/laendertabelle
1653840325,24039,19569,4470,657,259,https://www.intensivregister.de/api/public/reporting/laendertabelle
1653847527,24039,19568,4471,658,259,https://www.intensivregister.de/api/public/reporting/laendertabelle
1653858314,24040,19567,4473,658,259,https://www.intensivregister.de/api/public/reporting/laendertabelle
1653861929,24044,19570,4474,658,259,https://www.intensivregister.de/api/public/reporting/laendertabelle
1653869129,24044,19565,4479,658,259,https://www.intensivregister.de/api/public/reporting/laendertabelle
1653876323,24049,19581,4468,659,259,https://www.intensivregister.de/api/public/reporting/laendertabelle
1653883528,24101,19683,4418,654,256,https://www.intensivregister.de/api/public/reporting/laendertabelle
1653887117,24185,19712,4473,656,260,https://www.intensivregister.de/api/public/reporting/laendertabelle
1653890727,24241,19759,4482,659,259,https://www.intensivregister.de/api/public/reporting/laendertabelle
1653894324,24290,19819,4471,666,257,https://www.intensivregister.de/api/public/reporting/laendertabelle
1653901531,24333,19849,4484,670,257,https://www.intensivregister.de/api/public/reporting/laendertabelle
1653905121,24337,19853,4484,669,257,https://www.intensivregister.de/api/public/reporting/laendertabelle
1653912328,24339,19855,4484,667,257,https://www.intensivregister.de/api/public/reporting/laendertabelle
1653915922,24339,19858,4481,667,257,https://www.intensivregister.de/api/public/reporting/laendertabelle
1653919525,24341,19862,4479,667,257,https://www.intensivregister.de/api/public/reporting/laendertabelle
1653933928,24341,19863,4478,666,257,https://www.intensivregister.de/api/public/reporting/laendertabelle
1653941133,24341,19860,4481,666,257,https://www.intensivregister.de/api/public/reporting/laendertabelle
1653944729,24340,19863,4477,666,258,https://www.intensivregister.de/api/public/reporting/laendertabelle
1653951915,24344,19871,4473,667,258,https://www.intensivregister.de/api/public/reporting/laendertabelle
1653955524,24343,19876,4467,669,259,https://www.intensivregister.de/api/public/reporting/laendertabelle
1653959122,24343,19880,4463,669,259,https://www.intensivregister.de/api/public/reporting/laendertabelle
1653962714,24346,19887,4459,670,258,https://www.intensivregister.de/api/public/reporting/laendertabelle
1653969918,24395,20080,4315,675,258,https://www.intensivregister.de/api/public/reporting/laendertabelle
1653973525,24396,20198,4198,681,259,https://www.intensivregister.de/api/public/reporting/laendertabelle
1653980718,24411,20349,4062,681,271,https://www.intensivregister.de/api/public/reporting/laendertabelle
1653984323,24414,20385,4029,681,269,https://www.intensivregister.de/api/public/reporting/laendertabelle
1653987919,24416,20376,4040,684,269,https://www.intensivregister.de/api/public/reporting/laendertabelle
1653991517,24416,20375,4041,684,269,https://www.intensivregister.de/api/public/reporting/laendertabelle
1653998722,24418,20380,4038,685,269,https://www.intensivregister.de/api/public/reporting/laendertabelle
1654002320,24420,20383,4037,685,269,https://www.intensivregister.de/api/public/reporting/laendertabelle
1654005929,24421,20387,4034,685,269,https://www.intensivregister.de/api/public/reporting/laendertabelle
1654013133,24421,20389,4032,685,269,https://www.intensivregister.de/api/public/reporting/laendertabelle
1654016722,24421,20388,4033,685,269,https://www.intensivregister.de/api/public/reporting/laendertabelle
1654023916,24421,20389,4032,685,269,https://www.intensivregister.de/api/public/reporting/laendertabelle
1654031121,24420,20392,4028,684,268,https://www.intensivregister.de/api/public/reporting/laendertabelle
1654038314,24421,20393,4028,682,268,https://www.intensivregister.de/api/public/reporting/laendertabelle
1654041917,24425,20395,4030,683,269,https://www.intensivregister.de/api/public/reporting/laendertabelle
1654045514,24425,20391,4034,682,269,https://www.intensivregister.de/api/public/reporting/laendertabelle
1654049116,24426,20400,4026,683,268,https://www.intensivregister.de/api/public/reporting/laendertabelle
1654056322,24419,20481,3938,675,263,https://www.intensivregister.de/api/public/reporting/laendertabelle
1654059916,24443,20542,3901,670,265,https://www.intensivregister.de/api/public/reporting/laendertabelle
1654067122,24436,20587,3849,677,266,https://www.intensivregister.de/api/public/reporting/laendertabelle
1654074317,24430,20566,3864,672,265,https://www.intensivregister.de/api/public/reporting/laendertabelle
1654077922,24432,20564,3868,670,264,https://www.intensivregister.de/api/public/reporting/laendertabelle
1654085121,24427,20560,3867,671,265,https://www.intensivregister.de/api/public/reporting/laendertabelle
1654088723,24427,20563,3864,671,265,https://www.intensivregister.de/api/public/reporting/laendertabelle
1654095921,24427,20564,3863,671,265,https://www.intensivregister.de/api/public/reporting/laendertabelle
1654113923,24427,20568,3859,671,265,https://www.intensivregister.de/api/public/reporting/laendertabelle
1654121115,24425,20551,3874,669,264,https://www.intensivregister.de/api/public/reporting/laendertabelle
1654128317,24433,20556,3877,669,264,https://www.intensivregister.de/api/public/reporting/laendertabelle
1654131918,24434,20558,3876,668,263,https://www.intensivregister.de/api/public/reporting/laendertabelle
1654135519,24434,20580,3854,667,262,https://www.intensivregister.de/api/public/reporting/laendertabelle
1654139120,24432,20568,3864,666,264,https://www.intensivregister.de/api/public/reporting/laendertabelle
1654142722,24421,20519,3902,660,263,https://www.intensivregister.de/api/public/reporting/laendertabelle
1654149914,24388,20462,3926,661,269,https://www.intensivregister.de/api/public/reporting/laendertabelle
1654153516,24389,20462,3927,655,269,https://www.intensivregister.de/api/public/reporting/laendertabelle
1654157117,24397,20475,3922,647,271,https://www.intensivregister.de/api/public/reporting/laendertabelle
1654160729,24411,20488,3923,643,269,https://www.intensivregister.de/api/public/reporting/laendertabelle
1654164331,24411,20483,3928,643,268,https://www.intensivregister.de/api/public/reporting/laendertabelle
1654167933,24411,20485,3926,644,268,https://www.intensivregister.de/api/public/reporting/laendertabelle
1654175115,24410,20494,3916,643,268,https://www.intensivregister.de/api/public/reporting/laendertabelle
1654185927,24410,20493,3917,643,268,https://www.intensivregister.de/api/public/reporting/laendertabelle
1654193130,24409,20492,3917,643,268,https://www.intensivregister.de/api/public/reporting/laendertabelle
1654200321,24408,20490,3918,643,268,https://www.intensivregister.de/api/public/reporting/laendertabelle
1654207515,24408,20487,3921,642,268,https://www.intensivregister.de/api/public/reporting/laendertabelle
1654214716,24408,20498,3910,641,267,https://www.intensivregister.de/api/public/reporting/laendertabelle
1654218329,24408,20500,3908,641,267,https://www.intensivregister.de/api/public/reporting/laendertabelle
1654221929,24401,20492,3909,641,267,https://www.intensivregister.de/api/public/reporting/laendertabelle
1654225524,24404,20500,3904,647,269,https://www.intensivregister.de/api/public/reporting/laendertabelle
1654232723,24385,20563,3822,637,264,https://www.intensivregister.de/api/public/reporting/laendertabelle
1654239930,24365,20610,3755,633,262,https://www.intensivregister.de/api/public/reporting/laendertabelle
1654243534,24364,20592,3772,636,263,https://www.intensivregister.de/api/public/reporting/laendertabelle
1654247126,24362,20592,3770,635,261,https://www.intensivregister.de/api/public/reporting/laendertabelle
1654250720,24354,20588,3766,635,261,https://www.intensivregister.de/api/public/reporting/laendertabelle
1654257916,24355,20582,3773,635,261,https://www.intensivregister.de/api/public/reporting/laendertabelle
1654261518,24355,20583,3772,635,261,https://www.intensivregister.de/api/public/reporting/laendertabelle
1654265120,24352,20582,3770,635,262,https://www.intensivregister.de/api/public/reporting/laendertabelle
1654272322,24353,20584,3769,635,262,https://www.intensivregister.de/api/public/reporting/laendertabelle
1654279533,24349,20587,3762,635,262,https://www.intensivregister.de/api/public/reporting/laendertabelle
1654293927,24348,20587,3761,634,262,https://www.intensivregister.de/api/public/reporting/laendertabelle
1654297519,24348,20585,3763,634,262,https://www.intensivregister.de/api/public/reporting/laendertabelle
1654301131,24350,20588,3762,634,262,https://www.intensivregister.de/api/public/reporting/laendertabelle
1654304733,24350,20583,3767,634,263,https://www.intensivregister.de/api/public/reporting/laendertabelle
1654311929,24324,20553,3771,628,262,https://www.intensivregister.de/api/public/reporting/laendertabelle
1654315526,24308,20519,3789,627,264,https://www.intensivregister.de/api/public/reporting/laendertabelle
1654322722,24257,20367,3890,621,261,https://www.intensivregister.de/api/public/reporting/laendertabelle
1654326329,24226,20290,3936,615,259,https://www.intensivregister.de/api/public/reporting/laendertabelle
1654329915,24208,20208,4000,614,259,https://www.intensivregister.de/api/public/reporting/laendertabelle
1654337120,24204,20185,4019,617,259,https://www.intensivregister.de/api/public/reporting/laendertabelle
1654344317,24204,20186,4018,617,259,https://www.intensivregister.de/api/public/reporting/laendertabelle
1654351530,24204,20183,4021,617,259,https://www.intensivregister.de/api/public/reporting/laendertabelle
1654355127,24201,20184,4017,617,259,https://www.intensivregister.de/api/public/reporting/laendertabelle
1654362331,24202,20188,4014,616,259,https://www.intensivregister.de/api/public/reporting/laendertabelle
1654373133,24202,20184,4018,617,259,https://www.intensivregister.de/api/public/reporting/laendertabelle
1654376721,24204,20172,4032,617,259,https://www.intensivregister.de/api/public/reporting/laendertabelle
1654380328,24204,20171,4033,617,259,https://www.intensivregister.de/api/public/reporting/laendertabelle
1654383916,24204,20168,4036,617,259,https://www.intensivregister.de/api/public/reporting/laendertabelle
1654387523,24198,20161,4037,617,259,https://www.intensivregister.de/api/public/reporting/laendertabelle
1654394729,24201,20172,4029,617,259,https://www.intensivregister.de/api/public/reporting/laendertabelle
1654398316,24206,20158,4048,618,259,https://www.intensivregister.de/api/public/reporting/laendertabelle
1654401933,24195,20086,4109,623,256,https://www.intensivregister.de/api/public/reporting/laendertabelle
1654409128,24161,19866,4295,621,255,https://www.intensivregister.de/api/public/reporting/laendertabelle
1654412725,24171,19795,4376,618,254,https://www.intensivregister.de/api/public/reporting/laendertabelle
1654416324,24140,19760,4380,614,252,https://www.intensivregister.de/api/public/reporting/laendertabelle
1654419922,24140,19748,4392,613,251,https://www.intensivregister.de/api/public/reporting/laendertabelle
1654427129,24140,19741,4399,611,251,https://www.intensivregister.de/api/public/reporting/laendertabelle
1654430726,24133,19730,4403,612,251,https://www.intensivregister.de/api/public/reporting/laendertabelle
1654437922,24135,19730,4405,613,251,https://www.intensivregister.de/api/public/reporting/laendertabelle
1654441530,24135,19735,4400,614,252,https://www.intensivregister.de/api/public/reporting/laendertabelle
1654445127,24135,19733,4402,614,252,https://www.intensivregister.de/api/public/reporting/laendertabelle
1654448716,24136,19735,4401,614,252,https://www.intensivregister.de/api/public/reporting/laendertabelle
1654452323,24136,19732,4404,613,252,https://www.intensivregister.de/api/public/reporting/laendertabelle
1654459527,24136,19734,4402,613,252,https://www.intensivregister.de/api/public/reporting/laendertabelle
1654466732,24137,19725,4412,612,252,https://www.intensivregister.de/api/public/reporting/laendertabelle
1654473916,24138,19709,4429,609,252,https://www.intensivregister.de/api/public/reporting/laendertabelle
1654481131,24137,19711,4426,608,252,https://www.intensivregister.de/api/public/reporting/laendertabelle
1654488313,24117,19635,4482,608,253,https://www.intensivregister.de/api/public/reporting/laendertabelle
1654495519,24070,19591,4479,630,261,https://www.intensivregister.de/api/public/reporting/laendertabelle
1654499127,24084,19571,4513,625,259,https://www.intensivregister.de/api/public/reporting/laendertabelle
1654506322,24080,19574,4506,631,259,https://www.intensivregister.de/api/public/reporting/laendertabelle
1654509930,24081,19569,4512,630,259,https://www.intensivregister.de/api/public/reporting/laendertabelle
1654517128,24081,19574,4507,630,259,https://www.intensivregister.de/api/public/reporting/laendertabelle
1654520715,24081,19575,4506,630,259,https://www.intensivregister.de/api/public/reporting/laendertabelle
1654524323,24081,19574,4507,630,259,https://www.intensivregister.de/api/public/reporting/laendertabelle
1654527921,24081,19576,4505,630,259,https://www.intensivregister.de/api/public/reporting/laendertabelle
1654531530,24083,19578,4505,630,259,https://www.intensivregister.de/api/public/reporting/laendertabelle
1654535119,24083,19577,4506,630,259,https://www.intensivregister.de/api/public/reporting/laendertabelle
1654542325,24083,19580,4503,630,259,https://www.intensivregister.de/api/public/reporting/laendertabelle
1654545932,24086,19585,4501,631,259,https://www.intensivregister.de/api/public/reporting/laendertabelle
1654549530,24087,19582,4505,632,259,https://www.intensivregister.de/api/public/reporting/laendertabelle
1654553128,24088,19588,4500,631,259,https://www.intensivregister.de/api/public/reporting/laendertabelle
1654560324,24087,19585,4502,632,259,https://www.intensivregister.de/api/public/reporting/laendertabelle
1654567526,24091,19600,4491,632,260,https://www.intensivregister.de/api/public/reporting/laendertabelle
1654574729,24093,19710,4383,614,254,https://www.intensivregister.de/api/public/reporting/laendertabelle
1654581933,24185,19863,4322,618,250,https://www.intensivregister.de/api/public/reporting/laendertabelle
1654585525,24177,19868,4309,625,254,https://www.intensivregister.de/api/public/reporting/laendertabelle
1654589127,24216,19914,4302,621,250,https://www.intensivregister.de/api/public/reporting/laendertabelle
1654592719,24231,19925,4306,620,247,https://www.intensivregister.de/api/public/reporting/laendertabelle
1654596322,24236,19925,4311,620,247,https://www.intensivregister.de/api/public/reporting/laendertabelle
1654599914,24236,19928,4308,620,247,https://www.intensivregister.de/api/public/reporting/laendertabelle
1654603516,24238,19926,4312,620,247,https://www.intensivregister.de/api/public/reporting/laendertabelle
1654610720,24239,19933,4306,621,247,https://www.intensivregister.de/api/public/reporting/laendertabelle
1654617922,24238,19935,4303,622,248,https://www.intensivregister.de/api/public/reporting/laendertabelle
1654625124,24238,19931,4307,622,248,https://www.intensivregister.de/api/public/reporting/laendertabelle
1654635925,24241,19939,4302,624,248,https://www.intensivregister.de/api/public/reporting/laendertabelle
1654643116,24242,19940,4302,626,248,https://www.intensivregister.de/api/public/reporting/laendertabelle
1654646717,24242,19936,4306,626,248,https://www.intensivregister.de/api/public/reporting/laendertabelle
1654650328,24247,19939,4308,627,248,https://www.intensivregister.de/api/public/reporting/laendertabelle
1654653918,24249,19945,4304,626,247,https://www.intensivregister.de/api/public/reporting/laendertabelle
1654661128,24277,20070,4207,637,250,https://www.intensivregister.de/api/public/reporting/laendertabelle
1654664730,24307,20237,4070,644,254,https://www.intensivregister.de/api/public/reporting/laendertabelle
1654668332,24327,20344,3983,629,252,https://www.intensivregister.de/api/public/reporting/laendertabelle
1654671923,24327,20382,3945,626,251,https://www.intensivregister.de/api/public/reporting/laendertabelle
1654675516,24318,20358,3960,622,251,https://www.intensivregister.de/api/public/reporting/laendertabelle
1654679130,24323,20362,3961,623,251,https://www.intensivregister.de/api/public/reporting/laendertabelle
1654686317,24323,20340,3983,618,249,https://www.intensivregister.de/api/public/reporting/laendertabelle
1654700727,24354,20371,3983,618,250,https://www.intensivregister.de/api/public/reporting/laendertabelle
1654722329,24354,20370,3984,618,250,https://www.intensivregister.de/api/public/reporting/laendertabelle
1654722329,24349,20364,3985,617,250,https://www.intensivregister.de/api/public/reporting/laendertabelle
1654729515,24351,20373,3978,614,250,https://www.intensivregister.de/api/public/reporting/laendertabelle
1654733123,24354,20372,3982,614,250,https://www.intensivregister.de/api/public/reporting/laendertabelle
1654736723,24363,20384,3979,612,249,https://www.intensivregister.de/api/public/reporting/laendertabelle
1654740322,24361,20392,3969,611,249,https://www.intensivregister.de/api/public/reporting/laendertabelle
1654743928,24369,20418,3951,601,246,https://www.intensivregister.de/api/public/reporting/laendertabelle
1654751129,24347,20476,3871,604,239,https://www.intensivregister.de/api/public/reporting/laendertabelle
1654754721,24366,20524,3842,612,239,https://www.intensivregister.de/api/public/reporting/laendertabelle
1654761917,24421,20596,3825,622,240,https://www.intensivregister.de/api/public/reporting/laendertabelle
1654765521,24419,20591,3828,623,239,https://www.intensivregister.de/api/public/reporting/laendertabelle
1654772722,24415,20580,3835,622,238,https://www.intensivregister.de/api/public/reporting/laendertabelle
1654808733,24403,20566,3837,621,238,https://www.intensivregister.de/api/public/reporting/laendertabelle
1654815925,24403,20564,3839,621,238,https://www.intensivregister.de/api/public/reporting/laendertabelle
1654819530,24403,20555,3848,623,239,https://www.intensivregister.de/api/public/reporting/laendertabelle
1654823122,24400,20544,3856,623,239,https://www.intensivregister.de/api/public/reporting/laendertabelle
1654830322,24381,20540,3841,630,244,https://www.intensivregister.de/api/public/reporting/laendertabelle
1654833924,24336,20437,3899,634,245,https://www.intensivregister.de/api/public/reporting/laendertabelle
1654837526,24320,20404,3916,635,245,https://www.intensivregister.de/api/public/reporting/laendertabelle
1654844722,24264,20339,3925,630,247,https://www.intensivregister.de/api/public/reporting/laendertabelle
1654848330,24247,20353,3894,627,246,https://www.intensivregister.de/api/public/reporting/laendertabelle
1654851935,24243,20346,3897,631,246,https://www.intensivregister.de/api/public/reporting/laendertabelle
1654855519,24241,20343,3898,628,246,https://www.intensivregister.de/api/public/reporting/laendertabelle
1654859126,24239,20343,3896,631,246,https://www.intensivregister.de/api/public/reporting/laendertabelle
1654866318,24236,20344,3892,631,246,https://www.intensivregister.de/api/public/reporting/laendertabelle
1654869924,24236,20340,3896,631,246,https://www.intensivregister.de/api/public/reporting/laendertabelle
1654877115,24236,20337,3899,631,246,https://www.intensivregister.de/api/public/reporting/laendertabelle
1654884323,24229,20333,3896,631,246,https://www.intensivregister.de/api/public/reporting/laendertabelle
1654891531,24230,20335,3895,631,246,https://www.intensivregister.de/api/public/reporting/laendertabelle
1654895115,24223,20318,3905,630,245,https://www.intensivregister.de/api/public/reporting/laendertabelle
1654902316,24222,20322,3900,628,245,https://www.intensivregister.de/api/public/reporting/laendertabelle
1654905924,24222,20320,3902,629,246,https://www.intensivregister.de/api/public/reporting/laendertabelle
1654909528,24223,20329,3894,628,246,https://www.intensivregister.de/api/public/reporting/laendertabelle
1654916718,24179,20297,3882,624,244,https://www.intensivregister.de/api/public/reporting/laendertabelle
1654920333,24158,20275,3883,621,241,https://www.intensivregister.de/api/public/reporting/laendertabelle
1654927515,24075,20182,3893,618,234,https://www.intensivregister.de/api/public/reporting/laendertabelle
1654931130,24075,20128,3947,603,230,https://www.intensivregister.de/api/public/reporting/laendertabelle
1654934725,24062,20078,3984,609,234,https://www.intensivregister.de/api/public/reporting/laendertabelle
1654938321,24063,20076,3987,609,234,https://www.intensivregister.de/api/public/reporting/laendertabelle
1654941915,24062,20077,3985,609,233,https://www.intensivregister.de/api/public/reporting/laendertabelle
1654945517,24062,20076,3986,610,234,https://www.intensivregister.de/api/public/reporting/laendertabelle
1654952718,24064,20072,3992,609,233,https://www.intensivregister.de/api/public/reporting/laendertabelle
1654956322,24064,20073,3991,609,233,https://www.intensivregister.de/api/public/reporting/laendertabelle
1654963523,24064,20072,3992,609,234,https://www.intensivregister.de/api/public/reporting/laendertabelle
1654967127,24064,20069,3995,609,234,https://www.intensivregister.de/api/public/reporting/laendertabelle
1654970732,24062,20061,4001,609,234,https://www.intensivregister.de/api/public/reporting/laendertabelle
1654974326,24061,20060,4001,610,234,https://www.intensivregister.de/api/public/reporting/laendertabelle
1654977922,24061,20057,4004,610,234,https://www.intensivregister.de/api/public/reporting/laendertabelle
1654981526,24061,20055,4006,611,234,https://www.intensivregister.de/api/public/reporting/laendertabelle
1654985114,24061,20055,4006,612,234,https://www.intensivregister.de/api/public/reporting/laendertabelle
1654992316,24059,20049,4010,613,234,https://www.intensivregister.de/api/public/reporting/laendertabelle
1654995921,24049,20041,4008,611,233,https://www.intensivregister.de/api/public/reporting/laendertabelle
1654999516,24046,20032,4014,614,234,https://www.intensivregister.de/api/public/reporting/laendertabelle
1655003133,24047,20019,4028,618,234,https://www.intensivregister.de/api/public/reporting/laendertabelle
1655006729,24044,19970,4074,621,234,https://www.intensivregister.de/api/public/reporting/laendertabelle
1655010324,24009,19865,4144,612,235,https://www.intensivregister.de/api/public/reporting/laendertabelle
1655013918,23978,19790,4188,613,233,https://www.intensivregister.de/api/public/reporting/laendertabelle
1655017529,23970,19756,4214,621,238,https://www.intensivregister.de/api/public/reporting/laendertabelle
1655024728,23950,19691,4259,621,239,https://www.intensivregister.de/api/public/reporting/laendertabelle
1655028323,23931,19673,4258,616,236,https://www.intensivregister.de/api/public/reporting/laendertabelle
1655031929,23930,19674,4256,616,236,https://www.intensivregister.de/api/public/reporting/laendertabelle
1655039119,23928,19678,4250,618,236,https://www.intensivregister.de/api/public/reporting/laendertabelle
1655046321,23927,19679,4248,618,236,https://www.intensivregister.de/api/public/reporting/laendertabelle
1655053523,23927,19681,4246,618,237,https://www.intensivregister.de/api/public/reporting/laendertabelle
1655057121,23926,19681,4245,618,237,https://www.intensivregister.de/api/public/reporting/laendertabelle
1655060716,23942,19696,4246,620,238,https://www.intensivregister.de/api/public/reporting/laendertabelle
1655067927,23943,19701,4242,622,238,https://www.intensivregister.de/api/public/reporting/laendertabelle
1655075130,23944,19691,4253,622,238,https://www.intensivregister.de/api/public/reporting/laendertabelle
1655082315,23944,19690,4254,622,238,https://www.intensivregister.de/api/public/reporting/laendertabelle
1655085932,23957,19694,4263,621,237,https://www.intensivregister.de/api/public/reporting/laendertabelle
1655089522,23973,19685,4288,625,238,https://www.intensivregister.de/api/public/reporting/laendertabelle
1655093130,24007,19725,4282,623,237,https://www.intensivregister.de/api/public/reporting/laendertabelle
1655100327,24102,19830,4272,652,243,https://www.intensivregister.de/api/public/reporting/laendertabelle
1655103926,24149,19881,4268,653,243,https://www.intensivregister.de/api/public/reporting/laendertabelle
1655107515,24148,19912,4236,651,241,https://www.intensivregister.de/api/public/reporting/laendertabelle
1655111114,24144,19905,4239,651,242,https://www.intensivregister.de/api/public/reporting/laendertabelle
1655118323,24142,19910,4232,654,243,https://www.intensivregister.de/api/public/reporting/laendertabelle
1655121922,24142,19910,4232,653,243,https://www.intensivregister.de/api/public/reporting/laendertabelle
1655129126,24142,19909,4233,653,243,https://www.intensivregister.de/api/public/reporting/laendertabelle
1655147124,24141,19908,4233,653,243,https://www.intensivregister.de/api/public/reporting/laendertabelle
1655150723,24141,19906,4235,653,243,https://www.intensivregister.de/api/public/reporting/laendertabelle
1655157929,24144,19910,4234,651,243,https://www.intensivregister.de/api/public/reporting/laendertabelle
1655161519,24146,19912,4234,651,243,https://www.intensivregister.de/api/public/reporting/laendertabelle
1655168727,24145,19915,4230,652,245,https://www.intensivregister.de/api/public/reporting/laendertabelle
1655172323,24148,19924,4224,652,245,https://www.intensivregister.de/api/public/reporting/laendertabelle
1655175921,24172,20010,4162,659,249,https://www.intensivregister.de/api/public/reporting/laendertabelle
1655183122,24223,20132,4091,657,248,https://www.intensivregister.de/api/public/reporting/laendertabelle
1655190322,24279,20256,4023,669,246,https://www.intensivregister.de/api/public/reporting/laendertabelle
1655193931,24268,20285,3983,675,245,https://www.intensivregister.de/api/public/reporting/laendertabelle
1655201122,24265,20277,3988,674,242,https://www.intensivregister.de/api/public/reporting/laendertabelle
1655208331,24253,20263,3990,673,242,https://www.intensivregister.de/api/public/reporting/laendertabelle
1655211931,24253,20266,3987,672,242,https://www.intensivregister.de/api/public/reporting/laendertabelle
1655215520,24253,20268,3985,672,242,https://www.intensivregister.de/api/public/reporting/laendertabelle
1655222725,24250,20267,3983,671,242,https://www.intensivregister.de/api/public/reporting/laendertabelle
1655237129,24250,20262,3988,672,242,https://www.intensivregister.de/api/public/reporting/laendertabelle
1655240719,24249,20264,3985,673,242,https://www.intensivregister.de/api/public/reporting/laendertabelle
1655247914,24253,20267,3986,672,242,https://www.intensivregister.de/api/public/reporting/laendertabelle
1655251522,24252,20271,3981,672,242,https://www.intensivregister.de/api/public/reporting/laendertabelle
1655255115,24252,20268,3984,671,241,https://www.intensivregister.de/api/public/reporting/laendertabelle
1655262323,24278,20345,3933,664,238,https://www.intensivregister.de/api/public/reporting/laendertabelle
1655265920,24324,20378,3946,660,238,https://www.intensivregister.de/api/public/reporting/laendertabelle
1655273129,24300,20389,3911,670,233,https://www.intensivregister.de/api/public/reporting/laendertabelle
1655276726,24303,20407,3896,668,234,https://www.intensivregister.de/api/public/reporting/laendertabelle
1655280314,24299,20427,3872,666,232,https://www.intensivregister.de/api/public/reporting/laendertabelle
1655283921,24318,20455,3863,668,233,https://www.intensivregister.de/api/public/reporting/laendertabelle
1655287530,24318,20463,3855,673,233,https://www.intensivregister.de/api/public/reporting/laendertabelle
1655291127,24318,20464,3854,675,234,https://www.intensivregister.de/api/public/reporting/laendertabelle
1655298330,24317,20471,3846,674,234,https://www.intensivregister.de/api/public/reporting/laendertabelle
1655301915,24292,20450,3842,673,233,https://www.intensivregister.de/api/public/reporting/laendertabelle
1655305531,24292,20451,3841,673,233,https://www.intensivregister.de/api/public/reporting/laendertabelle
1655319923,24292,20450,3842,673,233,https://www.intensivregister.de/api/public/reporting/laendertabelle
1655330728,24293,20448,3845,671,232,https://www.intensivregister.de/api/public/reporting/laendertabelle
1655334323,24293,20453,3840,671,232,https://www.intensivregister.de/api/public/reporting/laendertabelle
1655337928,24294,20452,3842,670,232,https://www.intensivregister.de/api/public/reporting/laendertabelle
1655345130,24296,20472,3824,670,231,https://www.intensivregister.de/api/public/reporting/laendertabelle
1655348726,24294,20494,3800,680,235,https://www.intensivregister.de/api/public/reporting/laendertabelle
1655352334,24289,20518,3771,667,237,https://www.intensivregister.de/api/public/reporting/laendertabelle
1655355920,24255,20481,3774,666,239,https://www.intensivregister.de/api/public/reporting/laendertabelle
1655363124,24260,20440,3820,687,246,https://www.intensivregister.de/api/public/reporting/laendertabelle
1655366730,24256,20429,3827,681,245,https://www.intensivregister.de/api/public/reporting/laendertabelle
1655370318,24254,20423,3831,680,245,https://www.intensivregister.de/api/public/reporting/laendertabelle
1655373915,24252,20406,3846,681,245,https://www.intensivregister.de/api/public/reporting/laendertabelle
1655381128,24251,20394,3857,681,245,https://www.intensivregister.de/api/public/reporting/laendertabelle
1655384725,24251,20392,3859,682,245,https://www.intensivregister.de/api/public/reporting/laendertabelle
1655388322,24248,20390,3858,681,245,https://www.intensivregister.de/api/public/reporting/laendertabelle
1655399117,24248,20391,3857,681,245,https://www.intensivregister.de/api/public/reporting/laendertabelle
1655402724,24248,20389,3859,683,247,https://www.intensivregister.de/api/public/reporting/laendertabelle
1655413523,24247,20382,3865,684,247,https://www.intensivregister.de/api/public/reporting/laendertabelle
1655417132,24247,20382,3865,682,247,https://www.intensivregister.de/api/public/reporting/laendertabelle
1655420719,24245,20379,3866,684,247,https://www.intensivregister.de/api/public/reporting/laendertabelle
1655424328,24245,20376,3869,683,247,https://www.intensivregister.de/api/public/reporting/laendertabelle
1655427927,24245,20369,3876,683,247,https://www.intensivregister.de/api/public/reporting/laendertabelle
1655431516,24238,20355,3883,684,247,https://www.intensivregister.de/api/public/reporting/laendertabelle
1655435126,24204,20342,3862,686,245,https://www.intensivregister.de/api/public/reporting/laendertabelle
1655438718,24199,20333,3866,687,245,https://www.intensivregister.de/api/public/reporting/laendertabelle
1655442328,24162,20288,3874,686,247,https://www.intensivregister.de/api/public/reporting/laendertabelle
1655445921,24135,20218,3917,686,245,https://www.intensivregister.de/api/public/reporting/laendertabelle
1655449532,24098,20162,3936,687,244,https://www.intensivregister.de/api/public/reporting/laendertabelle
1655456733,24083,20150,3933,691,245,https://www.intensivregister.de/api/public/reporting/laendertabelle
1655460315,24079,20152,3927,694,245,https://www.intensivregister.de/api/public/reporting/laendertabelle
1655463914,24079,20149,3930,694,245,https://www.intensivregister.de/api/public/reporting/laendertabelle
1655467513,24079,20151,3928,695,245,https://www.intensivregister.de/api/public/reporting/laendertabelle
1655471133,24079,20150,3929,695,245,https://www.intensivregister.de/api/public/reporting/laendertabelle
1655478322,24074,20155,3919,696,246,https://www.intensivregister.de/api/public/reporting/laendertabelle
1655485529,24074,20159,3915,696,246,https://www.intensivregister.de/api/public/reporting/laendertabelle
1655496326,24075,20161,3914,696,246,https://www.intensivregister.de/api/public/reporting/laendertabelle
1655503524,24063,20138,3925,695,245,https://www.intensivregister.de/api/public/reporting/laendertabelle
1655507132,24062,20139,3923,695,245,https://www.intensivregister.de/api/public/reporting/laendertabelle
1655510721,24062,20142,3920,695,245,https://www.intensivregister.de/api/public/reporting/laendertabelle
1655514330,24064,20140,3924,695,245,https://www.intensivregister.de/api/public/reporting/laendertabelle
1655521528,24042,20118,3924,700,246,https://www.intensivregister.de/api/public/reporting/laendertabelle
1655528717,23968,19964,4004,684,241,https://www.intensivregister.de/api/public/reporting/laendertabelle
1655532329,23929,19914,4015,679,236,https://www.intensivregister.de/api/public/reporting/laendertabelle
1655539519,23888,19840,4048,690,239,https://www.intensivregister.de/api/public/reporting/laendertabelle
1655543118,23883,19817,4066,690,239,https://www.intensivregister.de/api/public/reporting/laendertabelle
1655550319,23882,19807,4075,690,239,https://www.intensivregister.de/api/public/reporting/laendertabelle
1655553918,23882,19807,4075,689,239,https://www.intensivregister.de/api/public/reporting/laendertabelle
1655557527,23882,19803,4079,689,239,https://www.intensivregister.de/api/public/reporting/laendertabelle
1655561118,23882,19808,4074,689,239,https://www.intensivregister.de/api/public/reporting/laendertabelle
1655564719,23882,19805,4077,689,239,https://www.intensivregister.de/api/public/reporting/laendertabelle
1655575529,23880,19803,4077,689,239,https://www.intensivregister.de/api/public/reporting/laendertabelle
1655582717,23880,19802,4078,689,239,https://www.intensivregister.de/api/public/reporting/laendertabelle
1655589928,23880,19783,4097,687,238,https://www.intensivregister.de/api/public/reporting/laendertabelle
1655589928,23879,19778,4101,688,238,https://www.intensivregister.de/api/public/reporting/laendertabelle
1655597132,23879,19784,4095,690,238,https://www.intensivregister.de/api/public/reporting/laendertabelle
1655604316,23878,19773,4105,690,237,https://www.intensivregister.de/api/public/reporting/laendertabelle
1655607928,23875,19775,4100,692,239,https://www.intensivregister.de/api/public/reporting/laendertabelle
1655611522,23836,19732,4104,701,242,https://www.intensivregister.de/api/public/reporting/laendertabelle
1655615117,23815,19663,4152,712,240,https://www.intensivregister.de/api/public/reporting/laendertabelle
1655618721,23791,19600,4191,711,237,https://www.intensivregister.de/api/public/reporting/laendertabelle
1655622333,23764,19566,4198,715,241,https://www.intensivregister.de/api/public/reporting/laendertabelle
1655629530,23760,19542,4218,718,242,https://www.intensivregister.de/api/public/reporting/laendertabelle
1655633123,23760,19540,4220,719,243,https://www.intensivregister.de/api/public/reporting/laendertabelle
1655636716,23759,19537,4222,718,243,https://www.intensivregister.de/api/public/reporting/laendertabelle
1655643922,23757,19537,4220,718,243,https://www.intensivregister.de/api/public/reporting/laendertabelle
1655651121,23757,19536,4221,718,243,https://www.intensivregister.de/api/public/reporting/laendertabelle
1655658326,23757,19535,4222,717,242,https://www.intensivregister.de/api/public/reporting/laendertabelle
1655665522,23741,19519,4222,714,241,https://www.intensivregister.de/api/public/reporting/laendertabelle
1655672728,23738,19516,4222,715,240,https://www.intensivregister.de/api/public/reporting/laendertabelle
1655679925,23736,19518,4218,715,240,https://www.intensivregister.de/api/public/reporting/laendertabelle
1655683519,23737,19524,4213,717,242,https://www.intensivregister.de/api/public/reporting/laendertabelle
1655687122,23736,19524,4212,716,242,https://www.intensivregister.de/api/public/reporting/laendertabelle
1655690715,23745,19548,4197,716,242,https://www.intensivregister.de/api/public/reporting/laendertabelle
1655694330,23759,19568,4191,708,233,https://www.intensivregister.de/api/public/reporting/laendertabelle
1655697918,23787,19626,4161,712,237,https://www.intensivregister.de/api/public/reporting/laendertabelle
1655701517,23879,19728,4151,723,230,https://www.intensivregister.de/api/public/reporting/laendertabelle
1655708717,23963,19821,4142,744,232,https://www.intensivregister.de/api/public/reporting/laendertabelle
1655712316,23971,19828,4143,744,233,https://www.intensivregister.de/api/public/reporting/laendertabelle
1655715925,23974,19844,4130,747,234,https://www.intensivregister.de/api/public/reporting/laendertabelle
1655719525,23977,19853,4124,750,234,https://www.intensivregister.de/api/public/reporting/laendertabelle
1655723115,23977,19852,4125,749,234,https://www.intensivregister.de/api/public/reporting/laendertabelle
1655730332,23989,19862,4127,755,234,https://www.intensivregister.de/api/public/reporting/laendertabelle
1655733929,23991,19866,4125,755,234,https://www.intensivregister.de/api/public/reporting/laendertabelle
1655741124,23989,19864,4125,755,234,https://www.intensivregister.de/api/public/reporting/laendertabelle
1655762714,23988,19855,4133,755,234,https://www.intensivregister.de/api/public/reporting/laendertabelle
1655766329,23996,19853,4143,756,234,https://www.intensivregister.de/api/public/reporting/laendertabelle
1655769919,23997,19859,4138,753,234,https://www.intensivregister.de/api/public/reporting/laendertabelle
1655773522,23996,19860,4136,756,234,https://www.intensivregister.de/api/public/reporting/laendertabelle
1655777125,23996,19858,4138,757,235,https://www.intensivregister.de/api/public/reporting/laendertabelle
1655784323,24064,20000,4064,772,236,https://www.intensivregister.de/api/public/reporting/laendertabelle
1655787931,24094,20222,3872,782,237,https://www.intensivregister.de/api/public/reporting/laendertabelle
1655791519,24126,20293,3833,788,238,https://www.intensivregister.de/api/public/reporting/laendertabelle
1655798725,24189,20393,3796,796,237,https://www.intensivregister.de/api/public/reporting/laendertabelle
1655802314,24188,20403,3785,795,238,https://www.intensivregister.de/api/public/reporting/laendertabelle
1655809519,24186,20411,3775,796,238,https://www.intensivregister.de/api/public/reporting/laendertabelle
1655813132,24186,20414,3772,796,238,https://www.intensivregister.de/api/public/reporting/laendertabelle
1655820315,24186,20411,3775,796,238,https://www.intensivregister.de/api/public/reporting/laendertabelle
1655827533,24182,20407,3775,796,238,https://www.intensivregister.de/api/public/reporting/laendertabelle
1655834730,24182,20409,3773,796,238,https://www.intensivregister.de/api/public/reporting/laendertabelle
1655838328,24182,20407,3775,796,238,https://www.intensivregister.de/api/public/reporting/laendertabelle
1655841914,24182,20410,3772,796,238,https://www.intensivregister.de/api/public/reporting/laendertabelle
1655849119,24184,20406,3778,798,239,https://www.intensivregister.de/api/public/reporting/laendertabelle
1655852727,24185,20400,3785,797,239,https://www.intensivregister.de/api/public/reporting/laendertabelle
1655859925,24187,20411,3776,797,240,https://www.intensivregister.de/api/public/reporting/laendertabelle
1655863519,24188,20402,3786,798,241,https://www.intensivregister.de/api/public/reporting/laendertabelle
1655867124,24187,20409,3778,799,238,https://www.intensivregister.de/api/public/reporting/laendertabelle
1655870719,24177,20449,3728,780,240,https://www.intensivregister.de/api/public/reporting/laendertabelle
1655874326,24159,20439,3720,772,245,https://www.intensivregister.de/api/public/reporting/laendertabelle
1655877914,24162,20461,3701,773,244,https://www.intensivregister.de/api/public/reporting/laendertabelle
1655881532,24145,20465,3680,777,244,https://www.intensivregister.de/api/public/reporting/laendertabelle
1655885131,24151,20458,3693,780,248,https://www.intensivregister.de/api/public/reporting/laendertabelle
1655888718,24157,20462,3695,780,248,https://www.intensivregister.de/api/public/reporting/laendertabelle
1655892333,24161,20470,3691,780,247,https://www.intensivregister.de/api/public/reporting/laendertabelle
1655895917,24162,20470,3692,780,247,https://www.intensivregister.de/api/public/reporting/laendertabelle
1655903127,24160,20475,3685,781,247,https://www.intensivregister.de/api/public/reporting/laendertabelle
1655910328,24157,20474,3683,781,247,https://www.intensivregister.de/api/public/reporting/laendertabelle
1655913933,24155,20473,3682,781,247,https://www.intensivregister.de/api/public/reporting/laendertabelle
1655917527,24155,20477,3678,781,247,https://www.intensivregister.de/api/public/reporting/laendertabelle
1655928322,24157,20479,3678,782,247,https://www.intensivregister.de/api/public/reporting/laendertabelle
1655931915,24157,20479,3678,780,247,https://www.intensivregister.de/api/public/reporting/laendertabelle
1655935529,24157,20476,3681,780,247,https://www.intensivregister.de/api/public/reporting/laendertabelle
1655942725,24156,20474,3682,781,248,https://www.intensivregister.de/api/public/reporting/laendertabelle
1655949914,24154,20475,3679,779,247,https://www.intensivregister.de/api/public/reporting/laendertabelle
1655957123,24164,20558,3606,791,248,https://www.intensivregister.de/api/public/reporting/laendertabelle
1655960714,24154,20599,3555,809,251,https://www.intensivregister.de/api/public/reporting/laendertabelle
1655964313,24151,20600,3551,809,258,https://www.intensivregister.de/api/public/reporting/laendertabelle
1655971520,24143,20602,3541,810,263,https://www.intensivregister.de/api/public/reporting/laendertabelle
1655975118,24147,20609,3538,809,263,https://www.intensivregister.de/api/public/reporting/laendertabelle
1655978717,24145,20612,3533,808,263,https://www.intensivregister.de/api/public/reporting/laendertabelle
1655985914,24138,20600,3538,807,264,https://www.intensivregister.de/api/public/reporting/laendertabelle
1655993119,24138,20598,3540,807,264,https://www.intensivregister.de/api/public/reporting/laendertabelle
1656000322,24140,20598,3542,807,264,https://www.intensivregister.de/api/public/reporting/laendertabelle
1656003929,24141,20600,3541,807,264,https://www.intensivregister.de/api/public/reporting/laendertabelle
1656014727,24141,20599,3542,807,264,https://www.intensivregister.de/api/public/reporting/laendertabelle
1656018333,24139,20606,3533,805,261,https://www.intensivregister.de/api/public/reporting/laendertabelle
1656021919,24138,20601,3537,803,260,https://www.intensivregister.de/api/public/reporting/laendertabelle
1656025516,24138,20604,3534,803,260,https://www.intensivregister.de/api/public/reporting/laendertabelle
1656032719,24139,20602,3537,803,261,https://www.intensivregister.de/api/public/reporting/laendertabelle
1656039933,24124,20603,3521,808,261,https://www.intensivregister.de/api/public/reporting/laendertabelle
1656043530,24101,20537,3564,802,256,https://www.intensivregister.de/api/public/reporting/laendertabelle
1656050726,24036,20481,3555,799,254,https://www.intensivregister.de/api/public/reporting/laendertabelle
1656054314,24030,20444,3586,799,255,https://www.intensivregister.de/api/public/reporting/laendertabelle
1656057931,24010,20433,3577,799,252,https://www.intensivregister.de/api/public/reporting/laendertabelle
1656065119,24012,20446,3566,799,252,https://www.intensivregister.de/api/public/reporting/laendertabelle
1656072327,24013,20448,3565,801,253,https://www.intensivregister.de/api/public/reporting/laendertabelle
1656075917,24019,20449,3570,804,255,https://www.intensivregister.de/api/public/reporting/laendertabelle
1656083132,24017,20451,3566,804,256,https://www.intensivregister.de/api/public/reporting/laendertabelle
1656090327,24016,20451,3565,804,256,https://www.intensivregister.de/api/public/reporting/laendertabelle
1656093926,24016,20451,3565,805,256,https://www.intensivregister.de/api/public/reporting/laendertabelle
1656097515,24016,20450,3566,805,256,https://www.intensivregister.de/api/public/reporting/laendertabelle
1656104722,24009,20442,3567,805,256,https://www.intensivregister.de/api/public/reporting/laendertabelle
1656108321,24010,20430,3580,806,256,https://www.intensivregister.de/api/public/reporting/laendertabelle
1656111927,24006,20430,3576,805,256,https://www.intensivregister.de/api/public/reporting/laendertabelle
1656115524,24005,20436,3569,807,256,https://www.intensivregister.de/api/public/reporting/laendertabelle
1656119121,24003,20436,3567,809,256,https://www.intensivregister.de/api/public/reporting/laendertabelle
1656122717,24007,20432,3575,809,256,https://www.intensivregister.de/api/public/reporting/laendertabelle
1656129922,23970,20425,3545,813,254,https://www.intensivregister.de/api/public/reporting/laendertabelle
1656133517,23937,20303,3634,799,254,https://www.intensivregister.de/api/public/reporting/laendertabelle
1656140730,23876,20202,3674,792,250,https://www.intensivregister.de/api/public/reporting/laendertabelle
1656144325,23864,20131,3733,792,250,https://www.intensivregister.de/api/public/reporting/laendertabelle
1656151528,23861,20107,3754,790,250,https://www.intensivregister.de/api/public/reporting/laendertabelle
1656158720,23858,20100,3758,792,250,https://www.intensivregister.de/api/public/reporting/laendertabelle
1656165923,23858,20091,3767,792,250,https://www.intensivregister.de/api/public/reporting/laendertabelle
1656173124,23858,20092,3766,792,250,https://www.intensivregister.de/api/public/reporting/laendertabelle
1656176730,23858,20093,3765,793,250,https://www.intensivregister.de/api/public/reporting/laendertabelle
1656180324,23858,20088,3770,792,250,https://www.intensivregister.de/api/public/reporting/laendertabelle
1656187523,23858,20084,3774,792,250,https://www.intensivregister.de/api/public/reporting/laendertabelle
1656194716,23847,20083,3764,793,251,https://www.intensivregister.de/api/public/reporting/laendertabelle
1656198322,23847,20086,3761,792,251,https://www.intensivregister.de/api/public/reporting/laendertabelle
1656201916,23847,20086,3761,791,251,https://www.intensivregister.de/api/public/reporting/laendertabelle
1656205529,23849,20088,3761,791,251,https://www.intensivregister.de/api/public/reporting/laendertabelle
1656209115,23850,20098,3752,792,251,https://www.intensivregister.de/api/public/reporting/laendertabelle
1656212729,23837,20059,3778,795,252,https://www.intensivregister.de/api/public/reporting/laendertabelle
1656216323,23833,20011,3822,798,253,https://www.intensivregister.de/api/public/reporting/laendertabelle
1656223526,23744,19884,3860,821,266,https://www.intensivregister.de/api/public/reporting/laendertabelle
1656227133,23743,19888,3855,825,266,https://www.intensivregister.de/api/public/reporting/laendertabelle
1656230730,23745,19859,3886,837,270,https://www.intensivregister.de/api/public/reporting/laendertabelle
1656237926,23754,19856,3898,839,269,https://www.intensivregister.de/api/public/reporting/laendertabelle
1656245132,23748,19845,3903,841,270,https://www.intensivregister.de/api/public/reporting/laendertabelle
1656248719,23749,19846,3903,841,270,https://www.intensivregister.de/api/public/reporting/laendertabelle
1656263127,23749,19846,3903,843,270,https://www.intensivregister.de/api/public/reporting/laendertabelle
1656270324,23748,19848,3900,841,269,https://www.intensivregister.de/api/public/reporting/laendertabelle
1656277515,23752,19847,3905,842,269,https://www.intensivregister.de/api/public/reporting/laendertabelle
1656284727,23752,19847,3905,841,270,https://www.intensivregister.de/api/public/reporting/laendertabelle
1656288324,23751,19844,3907,840,270,https://www.intensivregister.de/api/public/reporting/laendertabelle
1656295526,23757,19841,3916,839,270,https://www.intensivregister.de/api/public/reporting/laendertabelle
1656299113,23789,19864,3925,847,269,https://www.intensivregister.de/api/public/reporting/laendertabelle
1656302730,23850,19917,3933,858,281,https://www.intensivregister.de/api/public/reporting/laendertabelle
1656306329,23891,19984,3907,877,283,https://www.intensivregister.de/api/public/reporting/laendertabelle
1656313524,23949,20002,3947,916,291,https://www.intensivregister.de/api/public/reporting/laendertabelle
1656317114,23940,19987,3953,927,291,https://www.intensivregister.de/api/public/reporting/laendertabelle
1656324320,23943,19988,3955,930,292,https://www.intensivregister.de/api/public/reporting/laendertabelle
1656327918,23951,19995,3956,931,291,https://www.intensivregister.de/api/public/reporting/laendertabelle
1656335118,23953,19984,3969,934,292,https://www.intensivregister.de/api/public/reporting/laendertabelle
1656342324,23953,19986,3967,934,292,https://www.intensivregister.de/api/public/reporting/laendertabelle
1656349523,23952,19987,3965,937,292,https://www.intensivregister.de/api/public/reporting/laendertabelle
1656356731,23976,20006,3970,937,292,https://www.intensivregister.de/api/public/reporting/laendertabelle
1656360330,23978,20008,3970,935,293,https://www.intensivregister.de/api/public/reporting/laendertabelle
1656363921,23982,20012,3970,937,293,https://www.intensivregister.de/api/public/reporting/laendertabelle
1656367530,23981,20008,3973,937,293,https://www.intensivregister.de/api/public/reporting/laendertabelle
1656371128,23983,20017,3966,937,293,https://www.intensivregister.de/api/public/reporting/laendertabelle
1656374714,23981,20014,3967,937,293,https://www.intensivregister.de/api/public/reporting/laendertabelle
1656378323,23976,20009,3967,935,293,https://www.intensivregister.de/api/public/reporting/laendertabelle
1656381931,23978,20023,3955,938,293,https://www.intensivregister.de/api/public/reporting/laendertabelle
1656385520,23995,20058,3937,943,292,https://www.intensivregister.de/api/public/reporting/laendertabelle
1656389122,24025,20084,3941,951,295,https://www.intensivregister.de/api/public/reporting/laendertabelle
1656392728,24054,20278,3776,966,300,https://www.intensivregister.de/api/public/reporting/laendertabelle
1656396319,24098,20365,3733,980,297,https://www.intensivregister.de/api/public/reporting/laendertabelle
1656403520,24092,20410,3682,982,300,https://www.intensivregister.de/api/public/reporting/laendertabelle
1656410726,24092,20418,3674,984,301,https://www.intensivregister.de/api/public/reporting/laendertabelle
1656414325,24090,20422,3668,980,298,https://www.intensivregister.de/api/public/reporting/laendertabelle
1656417925,24100,20438,3662,984,298,https://www.intensivregister.de/api/public/reporting/laendertabelle
1656421529,24102,20441,3661,984,298,https://www.intensivregister.de/api/public/reporting/laendertabelle
1656432331,24102,20440,3662,984,297,https://www.intensivregister.de/api/public/reporting/laendertabelle
1656446728,24102,20439,3663,984,297,https://www.intensivregister.de/api/public/reporting/laendertabelle
1656450324,24102,20444,3658,985,298,https://www.intensivregister.de/api/public/reporting/laendertabelle
1656453933,24103,20450,3653,985,298,https://www.intensivregister.de/api/public/reporting/laendertabelle
1656457530,24104,20451,3653,985,298,https://www.intensivregister.de/api/public/reporting/laendertabelle
1656461116,24104,20452,3652,985,298,https://www.intensivregister.de/api/public/reporting/laendertabelle
1656464713,24105,20448,3657,986,298,https://www.intensivregister.de/api/public/reporting/laendertabelle
1656468315,24104,20457,3647,986,298,https://www.intensivregister.de/api/public/reporting/laendertabelle
1656475520,24108,20481,3627,980,296,https://www.intensivregister.de/api/public/reporting/laendertabelle
1656482732,24127,20527,3600,942,294,https://www.intensivregister.de/api/public/reporting/laendertabelle
1656489915,24116,20505,3611,934,286,https://www.intensivregister.de/api/public/reporting/laendertabelle
1656493523,24116,20498,3618,935,287,https://www.intensivregister.de/api/public/reporting/laendertabelle
1656497123,24114,20494,3620,935,287,https://www.intensivregister.de/api/public/reporting/laendertabelle
1656500716,24109,20493,3616,935,288,https://www.intensivregister.de/api/public/reporting/laendertabelle
1656507917,24107,20492,3615,935,286,https://www.intensivregister.de/api/public/reporting/laendertabelle
1656511517,24106,20492,3614,935,286,https://www.intensivregister.de/api/public/reporting/laendertabelle
1656515125,24108,20494,3614,935,286,https://www.intensivregister.de/api/public/reporting/laendertabelle
1656518713,24108,20495,3613,935,286,https://www.intensivregister.de/api/public/reporting/laendertabelle
1656529518,24108,20486,3622,935,286,https://www.intensivregister.de/api/public/reporting/laendertabelle
1656533121,24108,20485,3623,934,286,https://www.intensivregister.de/api/public/reporting/laendertabelle
1656536723,24108,20483,3625,934,286,https://www.intensivregister.de/api/public/reporting/laendertabelle
1656543922,24108,20479,3629,931,286,https://www.intensivregister.de/api/public/reporting/laendertabelle
1656551126,24114,20483,3631,930,285,https://www.intensivregister.de/api/public/reporting/laendertabelle
1656554723,24108,20475,3633,928,284,https://www.intensivregister.de/api/public/reporting/laendertabelle
1656558332,24110,20464,3646,928,284,https://www.intensivregister.de/api/public/reporting/laendertabelle
1656561919,24114,20436,3678,946,288,https://www.intensivregister.de/api/public/reporting/laendertabelle
1656569129,24069,20402,3667,943,293,https://www.intensivregister.de/api/public/reporting/laendertabelle
1656572724,24055,20375,3680,944,290,https://www.intensivregister.de/api/public/reporting/laendertabelle
1656579917,24050,20352,3698,935,289,https://www.intensivregister.de/api/public/reporting/laendertabelle
1656587118,24064,20358,3706,936,289,https://www.intensivregister.de/api/public/reporting/laendertabelle
1656590725,24064,20357,3707,936,289,https://www.intensivregister.de/api/public/reporting/laendertabelle
1656594314,24064,20357,3707,935,289,https://www.intensivregister.de/api/public/reporting/laendertabelle
1656597915,24064,20361,3703,935,289,https://www.intensivregister.de/api/public/reporting/laendertabelle
1656605114,24064,20356,3708,934,289,https://www.intensivregister.de/api/public/reporting/laendertabelle
1656612317,24064,20353,3711,934,289,https://www.intensivregister.de/api/public/reporting/laendertabelle
1656615933,24064,20352,3712,934,289,https://www.intensivregister.de/api/public/reporting/laendertabelle
1656619520,24061,20346,3715,934,289,https://www.intensivregister.de/api/public/reporting/laendertabelle
1656623116,24060,20346,3714,937,290,https://www.intensivregister.de/api/public/reporting/laendertabelle
1656626723,24060,20346,3714,936,290,https://www.intensivregister.de/api/public/reporting/laendertabelle
1656633925,24061,20349,3712,936,290,https://www.intensivregister.de/api/public/reporting/laendertabelle
1656641128,24059,20340,3719,936,290,https://www.intensivregister.de/api/public/reporting/laendertabelle
1656644735,24048,20355,3693,938,292,https://www.intensivregister.de/api/public/reporting/laendertabelle
1656648330,24015,20335,3680,934,294,https://www.intensivregister.de/api/public/reporting/laendertabelle
1656655534,23948,20340,3608,951,291,https://www.intensivregister.de/api/public/reporting/laendertabelle
1656659126,23937,20336,3601,968,292,https://www.intensivregister.de/api/public/reporting/laendertabelle
1656662729,23956,20341,3615,977,290,https://www.intensivregister.de/api/public/reporting/laendertabelle
1656666329,23960,20352,3608,976,289,https://www.intensivregister.de/api/public/reporting/laendertabelle
1656669935,23952,20351,3601,977,290,https://www.intensivregister.de/api/public/reporting/laendertabelle
1656673522,23950,20350,3600,978,290,https://www.intensivregister.de/api/public/reporting/laendertabelle
1656677129,23949,20348,3601,977,290,https://www.intensivregister.de/api/public/reporting/laendertabelle
1656680729,23947,20345,3602,977,290,https://www.intensivregister.de/api/public/reporting/laendertabelle
1656687927,23948,20342,3606,977,291,https://www.intensivregister.de/api/public/reporting/laendertabelle
1656702318,23948,20341,3607,975,291,https://www.intensivregister.de/api/public/reporting/laendertabelle
1656705930,23915,20310,3605,974,291,https://www.intensivregister.de/api/public/reporting/laendertabelle
1656713125,23916,20296,3620,971,291,https://www.intensivregister.de/api/public/reporting/laendertabelle
1656720320,23912,20295,3617,971,291,https://www.intensivregister.de/api/public/reporting/laendertabelle
1656727523,23911,20298,3613,966,290,https://www.intensivregister.de/api/public/reporting/laendertabelle
1656731130,23903,20290,3613,966,286,https://www.intensivregister.de/api/public/reporting/laendertabelle
1656734733,23851,20183,3668,958,280,https://www.intensivregister.de/api/public/reporting/laendertabelle
1656738321,23794,20051,3743,986,286,https://www.intensivregister.de/api/public/reporting/laendertabelle
1656741923,23734,19970,3764,988,292,https://www.intensivregister.de/api/public/reporting/laendertabelle
1656749134,23682,19896,3786,980,296,https://www.intensivregister.de/api/public/reporting/laendertabelle
1656756324,23677,19886,3791,983,298,https://www.intensivregister.de/api/public/reporting/laendertabelle
1656763521,23675,19884,3791,986,298,https://www.intensivregister.de/api/public/reporting/laendertabelle
1656774326,23675,19882,3793,975,298,https://www.intensivregister.de/api/public/reporting/laendertabelle
1656777923,23675,19883,3792,975,298,https://www.intensivregister.de/api/public/reporting/laendertabelle
1656788734,23675,19880,3795,976,299,https://www.intensivregister.de/api/public/reporting/laendertabelle
1656792335,23675,19881,3794,976,299,https://www.intensivregister.de/api/public/reporting/laendertabelle
1656799524,23671,19861,3810,973,299,https://www.intensivregister.de/api/public/reporting/laendertabelle
1656803129,23646,19848,3798,977,299,https://www.intensivregister.de/api/public/reporting/laendertabelle
1656806723,23641,19842,3799,978,299,https://www.intensivregister.de/api/public/reporting/laendertabelle
1656810326,23642,19835,3807,979,299,https://www.intensivregister.de/api/public/reporting/laendertabelle
1656813930,23640,19830,3810,979,300,https://www.intensivregister.de/api/public/reporting/laendertabelle
1656817533,23640,19817,3823,983,299,https://www.intensivregister.de/api/public/reporting/laendertabelle
1656821126,23626,19773,3853,977,298,https://www.intensivregister.de/api/public/reporting/laendertabelle
1656828329,23597,19658,3939,984,303,https://www.intensivregister.de/api/public/reporting/laendertabelle
1656831925,23557,19618,3939,987,301,https://www.intensivregister.de/api/public/reporting/laendertabelle
1656835520,23499,19550,3949,1000,302,https://www.intensivregister.de/api/public/reporting/laendertabelle
1656842724,23499,19553,3946,1002,302,https://www.intensivregister.de/api/public/reporting/laendertabelle
1656846327,23502,19555,3947,1001,302,https://www.intensivregister.de/api/public/reporting/laendertabelle
1656849928,23502,19557,3945,1001,302,https://www.intensivregister.de/api/public/reporting/laendertabelle
1656853533,23483,19531,3952,1002,303,https://www.intensivregister.de/api/public/reporting/laendertabelle
1656857125,23487,19531,3956,1002,303,https://www.intensivregister.de/api/public/reporting/laendertabelle
1656860734,23487,19531,3956,1001,303,https://www.intensivregister.de/api/public/reporting/laendertabelle
1656867928,23487,19532,3955,1001,303,https://www.intensivregister.de/api/public/reporting/laendertabelle
1656875126,23486,19532,3954,1001,303,https://www.intensivregister.de/api/public/reporting/laendertabelle
1656878727,23486,19531,3955,1002,303,https://www.intensivregister.de/api/public/reporting/laendertabelle
1656882327,23487,19529,3958,1002,303,https://www.intensivregister.de/api/public/reporting/laendertabelle
1656885932,23487,19535,3952,1003,303,https://www.intensivregister.de/api/public/reporting/laendertabelle
1656889532,23487,19540,3947,1005,304,https://www.intensivregister.de/api/public/reporting/laendertabelle
1656893134,23488,19547,3941,1005,304,https://www.intensivregister.de/api/public/reporting/laendertabelle
1656896725,23494,19552,3942,1004,304,https://www.intensivregister.de/api/public/reporting/laendertabelle
1656900322,23496,19549,3947,1006,304,https://www.intensivregister.de/api/public/reporting/laendertabelle
1656903928,23529,19554,3975,1002,300,https://www.intensivregister.de/api/public/reporting/laendertabelle
1656907526,23574,19592,3982,1019,302,https://www.intensivregister.de/api/public/reporting/laendertabelle
1656911125,23653,19659,3994,1040,303,https://www.intensivregister.de/api/public/reporting/laendertabelle
1656918325,23808,19728,4080,1058,305,https://www.intensivregister.de/api/public/reporting/laendertabelle
1656921929,23840,19734,4106,1062,305,https://www.intensivregister.de/api/public/reporting/laendertabelle
1656929128,23844,19765,4079,1062,307,https://www.intensivregister.de/api/public/reporting/laendertabelle
1656932721,23844,19769,4075,1064,307,https://www.intensivregister.de/api/public/reporting/laendertabelle
1656936327,23844,19773,4071,1064,307,https://www.intensivregister.de/api/public/reporting/laendertabelle
1656943520,23845,19772,4073,1065,307,https://www.intensivregister.de/api/public/reporting/laendertabelle
1656950730,23845,19775,4070,1065,307,https://www.intensivregister.de/api/public/reporting/laendertabelle
1656954325,23847,19773,4074,1065,307,https://www.intensivregister.de/api/public/reporting/laendertabelle
1656961527,23847,19772,4075,1065,307,https://www.intensivregister.de/api/public/reporting/laendertabelle
1656965128,23849,19773,4076,1065,307,https://www.intensivregister.de/api/public/reporting/laendertabelle
1656968728,23852,19775,4077,1062,306,https://www.intensivregister.de/api/public/reporting/laendertabelle
1656975927,23852,19777,4075,1062,306,https://www.intensivregister.de/api/public/reporting/laendertabelle
1656983136,23854,19775,4079,1064,305,https://www.intensivregister.de/api/public/reporting/laendertabelle
1656986729,23857,19785,4072,1068,308,https://www.intensivregister.de/api/public/reporting/laendertabelle
1656993926,23901,19898,4003,1052,307,https://www.intensivregister.de/api/public/reporting/laendertabelle
1657001124,23901,19992,3909,1068,312,https://www.intensivregister.de/api/public/reporting/laendertabelle
1657008329,23868,20021,3847,1067,312,https://www.intensivregister.de/api/public/reporting/laendertabelle
1657011933,23868,20021,3847,1063,311,https://www.intensivregister.de/api/public/reporting/laendertabelle
1657019122,23871,20025,3846,1062,311,https://www.intensivregister.de/api/public/reporting/laendertabelle
1657022731,23875,20031,3844,1068,314,https://www.intensivregister.de/api/public/reporting/laendertabelle
1657026322,23876,20033,3843,1068,314,https://www.intensivregister.de/api/public/reporting/laendertabelle
1657033531,23876,20032,3844,1068,314,https://www.intensivregister.de/api/public/reporting/laendertabelle
1657037133,23876,20036,3840,1069,314,https://www.intensivregister.de/api/public/reporting/laendertabelle
1657044329,23876,20035,3841,1068,314,https://www.intensivregister.de/api/public/reporting/laendertabelle
1657051533,23874,20040,3834,1068,314,https://www.intensivregister.de/api/public/reporting/laendertabelle
1657058723,23875,20042,3833,1070,314,https://www.intensivregister.de/api/public/reporting/laendertabelle
1657065928,23874,20037,3837,1068,314,https://www.intensivregister.de/api/public/reporting/laendertabelle
1657069522,23880,20041,3839,1066,314,https://www.intensivregister.de/api/public/reporting/laendertabelle
1657073132,23881,20055,3826,1066,316,https://www.intensivregister.de/api/public/reporting/laendertabelle
1657076727,23892,20099,3793,1059,318,https://www.intensivregister.de/api/public/reporting/laendertabelle
1657080330,23884,20132,3752,1066,312,https://www.intensivregister.de/api/public/reporting/laendertabelle
1657083924,23909,20198,3711,1053,307,https://www.intensivregister.de/api/public/reporting/laendertabelle
1657091136,23872,20135,3737,1052,304,https://www.intensivregister.de/api/public/reporting/laendertabelle
1657094728,23860,20115,3745,1045,307,https://www.intensivregister.de/api/public/reporting/laendertabelle
1657101936,23859,20115,3744,1045,308,https://www.intensivregister.de/api/public/reporting/laendertabelle
1657105520,23862,20106,3756,1044,308,https://www.intensivregister.de/api/public/reporting/laendertabelle
1657112730,23862,20109,3753,1045,308,https://www.intensivregister.de/api/public/reporting/laendertabelle
1657116323,23861,20107,3754,1045,308,https://www.intensivregister.de/api/public/reporting/laendertabelle
1657127129,23861,20100,3761,1047,309,https://www.intensivregister.de/api/public/reporting/laendertabelle
1657137931,23862,20098,3764,1047,309,https://www.intensivregister.de/api/public/reporting/laendertabelle
1657145129,23860,20095,3765,1049,309,https://www.intensivregister.de/api/public/reporting/laendertabelle
1657148727,23860,20097,3763,1049,309,https://www.intensivregister.de/api/public/reporting/laendertabelle
1657155936,23861,20096,3765,1053,311,https://www.intensivregister.de/api/public/reporting/laendertabelle
1657159530,23863,20108,3755,1059,312,https://www.intensivregister.de/api/public/reporting/laendertabelle
1657166733,23852,20081,3771,1062,325,https://www.intensivregister.de/api/public/reporting/laendertabelle
1657170335,23850,20011,3839,1059,322,https://www.intensivregister.de/api/public/reporting/laendertabelle
1657177526,23855,20034,3821,1049,324,https://www.intensivregister.de/api/public/reporting/laendertabelle
1657181121,23852,20036,3816,1046,326,https://www.intensivregister.de/api/public/reporting/laendertabelle
1657184721,23853,20039,3814,1045,327,https://www.intensivregister.de/api/public/reporting/laendertabelle
1657191925,23844,20031,3813,1042,328,https://www.intensivregister.de/api/public/reporting/laendertabelle
1657199130,23842,20041,3801,1044,328,https://www.intensivregister.de/api/public/reporting/laendertabelle
1657202721,23842,20039,3803,1044,328,https://www.intensivregister.de/api/public/reporting/laendertabelle
1657209935,23841,20040,3801,1044,328,https://www.intensivregister.de/api/public/reporting/laendertabelle
1657217128,23841,20041,3800,1041,327,https://www.intensivregister.de/api/public/reporting/laendertabelle
1657224329,23839,20040,3799,1042,327,https://www.intensivregister.de/api/public/reporting/laendertabelle
1657227927,23838,20035,3803,1042,326,https://www.intensivregister.de/api/public/reporting/laendertabelle
1657235133,23838,20032,3806,1041,326,https://www.intensivregister.de/api/public/reporting/laendertabelle
1657238720,23837,20033,3804,1041,326,https://www.intensivregister.de/api/public/reporting/laendertabelle
1657242328,23835,20032,3803,1040,325,https://www.intensivregister.de/api/public/reporting/laendertabelle
1657245927,23830,20015,3815,1036,322,https://www.intensivregister.de/api/public/reporting/laendertabelle
1657249524,23823,20010,3813,1036,325,https://www.intensivregister.de/api/public/reporting/laendertabelle
1657256723,23773,20051,3722,1037,325,https://www.intensivregister.de/api/public/reporting/laendertabelle
1657260329,23730,20025,3705,1058,324,https://www.intensivregister.de/api/public/reporting/laendertabelle
1657263931,23719,20027,3692,1066,323,https://www.intensivregister.de/api/public/reporting/laendertabelle
1657267521,23717,20037,3680,1072,324,https://www.intensivregister.de/api/public/reporting/laendertabelle
1657274733,23727,20042,3685,1074,323,https://www.intensivregister.de/api/public/reporting/laendertabelle
1657278332,23727,20036,3691,1070,323,https://www.intensivregister.de/api/public/reporting/laendertabelle
1657281930,23727,20028,3699,1072,323,https://www.intensivregister.de/api/public/reporting/laendertabelle
1657285521,23728,20030,3698,1074,324,https://www.intensivregister.de/api/public/reporting/laendertabelle
1657289130,23728,20025,3703,1075,324,https://www.intensivregister.de/api/public/reporting/laendertabelle
1657296329,23682,19986,3696,1074,323,https://www.intensivregister.de/api/public/reporting/laendertabelle
1657299936,23682,19985,3697,1074,323,https://www.intensivregister.de/api/public/reporting/laendertabelle
1657304481,23682,19986,3696,1074,323,https://www.intensivregister.de/api/public/reporting/laendertabelle
1657314329,23674,19962,3712,1073,322,https://www.intensivregister.de/api/public/reporting/laendertabelle
1657321520,23670,19962,3708,1074,323,https://www.intensivregister.de/api/public/reporting/laendertabelle
1657328728,23672,19959,3713,1072,323,https://www.intensivregister.de/api/public/reporting/laendertabelle
1657335919,23658,19957,3701,1080,323,https://www.intensivregister.de/api/public/reporting/laendertabelle
1657339521,23631,19894,3737,1070,319,https://www.intensivregister.de/api/public/reporting/laendertabelle
1657346735,23495,19695,3800,1058,326,https://www.intensivregister.de/api/public/reporting/laendertabelle
1657353927,23480,19641,3839,1054,332,https://www.intensivregister.de/api/public/reporting/laendertabelle
1657361131,23473,19618,3855,1056,334,https://www.intensivregister.de/api/public/reporting/laendertabelle
1657364731,23522,19662,3860,1057,334,https://www.intensivregister.de/api/public/reporting/laendertabelle
1657368323,23519,19652,3867,1058,334,https://www.intensivregister.de/api/public/reporting/laendertabelle
1657375527,23517,19652,3865,1058,334,https://www.intensivregister.de/api/public/reporting/laendertabelle
1657379126,23516,19649,3867,1058,334,https://www.intensivregister.de/api/public/reporting/laendertabelle
1657386333,23516,19645,3871,1057,334,https://www.intensivregister.de/api/public/reporting/laendertabelle
1657389925,23516,19648,3868,1057,334,https://www.intensivregister.de/api/public/reporting/laendertabelle
1657397129,23516,19646,3870,1058,334,https://www.intensivregister.de/api/public/reporting/laendertabelle
1657400721,23513,19645,3868,1058,334,https://www.intensivregister.de/api/public/reporting/laendertabelle
1657404320,23512,19644,3868,1058,334,https://www.intensivregister.de/api/public/reporting/laendertabelle
1657407935,23510,19651,3859,1058,334,https://www.intensivregister.de/api/public/reporting/laendertabelle
1657415118,23507,19646,3861,1059,334,https://www.intensivregister.de/api/public/reporting/laendertabelle
1657418730,23508,19649,3859,1061,334,https://www.intensivregister.de/api/public/reporting/laendertabelle
1657422324,23512,19618,3894,1062,331,https://www.intensivregister.de/api/public/reporting/laendertabelle
1657429533,23498,19501,3997,1071,331,https://www.intensivregister.de/api/public/reporting/laendertabelle
1657436735,23446,19443,4003,1096,338,https://www.intensivregister.de/api/public/reporting/laendertabelle
1657443930,23417,19370,4047,1101,342,https://www.intensivregister.de/api/public/reporting/laendertabelle
1657447527,23417,19367,4050,1099,342,https://www.intensivregister.de/api/public/reporting/laendertabelle
1657454722,23416,19366,4050,1098,342,https://www.intensivregister.de/api/public/reporting/laendertabelle
1657458334,23416,19364,4052,1098,342,https://www.intensivregister.de/api/public/reporting/laendertabelle
1657461928,23416,19369,4047,1099,343,https://www.intensivregister.de/api/public/reporting/laendertabelle
1657476329,23416,19374,4042,1099,343,https://www.intensivregister.de/api/public/reporting/laendertabelle
1657479928,23417,19375,4042,1099,343,https://www.intensivregister.de/api/public/reporting/laendertabelle
1657487130,23410,19373,4037,1100,343,https://www.intensivregister.de/api/public/reporting/laendertabelle
1657490731,23411,19369,4042,1100,343,https://www.intensivregister.de/api/public/reporting/laendertabelle
1657494319,23411,19366,4045,1101,343,https://www.intensivregister.de/api/public/reporting/laendertabelle
1657497925,23411,19363,4048,1101,344,https://www.intensivregister.de/api/public/reporting/laendertabelle
1657505125,23406,19358,4048,1103,345,https://www.intensivregister.de/api/public/reporting/laendertabelle
1657512326,23451,19384,4067,1121,355,https://www.intensivregister.de/api/public/reporting/laendertabelle
1657515928,23528,19432,4096,1158,372,https://www.intensivregister.de/api/public/reporting/laendertabelle
1657519535,23563,19506,4057,1174,381,https://www.intensivregister.de/api/public/reporting/laendertabelle
1657526720,23600,19529,4071,1174,383,https://www.intensivregister.de/api/public/reporting/laendertabelle
1657530332,23598,19527,4071,1175,385,https://www.intensivregister.de/api/public/reporting/laendertabelle
1657537522,23599,19521,4078,1176,387,https://www.intensivregister.de/api/public/reporting/laendertabelle
1657541135,23602,19523,4079,1176,386,https://www.intensivregister.de/api/public/reporting/laendertabelle
1657544724,23601,19523,4078,1176,386,https://www.intensivregister.de/api/public/reporting/laendertabelle
1657548330,23601,19522,4079,1175,386,https://www.intensivregister.de/api/public/reporting/laendertabelle
1657551930,23601,19523,4078,1175,386,https://www.intensivregister.de/api/public/reporting/laendertabelle
1657555536,23602,19522,4080,1175,386,https://www.intensivregister.de/api/public/reporting/laendertabelle
1657562730,23602,19522,4080,1176,386,https://www.intensivregister.de/api/public/reporting/laendertabelle
1657569932,23603,19523,4080,1176,386,https://www.intensivregister.de/api/public/reporting/laendertabelle
1657573524,23610,19533,4077,1176,386,https://www.intensivregister.de/api/public/reporting/laendertabelle
1657577128,23613,19532,4081,1176,385,https://www.intensivregister.de/api/public/reporting/laendertabelle
1657584330,23614,19539,4075,1178,385,https://www.intensivregister.de/api/public/reporting/laendertabelle
1657587926,23610,19542,4068,1176,383,https://www.intensivregister.de/api/public/reporting/laendertabelle
1657591524,23607,19549,4058,1175,385,https://www.intensivregister.de/api/public/reporting/laendertabelle
1657595120,23618,19628,3990,1168,381,https://www.intensivregister.de/api/public/reporting/laendertabelle
1657598725,23629,19691,3938,1173,386,https://www.intensivregister.de/api/public/reporting/laendertabelle
1657602327,23649,19851,3798,1189,384,https://www.intensivregister.de/api/public/reporting/laendertabelle
1657609522,23649,19905,3744,1207,388,https://www.intensivregister.de/api/public/reporting/laendertabelle
1657613128,23662,19941,3721,1213,387,https://www.intensivregister.de/api/public/reporting/laendertabelle
1657616721,23667,19940,3727,1210,389,https://www.intensivregister.de/api/public/reporting/laendertabelle
1657620328,23688,19947,3741,1214,393,https://www.intensivregister.de/api/public/reporting/laendertabelle
1657627520,23688,19939,3749,1213,392,https://www.intensivregister.de/api/public/reporting/laendertabelle
1657631124,23690,19935,3755,1214,391,https://www.intensivregister.de/api/public/reporting/laendertabelle
1657645515,23692,19930,3762,1213,391,https://www.intensivregister.de/api/public/reporting/laendertabelle
1657656320,23689,19924,3765,1214,391,https://www.intensivregister.de/api/public/reporting/laendertabelle
1657659914,23686,19926,3760,1216,392,https://www.intensivregister.de/api/public/reporting/laendertabelle
1657667133,23688,19924,3764,1208,392,https://www.intensivregister.de/api/public/reporting/laendertabelle
1657670721,23691,19924,3767,1208,392,https://www.intensivregister.de/api/public/reporting/laendertabelle
1657674319,23691,19923,3768,1209,393,https://www.intensivregister.de/api/public/reporting/laendertabelle
1657681532,23693,19936,3757,1211,394,https://www.intensivregister.de/api/public/reporting/laendertabelle
1657685121,23711,19940,3771,1216,392,https://www.intensivregister.de/api/public/reporting/laendertabelle
1657692320,23765,20068,3697,1232,389,https://www.intensivregister.de/api/public/reporting/laendertabelle
1657695930,23767,20082,3685,1238,393,https://www.intensivregister.de/api/public/reporting/laendertabelle
1657699529,23779,20102,3677,1238,392,https://www.intensivregister.de/api/public/reporting/laendertabelle
1657703114,23770,20108,3662,1238,391,https://www.intensivregister.de/api/public/reporting/laendertabelle
1657710322,23768,20113,3655,1240,390,https://www.intensivregister.de/api/public/reporting/laendertabelle
1657713914,23768,20110,3658,1240,391,https://www.intensivregister.de/api/public/reporting/laendertabelle
1657721122,23770,20110,3660,1240,391,https://www.intensivregister.de/api/public/reporting/laendertabelle
1657742721,23760,20101,3659,1240,391,https://www.intensivregister.de/api/public/reporting/laendertabelle
1657746320,23761,20101,3660,1238,390,https://www.intensivregister.de/api/public/reporting/laendertabelle
1657749927,23762,20110,3652,1240,392,https://www.intensivregister.de/api/public/reporting/laendertabelle
1657753515,23765,20106,3659,1240,392,https://www.intensivregister.de/api/public/reporting/laendertabelle
1657760731,23766,20105,3661,1244,393,https://www.intensivregister.de/api/public/reporting/laendertabelle
1657764320,23764,20109,3655,1245,392,https://www.intensivregister.de/api/public/reporting/laendertabelle
1657767928,23762,20107,3655,1247,388,https://www.intensivregister.de/api/public/reporting/laendertabelle
1657775125,23746,20120,3626,1245,381,https://www.intensivregister.de/api/public/reporting/laendertabelle
1657782321,23725,20121,3604,1237,377,https://www.intensivregister.de/api/public/reporting/laendertabelle
1657785919,23712,20137,3575,1243,378,https://www.intensivregister.de/api/public/reporting/laendertabelle
1657789528,23713,20138,3575,1241,378,https://www.intensivregister.de/api/public/reporting/laendertabelle
1657793115,23713,20139,3574,1240,378,https://www.intensivregister.de/api/public/reporting/laendertabelle
1657800333,23708,20148,3560,1241,379,https://www.intensivregister.de/api/public/reporting/laendertabelle
1657803921,23711,20150,3561,1240,379,https://www.intensivregister.de/api/public/reporting/laendertabelle
1657814724,23710,20148,3562,1240,379,https://www.intensivregister.de/api/public/reporting/laendertabelle
1657818334,23710,20149,3561,1240,379,https://www.intensivregister.de/api/public/reporting/laendertabelle
1657832727,23706,20142,3564,1241,380,https://www.intensivregister.de/api/public/reporting/laendertabelle
1657836327,23706,20142,3564,1239,379,https://www.intensivregister.de/api/public/reporting/laendertabelle
1657839917,23705,20144,3561,1240,379,https://www.intensivregister.de/api/public/reporting/laendertabelle
1657847127,23698,20143,3555,1242,379,https://www.intensivregister.de/api/public/reporting/laendertabelle
1657854321,23693,20156,3537,1250,387,https://www.intensivregister.de/api/public/reporting/laendertabelle
1657857927,23662,20109,3553,1234,383,https://www.intensivregister.de/api/public/reporting/laendertabelle
1657865120,23636,20057,3579,1226,382,https://www.intensivregister.de/api/public/reporting/laendertabelle
1657868720,23621,20059,3562,1227,383,https://www.intensivregister.de/api/public/reporting/laendertabelle
1657872320,23616,20060,3556,1219,384,https://www.intensivregister.de/api/public/reporting/laendertabelle
1657875920,23610,20052,3558,1218,384,https://www.intensivregister.de/api/public/reporting/laendertabelle
1657879517,23603,20046,3557,1216,385,https://www.intensivregister.de/api/public/reporting/laendertabelle
1657886721,23600,20041,3559,1218,384,https://www.intensivregister.de/api/public/reporting/laendertabelle
1657890321,23599,20039,3560,1217,384,https://www.intensivregister.de/api/public/reporting/laendertabelle
1657893921,23602,20040,3562,1217,384,https://www.intensivregister.de/api/public/reporting/laendertabelle
1657915517,23602,20038,3564,1218,384,https://www.intensivregister.de/api/public/reporting/laendertabelle
1657922727,23591,20017,3574,1217,384,https://www.intensivregister.de/api/public/reporting/laendertabelle
1657929927,23591,20007,3584,1218,383,https://www.intensivregister.de/api/public/reporting/laendertabelle
1657933528,23592,20010,3582,1218,383,https://www.intensivregister.de/api/public/reporting/laendertabelle
1657940721,23580,20017,3563,1219,383,https://www.intensivregister.de/api/public/reporting/laendertabelle
1657944320,23541,19980,3561,1222,382,https://www.intensivregister.de/api/public/reporting/laendertabelle
1657951521,23433,19842,3591,1223,392,https://www.intensivregister.de/api/public/reporting/laendertabelle
1657955129,23396,19799,3597,1227,389,https://www.intensivregister.de/api/public/reporting/laendertabelle
1657962321,23365,19783,3582,1221,391,https://www.intensivregister.de/api/public/reporting/laendertabelle
1657965921,23360,19768,3592,1222,391,https://www.intensivregister.de/api/public/reporting/laendertabelle
1657973127,23360,19778,3582,1221,391,https://www.intensivregister.de/api/public/reporting/laendertabelle
1657976727,23359,19766,3593,1222,391,https://www.intensivregister.de/api/public/reporting/laendertabelle
1657983921,23356,19765,3591,1222,391,https://www.intensivregister.de/api/public/reporting/laendertabelle
1657987521,23356,19764,3592,1222,391,https://www.intensivregister.de/api/public/reporting/laendertabelle
1657994728,23357,19760,3597,1221,390,https://www.intensivregister.de/api/public/reporting/laendertabelle
1657998317,23357,19759,3598,1221,390,https://www.intensivregister.de/api/public/reporting/laendertabelle
1658005521,23356,19753,3603,1218,389,https://www.intensivregister.de/api/public/reporting/laendertabelle
1658009121,23357,19755,3602,1217,389,https://www.intensivregister.de/api/public/reporting/laendertabelle
1658016328,23356,19750,3606,1214,389,https://www.intensivregister.de/api/public/reporting/laendertabelle
1658023528,23356,19747,3609,1214,389,https://www.intensivregister.de/api/public/reporting/laendertabelle
1658027127,23349,19716,3633,1218,387,https://www.intensivregister.de/api/public/reporting/laendertabelle
1658030720,23317,19654,3663,1223,390,https://www.intensivregister.de/api/public/reporting/laendertabelle
1658034328,23292,19590,3702,1226,394,https://www.intensivregister.de/api/public/reporting/laendertabelle
1658037928,23267,19534,3733,1254,396,https://www.intensivregister.de/api/public/reporting/laendertabelle
1658041521,23249,19473,3776,1261,398,https://www.intensivregister.de/api/public/reporting/laendertabelle
1658048728,23231,19431,3800,1268,398,https://www.intensivregister.de/api/public/reporting/laendertabelle
1658052327,23229,19426,3803,1269,398,https://www.intensivregister.de/api/public/reporting/laendertabelle
1658055920,23230,19425,3805,1268,398,https://www.intensivregister.de/api/public/reporting/laendertabelle
1658063121,23230,19426,3804,1268,398,https://www.intensivregister.de/api/public/reporting/laendertabelle
1658070321,23230,19426,3804,1267,398,https://www.intensivregister.de/api/public/reporting/laendertabelle
1658073917,23230,19424,3806,1267,398,https://www.intensivregister.de/api/public/reporting/laendertabelle
1658077521,23230,19423,3807,1267,398,https://www.intensivregister.de/api/public/reporting/laendertabelle
1658081121,23230,19416,3814,1268,398,https://www.intensivregister.de/api/public/reporting/laendertabelle
1658088328,23231,19418,3813,1268,398,https://www.intensivregister.de/api/public/reporting/laendertabelle
1658091920,23234,19407,3827,1268,398,https://www.intensivregister.de/api/public/reporting/laendertabelle
1658095527,23239,19415,3824,1268,398,https://www.intensivregister.de/api/public/reporting/laendertabelle
1658099121,23239,19419,3820,1267,398,https://www.intensivregister.de/api/public/reporting/laendertabelle
1658106328,23242,19433,3809,1266,399,https://www.intensivregister.de/api/public/reporting/laendertabelle
1658109921,23238,19440,3798,1267,397,https://www.intensivregister.de/api/public/reporting/laendertabelle
1658117127,23307,19453,3854,1280,397,https://www.intensivregister.de/api/public/reporting/laendertabelle
1658124317,23435,19586,3849,1315,402,https://www.intensivregister.de/api/public/reporting/laendertabelle
1658127920,23438,19580,3858,1328,404,https://www.intensivregister.de/api/public/reporting/laendertabelle
1658131521,23452,19594,3858,1326,404,https://www.intensivregister.de/api/public/reporting/laendertabelle
1658135128,23444,19584,3860,1323,405,https://www.intensivregister.de/api/public/reporting/laendertabelle
1658138721,23443,19579,3864,1321,404,https://www.intensivregister.de/api/public/reporting/laendertabelle
1658145914,23445,19588,3857,1323,405,https://www.intensivregister.de/api/public/reporting/laendertabelle
1658149520,23448,19587,3861,1325,405,https://www.intensivregister.de/api/public/reporting/laendertabelle
1658153120,23450,19590,3860,1326,406,https://www.intensivregister.de/api/public/reporting/laendertabelle
1658156721,23448,19590,3858,1326,406,https://www.intensivregister.de/api/public/reporting/laendertabelle
1658163921,23450,19593,3857,1328,407,https://www.intensivregister.de/api/public/reporting/laendertabelle
1658167527,23450,19594,3856,1328,407,https://www.intensivregister.de/api/public/reporting/laendertabelle
1658174727,23450,19591,3859,1328,407,https://www.intensivregister.de/api/public/reporting/laendertabelle
1658181918,23449,19597,3852,1330,409,https://www.intensivregister.de/api/public/reporting/laendertabelle
1658185528,23445,19594,3851,1331,410,https://www.intensivregister.de/api/public/reporting/laendertabelle
1658192717,23445,19587,3858,1334,413,https://www.intensivregister.de/api/public/reporting/laendertabelle
1658199921,23491,19703,3788,1330,413,https://www.intensivregister.de/api/public/reporting/laendertabelle
1658203520,23532,19741,3791,1336,416,https://www.intensivregister.de/api/public/reporting/laendertabelle
1658207120,23572,19875,3697,1331,423,https://www.intensivregister.de/api/public/reporting/laendertabelle
1658210718,23615,19983,3632,1322,419,https://www.intensivregister.de/api/public/reporting/laendertabelle
1658214321,23618,19994,3624,1321,416,https://www.intensivregister.de/api/public/reporting/laendertabelle
1658217918,23643,20033,3610,1327,416,https://www.intensivregister.de/api/public/reporting/laendertabelle
1658221521,23646,20038,3608,1326,414,https://www.intensivregister.de/api/public/reporting/laendertabelle
1658225118,23620,20017,3603,1327,413,https://www.intensivregister.de/api/public/reporting/laendertabelle
1658228720,23620,20019,3601,1323,411,https://www.intensivregister.de/api/public/reporting/laendertabelle
1658232328,23618,20017,3601,1325,411,https://www.intensivregister.de/api/public/reporting/laendertabelle
1658235927,23621,20017,3604,1327,412,https://www.intensivregister.de/api/public/reporting/laendertabelle
1658243120,23621,20016,3605,1326,412,https://www.intensivregister.de/api/public/reporting/laendertabelle
1658264721,23625,20012,3613,1325,412,https://www.intensivregister.de/api/public/reporting/laendertabelle
1658268328,23624,20012,3612,1325,412,https://www.intensivregister.de/api/public/reporting/laendertabelle
1658271921,23622,20017,3605,1323,411,https://www.intensivregister.de/api/public/reporting/laendertabelle
1658275528,23624,20019,3605,1324,412,https://www.intensivregister.de/api/public/reporting/laendertabelle
1658282720,23624,20020,3604,1333,413,https://www.intensivregister.de/api/public/reporting/laendertabelle
1658289921,23618,20046,3572,1334,418,https://www.intensivregister.de/api/public/reporting/laendertabelle
1658293521,23640,20078,3562,1322,419,https://www.intensivregister.de/api/public/reporting/laendertabelle
1658297118,23634,20111,3523,1330,428,https://www.intensivregister.de/api/public/reporting/laendertabelle
1658300718,23637,20118,3519,1329,427,https://www.intensivregister.de/api/public/reporting/laendertabelle
1658304321,23646,20142,3504,1332,429,https://www.intensivregister.de/api/public/reporting/laendertabelle
1658307928,23641,20148,3493,1332,431,https://www.intensivregister.de/api/public/reporting/laendertabelle
1658315121,23637,20144,3493,1335,431,https://www.intensivregister.de/api/public/reporting/laendertabelle
1658322322,23639,20146,3493,1337,431,https://www.intensivregister.de/api/public/reporting/laendertabelle
1658325922,23639,20147,3492,1335,429,https://www.intensivregister.de/api/public/reporting/laendertabelle
1658329528,23639,20146,3493,1335,429,https://www.intensivregister.de/api/public/reporting/laendertabelle
1658336717,23639,20147,3492,1335,429,https://www.intensivregister.de/api/public/reporting/laendertabelle
1658340321,23639,20148,3491,1335,429,https://www.intensivregister.de/api/public/reporting/laendertabelle
1658351122,23638,20149,3489,1336,429,https://www.intensivregister.de/api/public/reporting/laendertabelle
1658354718,23640,20152,3488,1337,429,https://www.intensivregister.de/api/public/reporting/laendertabelle
1658361928,23640,20160,3480,1339,429,https://www.intensivregister.de/api/public/reporting/laendertabelle
1658365521,23641,20161,3480,1338,428,https://www.intensivregister.de/api/public/reporting/laendertabelle
1658369128,23639,20163,3476,1338,428,https://www.intensivregister.de/api/public/reporting/laendertabelle
1658372728,23630,20173,3457,1341,430,https://www.intensivregister.de/api/public/reporting/laendertabelle
1658376321,23628,20158,3470,1340,432,https://www.intensivregister.de/api/public/reporting/laendertabelle
1658379918,23493,20043,3450,1370,435,https://www.intensivregister.de/api/public/reporting/laendertabelle
1658387122,23481,20085,3396,1389,440,https://www.intensivregister.de/api/public/reporting/laendertabelle
1658390721,23473,20097,3376,1396,440,https://www.intensivregister.de/api/public/reporting/laendertabelle
1658397917,23472,20098,3374,1396,439,https://www.intensivregister.de/api/public/reporting/laendertabelle
1658397917,23472,20097,3375,1394,439,https://www.intensivregister.de/api/public/reporting/laendertabelle
1658401528,23499,20115,3384,1392,439,https://www.intensivregister.de/api/public/reporting/laendertabelle
1658405118,23501,20117,3384,1392,439,https://www.intensivregister.de/api/public/reporting/laendertabelle
1658412317,23497,20115,3382,1390,439,https://www.intensivregister.de/api/public/reporting/laendertabelle
1658415928,23535,20155,3380,1391,439,https://www.intensivregister.de/api/public/reporting/laendertabelle
1658419518,23535,20156,3379,1391,439,https://www.intensivregister.de/api/public/reporting/laendertabelle
1658433928,23535,20157,3378,1389,439,https://www.intensivregister.de/api/public/reporting/laendertabelle
1658437521,23536,20160,3376,1389,439,https://www.intensivregister.de/api/public/reporting/laendertabelle
1658444721,23531,20157,3374,1391,439,https://www.intensivregister.de/api/public/reporting/laendertabelle
1658451931,23528,20153,3375,1391,440,https://www.intensivregister.de/api/public/reporting/laendertabelle
1658455529,23529,20153,3376,1390,440,https://www.intensivregister.de/api/public/reporting/laendertabelle
1658462721,23530,20136,3394,1387,437,https://www.intensivregister.de/api/public/reporting/laendertabelle
1658462721,23502,20151,3351,1390,437,https://www.intensivregister.de/api/public/reporting/laendertabelle
1658469921,23392,20130,3262,1401,444,https://www.intensivregister.de/api/public/reporting/laendertabelle
1658473521,23386,20101,3285,1393,443,https://www.intensivregister.de/api/public/reporting/laendertabelle
1658477129,23377,20075,3302,1394,443,https://www.intensivregister.de/api/public/reporting/laendertabelle
1658480728,23366,20061,3305,1396,444,https://www.intensivregister.de/api/public/reporting/laendertabelle
1658484318,23361,20055,3306,1399,446,https://www.intensivregister.de/api/public/reporting/laendertabelle
1658491518,23363,20048,3315,1397,446,https://www.intensivregister.de/api/public/reporting/laendertabelle
1658495121,23361,20048,3313,1396,446,https://www.intensivregister.de/api/public/reporting/laendertabelle
1658498721,23354,20046,3308,1400,446,https://www.intensivregister.de/api/public/reporting/laendertabelle
1658502327,23354,20045,3309,1398,446,https://www.intensivregister.de/api/public/reporting/laendertabelle
1658505922,23351,20042,3309,1398,446,https://www.intensivregister.de/api/public/reporting/laendertabelle
1658509529,23353,20041,3312,1398,446,https://www.intensivregister.de/api/public/reporting/laendertabelle
1658513129,23353,20039,3314,1398,446,https://www.intensivregister.de/api/public/reporting/laendertabelle
1658520328,23353,20042,3311,1398,446,https://www.intensivregister.de/api/public/reporting/laendertabelle
1658523917,23355,20029,3326,1400,446,https://www.intensivregister.de/api/public/reporting/laendertabelle
1658527528,23355,20026,3329,1400,447,https://www.intensivregister.de/api/public/reporting/laendertabelle
1658531121,23355,20023,3332,1400,447,https://www.intensivregister.de/api/public/reporting/laendertabelle
1658538318,23353,20024,3329,1399,447,https://www.intensivregister.de/api/public/reporting/laendertabelle
1658545518,23353,19969,3384,1401,449,https://www.intensivregister.de/api/public/reporting/laendertabelle
1658549117,23316,19913,3403,1385,446,https://www.intensivregister.de/api/public/reporting/laendertabelle
1658552721,23261,19807,3454,1385,444,https://www.intensivregister.de/api/public/reporting/laendertabelle
1658559917,23203,19713,3490,1399,447,https://www.intensivregister.de/api/public/reporting/laendertabelle
1658563522,23179,19669,3510,1405,449,https://www.intensivregister.de/api/public/reporting/laendertabelle
1658570729,23166,19665,3501,1402,449,https://www.intensivregister.de/api/public/reporting/laendertabelle
1658574318,23167,19657,3510,1400,448,https://www.intensivregister.de/api/public/reporting/laendertabelle
1658581521,23166,19654,3512,1401,448,https://www.intensivregister.de/api/public/reporting/laendertabelle
1658592318,23165,19651,3514,1405,448,https://www.intensivregister.de/api/public/reporting/laendertabelle
1658595928,23165,19650,3515,1405,448,https://www.intensivregister.de/api/public/reporting/laendertabelle
1658603121,23166,19653,3513,1407,448,https://www.intensivregister.de/api/public/reporting/laendertabelle
1658606721,23166,19650,3516,1407,448,https://www.intensivregister.de/api/public/reporting/laendertabelle
1658610321,23163,19638,3525,1409,448,https://www.intensivregister.de/api/public/reporting/laendertabelle
1658617518,23157,19628,3529,1411,449,https://www.intensivregister.de/api/public/reporting/laendertabelle
1658621122,23157,19627,3530,1412,449,https://www.intensivregister.de/api/public/reporting/laendertabelle
1658624719,23157,19626,3531,1413,448,https://www.intensivregister.de/api/public/reporting/laendertabelle
1658631917,23136,19601,3535,1418,447,https://www.intensivregister.de/api/public/reporting/laendertabelle
1658639118,23069,19490,3579,1437,445,https://www.intensivregister.de/api/public/reporting/laendertabelle
1658642717,23049,19408,3641,1442,450,https://www.intensivregister.de/api/public/reporting/laendertabelle
1658646329,23045,19356,3689,1439,447,https://www.intensivregister.de/api/public/reporting/laendertabelle
1658653520,23042,19339,3703,1439,442,https://www.intensivregister.de/api/public/reporting/laendertabelle
1658657128,23042,19340,3702,1438,442,https://www.intensivregister.de/api/public/reporting/laendertabelle
1658664321,23044,19340,3704,1438,442,https://www.intensivregister.de/api/public/reporting/laendertabelle
1658667921,23044,19337,3707,1438,443,https://www.intensivregister.de/api/public/reporting/laendertabelle
1658671520,23042,19330,3712,1441,441,https://www.intensivregister.de/api/public/reporting/laendertabelle
1658675128,23042,19330,3712,1442,441,https://www.intensivregister.de/api/public/reporting/laendertabelle
1658682328,23042,19331,3711,1443,441,https://www.intensivregister.de/api/public/reporting/laendertabelle
1658696728,23039,19325,3714,1444,441,https://www.intensivregister.de/api/public/reporting/laendertabelle
1658700328,23042,19326,3716,1448,441,https://www.intensivregister.de/api/public/reporting/laendertabelle
1658703922,23043,19334,3709,1448,441,https://www.intensivregister.de/api/public/reporting/laendertabelle
1658711121,23043,19336,3707,1449,442,https://www.intensivregister.de/api/public/reporting/laendertabelle
1658714720,23054,19345,3709,1449,442,https://www.intensivregister.de/api/public/reporting/laendertabelle
1658721918,23134,19471,3663,1472,445,https://www.intensivregister.de/api/public/reporting/laendertabelle
1658725528,23201,19509,3692,1490,448,https://www.intensivregister.de/api/public/reporting/laendertabelle
1658729118,23254,19533,3721,1515,459,https://www.intensivregister.de/api/public/reporting/laendertabelle
1658732720,23281,19567,3714,1532,457,https://www.intensivregister.de/api/public/reporting/laendertabelle
1658736328,23284,19593,3691,1551,459,https://www.intensivregister.de/api/public/reporting/laendertabelle
1658739928,23301,19602,3699,1554,459,https://www.intensivregister.de/api/public/reporting/laendertabelle
1658743517,23305,19604,3701,1559,460,https://www.intensivregister.de/api/public/reporting/laendertabelle
1658747128,23305,19606,3699,1561,461,https://www.intensivregister.de/api/public/reporting/laendertabelle
1658750723,23305,19607,3698,1563,463,https://www.intensivregister.de/api/public/reporting/laendertabelle
1658754329,23331,19630,3701,1565,465,https://www.intensivregister.de/api/public/reporting/laendertabelle
1658757918,23330,19631,3699,1564,465,https://www.intensivregister.de/api/public/reporting/laendertabelle
1658765121,23341,19642,3699,1564,465,https://www.intensivregister.de/api/public/reporting/laendertabelle
1658772320,23341,19642,3699,1565,466,https://www.intensivregister.de/api/public/reporting/laendertabelle
1658779529,23304,19608,3696,1564,466,https://www.intensivregister.de/api/public/reporting/laendertabelle
1658786728,23303,19605,3698,1568,465,https://www.intensivregister.de/api/public/reporting/laendertabelle
1658790321,23303,19610,3693,1568,465,https://www.intensivregister.de/api/public/reporting/laendertabelle
1658793928,23302,19615,3687,1568,465,https://www.intensivregister.de/api/public/reporting/laendertabelle
1658797528,23303,19616,3687,1569,467,https://www.intensivregister.de/api/public/reporting/laendertabelle
1658801121,23312,19622,3690,1572,467,https://www.intensivregister.de/api/public/reporting/laendertabelle
1658804729,23363,19704,3659,1565,469,https://www.intensivregister.de/api/public/reporting/laendertabelle
1658811923,23438,19842,3596,1597,480,https://www.intensivregister.de/api/public/reporting/laendertabelle
1658819121,23479,19920,3559,1605,483,https://www.intensivregister.de/api/public/reporting/laendertabelle
1658822721,23571,20004,3567,1622,492,https://www.intensivregister.de/api/public/reporting/laendertabelle
1658829921,23569,20007,3562,1622,494,https://www.intensivregister.de/api/public/reporting/laendertabelle
1658833521,23570,20011,3559,1620,494,https://www.intensivregister.de/api/public/reporting/laendertabelle
1658837125,23573,20015,3558,1620,494,https://www.intensivregister.de/api/public/reporting/laendertabelle
1658840717,23573,20018,3555,1621,494,https://www.intensivregister.de/api/public/reporting/laendertabelle
1658847921,23573,20023,3550,1621,494,https://www.intensivregister.de/api/public/reporting/laendertabelle
1658855118,23573,20023,3550,1619,494,https://www.intensivregister.de/api/public/reporting/laendertabelle
1658858718,23573,20024,3549,1619,494,https://www.intensivregister.de/api/public/reporting/laendertabelle
1658873121,23573,20024,3549,1620,494,https://www.intensivregister.de/api/public/reporting/laendertabelle
1658876721,23575,20027,3548,1618,494,https://www.intensivregister.de/api/public/reporting/laendertabelle
1658880329,23570,20019,3551,1617,494,https://www.intensivregister.de/api/public/reporting/laendertabelle
1658883919,23573,20023,3550,1619,494,https://www.intensivregister.de/api/public/reporting/laendertabelle
1658891118,23576,20062,3514,1604,486,https://www.intensivregister.de/api/public/reporting/laendertabelle
1658894721,23593,20091,3502,1593,482,https://www.intensivregister.de/api/public/reporting/laendertabelle
1658898322,23565,20076,3489,1588,489,https://www.intensivregister.de/api/public/reporting/laendertabelle
1658901923,23580,20091,3489,1591,494,https://www.intensivregister.de/api/public/reporting/laendertabelle
1658905529,23584,20115,3469,1589,499,https://www.intensivregister.de/api/public/reporting/laendertabelle
1658909123,23588,20104,3484,1587,501,https://www.intensivregister.de/api/public/reporting/laendertabelle
1658916318,23590,20106,3484,1589,503,https://www.intensivregister.de/api/public/reporting/laendertabelle
1658919923,23588,20106,3482,1586,502,https://www.intensivregister.de/api/public/reporting/laendertabelle
1658927118,23589,20106,3483,1588,500,https://www.intensivregister.de/api/public/reporting/laendertabelle
1658930718,23589,20107,3482,1588,501,https://www.intensivregister.de/api/public/reporting/laendertabelle
1658934322,23589,20108,3481,1588,501,https://www.intensivregister.de/api/public/reporting/laendertabelle
1658937928,23589,20103,3486,1591,500,https://www.intensivregister.de/api/public/reporting/laendertabelle
1658945128,23588,20104,3484,1591,500,https://www.intensivregister.de/api/public/reporting/laendertabelle
1658948721,23588,20103,3485,1592,500,https://www.intensivregister.de/api/public/reporting/laendertabelle
1658955921,23563,20067,3496,1590,501,https://www.intensivregister.de/api/public/reporting/laendertabelle
1658959527,23562,20064,3498,1591,501,https://www.intensivregister.de/api/public/reporting/laendertabelle
1658963122,23562,20069,3493,1590,502,https://www.intensivregister.de/api/public/reporting/laendertabelle
1658970322,23563,20059,3504,1589,501,https://www.intensivregister.de/api/public/reporting/laendertabelle
1658973921,23560,20063,3497,1590,501,https://www.intensivregister.de/api/public/reporting/laendertabelle
1658977521,23550,20058,3492,1576,499,https://www.intensivregister.de/api/public/reporting/laendertabelle
1658981123,23545,19989,3556,1557,505,https://www.intensivregister.de/api/public/reporting/laendertabelle
1658988317,23554,20035,3519,1559,489,https://www.intensivregister.de/api/public/reporting/laendertabelle
1658991918,23559,20034,3525,1550,483,https://www.intensivregister.de/api/public/reporting/laendertabelle
1658995528,23573,20027,3546,1549,484,https://www.intensivregister.de/api/public/reporting/laendertabelle
1658999118,23579,20034,3545,1549,482,https://www.intensivregister.de/api/public/reporting/laendertabelle
1659002728,23579,20035,3544,1549,483,https://www.intensivregister.de/api/public/reporting/laendertabelle
1659006321,23581,20036,3545,1548,482,https://www.intensivregister.de/api/public/reporting/laendertabelle
1659013528,23589,20051,3538,1551,482,https://www.intensivregister.de/api/public/reporting/laendertabelle
1659013528,23619,20078,3541,1553,482,https://www.intensivregister.de/api/public/reporting/laendertabelle
1659017121,23619,20078,3541,1554,482,https://www.intensivregister.de/api/public/reporting/laendertabelle
1659024328,23619,20079,3540,1554,482,https://www.intensivregister.de/api/public/reporting/laendertabelle
1659038728,23621,20076,3545,1554,483,https://www.intensivregister.de/api/public/reporting/laendertabelle
1659042323,23619,20076,3543,1553,484,https://www.intensivregister.de/api/public/reporting/laendertabelle
1659045922,23613,20074,3539,1553,484,https://www.intensivregister.de/api/public/reporting/laendertabelle
1659053127,23614,20083,3531,1555,485,https://www.intensivregister.de/api/public/reporting/laendertabelle
1659056728,23615,20090,3525,1554,485,https://www.intensivregister.de/api/public/reporting/laendertabelle
1659063921,23614,20057,3557,1555,485,https://www.intensivregister.de/api/public/reporting/laendertabelle
1659067528,23577,20023,3554,1545,480,https://www.intensivregister.de/api/public/reporting/laendertabelle
1659071118,23528,19964,3564,1527,483,https://www.intensivregister.de/api/public/reporting/laendertabelle
1659074722,23504,19915,3589,1505,480,https://www.intensivregister.de/api/public/reporting/laendertabelle
1659078322,23475,19881,3594,1499,480,https://www.intensivregister.de/api/public/reporting/laendertabelle
1659081921,23461,19848,3613,1494,477,https://www.intensivregister.de/api/public/reporting/laendertabelle
1659089120,23441,19822,3619,1486,477,https://www.intensivregister.de/api/public/reporting/laendertabelle
1659092721,23441,19813,3628,1486,477,https://www.intensivregister.de/api/public/reporting/laendertabelle
1659099922,23441,19812,3629,1487,476,https://www.intensivregister.de/api/public/reporting/laendertabelle
1659103522,23441,19813,3628,1487,476,https://www.intensivregister.de/api/public/reporting/laendertabelle
1659107128,23440,19815,3625,1489,478,https://www.intensivregister.de/api/public/reporting/laendertabelle
1659110717,23441,19816,3625,1489,478,https://www.intensivregister.de/api/public/reporting/laendertabelle
1659125128,23440,19815,3625,1487,478,https://www.intensivregister.de/api/public/reporting/laendertabelle
1659128723,23440,19809,3631,1487,477,https://www.intensivregister.de/api/public/reporting/laendertabelle
1659132330,23440,19813,3627,1486,477,https://www.intensivregister.de/api/public/reporting/laendertabelle
1659135921,23442,19807,3635,1489,477,https://www.intensivregister.de/api/public/reporting/laendertabelle
1659139522,23443,19809,3634,1488,477,https://www.intensivregister.de/api/public/reporting/laendertabelle
1659143128,23443,19817,3626,1488,477,https://www.intensivregister.de/api/public/reporting/laendertabelle
1659150327,23437,19819,3618,1480,480,https://www.intensivregister.de/api/public/reporting/laendertabelle
1659153918,23413,19803,3610,1472,483,https://www.intensivregister.de/api/public/reporting/laendertabelle
1659157518,23345,19718,3627,1470,482,https://www.intensivregister.de/api/public/reporting/laendertabelle
1659161129,23298,19654,3644,1460,484,https://www.intensivregister.de/api/public/reporting/laendertabelle
1659168321,23243,19571,3672,1458,488,https://www.intensivregister.de/api/public/reporting/laendertabelle
1659175521,23245,19571,3674,1455,487,https://www.intensivregister.de/api/public/reporting/laendertabelle
1659179121,23242,19560,3682,1455,487,https://www.intensivregister.de/api/public/reporting/laendertabelle
1659182729,23240,19547,3693,1454,487,https://www.intensivregister.de/api/public/reporting/laendertabelle
1659186322,23240,19546,3694,1454,487,https://www.intensivregister.de/api/public/reporting/laendertabelle
1659193528,23236,19543,3693,1454,487,https://www.intensivregister.de/api/public/reporting/laendertabelle
1659197118,23231,19536,3695,1454,487,https://www.intensivregister.de/api/public/reporting/laendertabelle
1659204321,23233,19529,3704,1454,487,https://www.intensivregister.de/api/public/reporting/laendertabelle
1659207921,23233,19530,3703,1454,486,https://www.intensivregister.de/api/public/reporting/laendertabelle
1659211522,23233,19529,3704,1454,486,https://www.intensivregister.de/api/public/reporting/laendertabelle
1659215129,23229,19531,3698,1454,487,https://www.intensivregister.de/api/public/reporting/laendertabelle
1659218727,23229,19529,3700,1455,487,https://www.intensivregister.de/api/public/reporting/laendertabelle
1659222321,23224,19518,3706,1456,488,https://www.intensivregister.de/api/public/reporting/laendertabelle
1659225928,23222,19515,3707,1455,489,https://www.intensivregister.de/api/public/reporting/laendertabelle
1659229520,23222,19516,3706,1456,489,https://www.intensivregister.de/api/public/reporting/laendertabelle
1659233120,23225,19511,3714,1450,485,https://www.intensivregister.de/api/public/reporting/laendertabelle
1659236718,23228,19497,3731,1447,484,https://www.intensivregister.de/api/public/reporting/laendertabelle
1659240329,23209,19466,3743,1453,487,https://www.intensivregister.de/api/public/reporting/laendertabelle
1659247521,23153,19362,3791,1459,484,https://www.intensivregister.de/api/public/reporting/laendertabelle
1659251127,23131,19316,3815,1437,476,https://www.intensivregister.de/api/public/reporting/laendertabelle
1659258318,23116,19289,3827,1446,477,https://www.intensivregister.de/api/public/reporting/laendertabelle
1659261920,23105,19283,3822,1447,476,https://www.intensivregister.de/api/public/reporting/laendertabelle
1659272721,23105,19282,3823,1449,477,https://www.intensivregister.de/api/public/reporting/laendertabelle
1659276321,23103,19280,3823,1450,479,https://www.intensivregister.de/api/public/reporting/laendertabelle
1659283520,23103,19283,3820,1450,479,https://www.intensivregister.de/api/public/reporting/laendertabelle
1659287120,23103,19284,3819,1449,479,https://www.intensivregister.de/api/public/reporting/laendertabelle
1659294322,23104,19284,3820,1449,479,https://www.intensivregister.de/api/public/reporting/laendertabelle
1659297918,23102,19284,3818,1448,479,https://www.intensivregister.de/api/public/reporting/laendertabelle
1659301518,23103,19284,3819,1447,479,https://www.intensivregister.de/api/public/reporting/laendertabelle
1659305128,23103,19279,3824,1448,479,https://www.intensivregister.de/api/public/reporting/laendertabelle
1659312327,23110,19287,3823,1449,479,https://www.intensivregister.de/api/public/reporting/laendertabelle
1659319520,23116,19297,3819,1451,483,https://www.intensivregister.de/api/public/reporting/laendertabelle
1659323118,23145,19325,3820,1463,490,https://www.intensivregister.de/api/public/reporting/laendertabelle
1659330321,23296,19414,3882,1451,482,https://www.intensivregister.de/api/public/reporting/laendertabelle
1659333917,23376,19460,3916,1466,491,https://www.intensivregister.de/api/public/reporting/laendertabelle
1659337522,23440,19518,3922,1467,489,https://www.intensivregister.de/api/public/reporting/laendertabelle
1659341128,23484,19553,3931,1465,487,https://www.intensivregister.de/api/public/reporting/laendertabelle
1659348322,23499,19565,3934,1468,486,https://www.intensivregister.de/api/public/reporting/laendertabelle
1659351921,23499,19564,3935,1469,487,https://www.intensivregister.de/api/public/reporting/laendertabelle
1659355521,23499,19563,3936,1469,487,https://www.intensivregister.de/api/public/reporting/laendertabelle
1659362728,23498,19557,3941,1471,487,https://www.intensivregister.de/api/public/reporting/laendertabelle
1659366317,23499,19557,3942,1471,487,https://www.intensivregister.de/api/public/reporting/laendertabelle
1659384329,23499,19557,3942,1470,487,https://www.intensivregister.de/api/public/reporting/laendertabelle
1659387928,23503,19565,3938,1470,486,https://www.intensivregister.de/api/public/reporting/laendertabelle
1659391517,23506,19556,3950,1468,487,https://www.intensivregister.de/api/public/reporting/laendertabelle
1659395120,23505,19548,3957,1467,487,https://www.intensivregister.de/api/public/reporting/laendertabelle
1659402328,23506,19545,3961,1465,486,https://www.intensivregister.de/api/public/reporting/laendertabelle
1659405930,23509,19563,3946,1462,485,https://www.intensivregister.de/api/public/reporting/laendertabelle
1659413121,23576,19648,3928,1458,485,https://www.intensivregister.de/api/public/reporting/laendertabelle
1659420317,23690,19764,3926,1452,474,https://www.intensivregister.de/api/public/reporting/laendertabelle
1659427517,23712,19813,3899,1441,474,https://www.intensivregister.de/api/public/reporting/laendertabelle
1659431118,23721,19809,3912,1444,474,https://www.intensivregister.de/api/public/reporting/laendertabelle
1659434729,23725,19819,3906,1443,474,https://www.intensivregister.de/api/public/reporting/laendertabelle
1659438318,23729,19815,3914,1443,472,https://www.intensivregister.de/api/public/reporting/laendertabelle
1659445517,23730,19812,3918,1442,471,https://www.intensivregister.de/api/public/reporting/laendertabelle
1659452721,23733,19819,3914,1443,473,https://www.intensivregister.de/api/public/reporting/laendertabelle
1659474328,23734,19819,3915,1445,474,https://www.intensivregister.de/api/public/reporting/laendertabelle
1659477928,23734,19809,3925,1444,474,https://www.intensivregister.de/api/public/reporting/laendertabelle
1659481520,23734,19811,3923,1444,474,https://www.intensivregister.de/api/public/reporting/laendertabelle
1659488720,23734,19816,3918,1447,476,https://www.intensivregister.de/api/public/reporting/laendertabelle
1659495918,23768,19840,3928,1446,475,https://www.intensivregister.de/api/public/reporting/laendertabelle
1659503121,23783,19912,3871,1406,464,https://www.intensivregister.de/api/public/reporting/laendertabelle
1659506727,23796,19971,3825,1397,464,https://www.intensivregister.de/api/public/reporting/laendertabelle
1659513928,23822,20016,3806,1395,462,https://www.intensivregister.de/api/public/reporting/laendertabelle
1659521122,23821,20015,3806,1392,462,https://www.intensivregister.de/api/public/reporting/laendertabelle
1659524722,23823,20016,3807,1392,462,https://www.intensivregister.de/api/public/reporting/laendertabelle
1659528321,23823,20015,3808,1394,465,https://www.intensivregister.de/api/public/reporting/laendertabelle
1659531921,23823,20014,3809,1397,469,https://www.intensivregister.de/api/public/reporting/laendertabelle
1659535522,23823,20013,3810,1397,469,https://www.intensivregister.de/api/public/reporting/laendertabelle
1659539121,23823,20015,3808,1397,469,https://www.intensivregister.de/api/public/reporting/laendertabelle
1659542718,23822,20015,3807,1397,469,https://www.intensivregister.de/api/public/reporting/laendertabelle
1659549928,23822,20017,3805,1397,470,https://www.intensivregister.de/api/public/reporting/laendertabelle
1659560728,23820,20022,3798,1396,469,https://www.intensivregister.de/api/public/reporting/laendertabelle
1659564321,23822,20029,3793,1396,469,https://www.intensivregister.de/api/public/reporting/laendertabelle
1659567921,23822,20036,3786,1398,469,https://www.intensivregister.de/api/public/reporting/laendertabelle
1659571528,23822,20035,3787,1398,469,https://www.intensivregister.de/api/public/reporting/laendertabelle
1659575121,23823,20028,3795,1398,469,https://www.intensivregister.de/api/public/reporting/laendertabelle
1659578722,23826,20031,3795,1399,469,https://www.intensivregister.de/api/public/reporting/laendertabelle
1659582328,23856,20038,3818,1391,469,https://www.intensivregister.de/api/public/reporting/laendertabelle
1659585927,23865,20047,3818,1390,470,https://www.intensivregister.de/api/public/reporting/laendertabelle
1659589528,23890,20093,3797,1392,471,https://www.intensivregister.de/api/public/reporting/laendertabelle
1659593118,23873,20098,3775,1399,467,https://www.intensivregister.de/api/public/reporting/laendertabelle
1659596718,23842,20059,3783,1403,468,https://www.intensivregister.de/api/public/reporting/laendertabelle
1659603928,23843,20048,3795,1403,466,https://www.intensivregister.de/api/public/reporting/laendertabelle
1659607528,23841,20051,3790,1398,465,https://www.intensivregister.de/api/public/reporting/laendertabelle
1659611128,23841,20044,3797,1399,466,https://www.intensivregister.de/api/public/reporting/laendertabelle
1659618321,23841,20038,3803,1387,466,https://www.intensivregister.de/api/public/reporting/laendertabelle
1659618321,23841,20039,3802,1387,467,https://www.intensivregister.de/api/public/reporting/laendertabelle
1659625521,23841,20037,3804,1387,467,https://www.intensivregister.de/api/public/reporting/laendertabelle
1659632718,23840,20038,3802,1389,467,https://www.intensivregister.de/api/public/reporting/laendertabelle
1659636317,23842,20042,3800,1390,468,https://www.intensivregister.de/api/public/reporting/laendertabelle
1659643521,23840,20041,3799,1390,468,https://www.intensivregister.de/api/public/reporting/laendertabelle
1659647117,23840,20044,3796,1390,468,https://www.intensivregister.de/api/public/reporting/laendertabelle
1659650721,23840,20045,3795,1390,468,https://www.intensivregister.de/api/public/reporting/laendertabelle
1659657929,23830,20019,3811,1388,465,https://www.intensivregister.de/api/public/reporting/laendertabelle
1659661514,23832,20016,3816,1388,465,https://www.intensivregister.de/api/public/reporting/laendertabelle
1659668721,23807,19988,3819,1391,462,https://www.intensivregister.de/api/public/reporting/laendertabelle
1659672327,23804,20022,3782,1383,446,https://www.intensivregister.de/api/public/reporting/laendertabelle
1659675917,23766,20037,3729,1373,448,https://www.intensivregister.de/api/public/reporting/laendertabelle
1659683121,23704,19985,3719,1377,444,https://www.intensivregister.de/api/public/reporting/laendertabelle
1659686718,23705,20008,3697,1376,450,https://www.intensivregister.de/api/public/reporting/laendertabelle
1659693918,23690,19999,3691,1376,449,https://www.intensivregister.de/api/public/reporting/laendertabelle
1659697520,23676,19993,3683,1375,449,https://www.intensivregister.de/api/public/reporting/laendertabelle
1659704717,23667,19976,3691,1373,449,https://www.intensivregister.de/api/public/reporting/laendertabelle
1659708321,23668,19979,3689,1374,449,https://www.intensivregister.de/api/public/reporting/laendertabelle
1659711922,23668,19978,3690,1374,449,https://www.intensivregister.de/api/public/reporting/laendertabelle
1659729920,23668,19980,3688,1375,449,https://www.intensivregister.de/api/public/reporting/laendertabelle
1659733520,23668,19983,3685,1376,450,https://www.intensivregister.de/api/public/reporting/laendertabelle
1659740729,23667,19985,3682,1378,450,https://www.intensivregister.de/api/public/reporting/laendertabelle
1659744318,23667,19997,3670,1378,450,https://www.intensivregister.de/api/public/reporting/laendertabelle
1659747917,23662,19991,3671,1376,449,https://www.intensivregister.de/api/public/reporting/laendertabelle
1659755128,23658,19961,3697,1376,451,https://www.intensivregister.de/api/public/reporting/laendertabelle
1659762329,23558,19888,3670,1383,455,https://www.intensivregister.de/api/public/reporting/laendertabelle
1659765922,23516,19854,3662,1365,455,https://www.intensivregister.de/api/public/reporting/laendertabelle
1659773121,23484,19769,3715,1349,459,https://www.intensivregister.de/api/public/reporting/laendertabelle
1659776717,23479,19766,3713,1345,459,https://www.intensivregister.de/api/public/reporting/laendertabelle
1659780321,23477,19764,3713,1346,459,https://www.intensivregister.de/api/public/reporting/laendertabelle
1659783917,23481,19765,3716,1344,459,https://www.intensivregister.de/api/public/reporting/laendertabelle
1659787522,23481,19761,3720,1344,459,https://www.intensivregister.de/api/public/reporting/laendertabelle
1659791129,23481,19758,3723,1344,459,https://www.intensivregister.de/api/public/reporting/laendertabelle
1659794717,23481,19758,3723,1342,457,https://www.intensivregister.de/api/public/reporting/laendertabelle
1659809121,23481,19760,3721,1342,457,https://www.intensivregister.de/api/public/reporting/laendertabelle
1659812721,23481,19765,3716,1341,457,https://www.intensivregister.de/api/public/reporting/laendertabelle
1659816321,23481,19768,3713,1341,457,https://www.intensivregister.de/api/public/reporting/laendertabelle
1659819919,23478,19756,3722,1340,458,https://www.intensivregister.de/api/public/reporting/laendertabelle
1659823522,23478,19755,3723,1340,458,https://www.intensivregister.de/api/public/reporting/laendertabelle
1659827118,23476,19754,3722,1341,458,https://www.intensivregister.de/api/public/reporting/laendertabelle
1659830717,23470,19748,3722,1341,458,https://www.intensivregister.de/api/public/reporting/laendertabelle
1659837928,23469,19737,3732,1339,458,https://www.intensivregister.de/api/public/reporting/laendertabelle
1659841522,23479,19726,3753,1338,458,https://www.intensivregister.de/api/public/reporting/laendertabelle
1659848718,23466,19540,3926,1311,459,https://www.intensivregister.de/api/public/reporting/laendertabelle
1659852321,23442,19479,3963,1299,460,https://www.intensivregister.de/api/public/reporting/laendertabelle
1659859521,23424,19403,4021,1286,451,https://www.intensivregister.de/api/public/reporting/laendertabelle
1659863127,23424,19402,4022,1287,452,https://www.intensivregister.de/api/public/reporting/laendertabelle
1659866721,23423,19389,4034,1287,452,https://www.intensivregister.de/api/public/reporting/laendertabelle
1659873921,23423,19384,4039,1286,451,https://www.intensivregister.de/api/public/reporting/laendertabelle
1659877527,23427,19386,4041,1285,451,https://www.intensivregister.de/api/public/reporting/laendertabelle
1659884720,23427,19382,4045,1285,451,https://www.intensivregister.de/api/public/reporting/laendertabelle
1659891921,23428,19380,4048,1285,451,https://www.intensivregister.de/api/public/reporting/laendertabelle
1659902717,23426,19377,4049,1283,452,https://www.intensivregister.de/api/public/reporting/laendertabelle
1659906327,23427,19375,4052,1284,451,https://www.intensivregister.de/api/public/reporting/laendertabelle
1659909917,23427,19377,4050,1283,450,https://www.intensivregister.de/api/public/reporting/laendertabelle
1659913518,23428,19378,4050,1283,450,https://www.intensivregister.de/api/public/reporting/laendertabelle
1659917121,23428,19377,4051,1284,450,https://www.intensivregister.de/api/public/reporting/laendertabelle
1659920728,23432,19381,4051,1284,450,https://www.intensivregister.de/api/public/reporting/laendertabelle
1659924328,23437,19385,4052,1286,451,https://www.intensivregister.de/api/public/reporting/laendertabelle
1659927918,23476,19438,4038,1292,457,https://www.intensivregister.de/api/public/reporting/laendertabelle
1659935121,23571,19518,4053,1296,453,https://www.intensivregister.de/api/public/reporting/laendertabelle
1659942317,23655,19595,4060,1324,446,https://www.intensivregister.de/api/public/reporting/laendertabelle
1659945921,23670,19625,4045,1330,451,https://www.intensivregister.de/api/public/reporting/laendertabelle
1659953121,23685,19631,4054,1324,450,https://www.intensivregister.de/api/public/reporting/laendertabelle
1659956722,23684,19631,4053,1325,450,https://www.intensivregister.de/api/public/reporting/laendertabelle
1659963920,23697,19644,4053,1327,449,https://www.intensivregister.de/api/public/reporting/laendertabelle
1659989117,23697,19646,4051,1327,449,https://www.intensivregister.de/api/public/reporting/laendertabelle
1659996320,23696,19640,4056,1323,448,https://www.intensivregister.de/api/public/reporting/laendertabelle
1659999917,23696,19638,4058,1323,448,https://www.intensivregister.de/api/public/reporting/laendertabelle
1660003526,23692,19638,4054,1321,446,https://www.intensivregister.de/api/public/reporting/laendertabelle
1660007119,23692,19639,4053,1321,446,https://www.intensivregister.de/api/public/reporting/laendertabelle
1660010722,23688,19649,4039,1322,446,https://www.intensivregister.de/api/public/reporting/laendertabelle
1660017921,23752,19759,3993,1310,445,https://www.intensivregister.de/api/public/reporting/laendertabelle
1660025121,23752,19829,3923,1282,443,https://www.intensivregister.de/api/public/reporting/laendertabelle
1660028728,23769,19843,3926,1273,441,https://www.intensivregister.de/api/public/reporting/laendertabelle
1660035929,23797,19873,3924,1270,442,https://www.intensivregister.de/api/public/reporting/laendertabelle
1660039521,23797,19878,3919,1269,442,https://www.intensivregister.de/api/public/reporting/laendertabelle
1660043118,23788,19879,3909,1270,442,https://www.intensivregister.de/api/public/reporting/laendertabelle
1660050321,23789,19883,3906,1270,441,https://www.intensivregister.de/api/public/reporting/laendertabelle
1660057528,23796,19887,3909,1268,441,https://www.intensivregister.de/api/public/reporting/laendertabelle
1660061120,23796,19889,3907,1268,441,https://www.intensivregister.de/api/public/reporting/laendertabelle
1660079117,23798,19883,3915,1267,441,https://www.intensivregister.de/api/public/reporting/laendertabelle
1660082721,23801,19888,3913,1266,441,https://www.intensivregister.de/api/public/reporting/laendertabelle
1660089920,23799,19883,3916,1265,440,https://www.intensivregister.de/api/public/reporting/laendertabelle
1660093522,23799,19888,3911,1266,440,https://www.intensivregister.de/api/public/reporting/laendertabelle
1660097121,23795,19894,3901,1270,441,https://www.intensivregister.de/api/public/reporting/laendertabelle
1660104328,23790,19905,3885,1254,435,https://www.intensivregister.de/api/public/reporting/laendertabelle
1660107927,23790,19913,3877,1257,440,https://www.intensivregister.de/api/public/reporting/laendertabelle
1660115118,23802,19977,3825,1249,443,https://www.intensivregister.de/api/public/reporting/laendertabelle
1660118718,23824,19991,3833,1238,443,https://www.intensivregister.de/api/public/reporting/laendertabelle
1660122322,23820,19988,3832,1235,443,https://www.intensivregister.de/api/public/reporting/laendertabelle
1660129521,23823,19977,3846,1236,443,https://www.intensivregister.de/api/public/reporting/laendertabelle
1660133121,23823,19980,3843,1235,443,https://www.intensivregister.de/api/public/reporting/laendertabelle
1660136721,23822,19980,3842,1235,443,https://www.intensivregister.de/api/public/reporting/laendertabelle
1660143918,23822,19982,3840,1235,443,https://www.intensivregister.de/api/public/reporting/laendertabelle
1660161921,23822,19984,3838,1235,443,https://www.intensivregister.de/api/public/reporting/laendertabelle
1660165528,23822,19979,3843,1239,443,https://www.intensivregister.de/api/public/reporting/laendertabelle
1660172728,23827,19983,3844,1239,443,https://www.intensivregister.de/api/public/reporting/laendertabelle
1660176321,23827,19988,3839,1238,443,https://www.intensivregister.de/api/public/reporting/laendertabelle
1660179921,23827,19985,3842,1237,442,https://www.intensivregister.de/api/public/reporting/laendertabelle
1660187118,23807,19963,3844,1230,445,https://www.intensivregister.de/api/public/reporting/laendertabelle
1660190720,23816,19970,3846,1197,443,https://www.intensivregister.de/api/public/reporting/laendertabelle
1660194328,23831,19959,3872,1184,439,https://www.intensivregister.de/api/public/reporting/laendertabelle
1660197921,23811,19926,3885,1169,433,https://www.intensivregister.de/api/public/reporting/laendertabelle
1660205120,23816,19923,3893,1179,429,https://www.intensivregister.de/api/public/reporting/laendertabelle
1660208721,23837,19944,3893,1178,430,https://www.intensivregister.de/api/public/reporting/laendertabelle
1660212317,23837,19945,3892,1175,430,https://www.intensivregister.de/api/public/reporting/laendertabelle
1660219521,23839,19939,3900,1172,429,https://www.intensivregister.de/api/public/reporting/laendertabelle
1660223121,23838,19945,3893,1168,428,https://www.intensivregister.de/api/public/reporting/laendertabelle
1660226719,23835,19947,3888,1169,428,https://www.intensivregister.de/api/public/reporting/laendertabelle
1660244721,23835,19949,3886,1169,428,https://www.intensivregister.de/api/public/reporting/laendertabelle
1660248319,23835,19947,3888,1167,427,https://www.intensivregister.de/api/public/reporting/laendertabelle
1660251921,23834,19944,3890,1169,427,https://www.intensivregister.de/api/public/reporting/laendertabelle
1660255528,23834,19939,3895,1170,428,https://www.intensivregister.de/api/public/reporting/laendertabelle
1660259118,23834,19940,3894,1169,427,https://www.intensivregister.de/api/public/reporting/laendertabelle
1660262730,23834,19935,3899,1172,428,https://www.intensivregister.de/api/public/reporting/laendertabelle
1660266318,23834,19934,3900,1173,428,https://www.intensivregister.de/api/public/reporting/laendertabelle
1660269921,23834,19941,3893,1172,427,https://www.intensivregister.de/api/public/reporting/laendertabelle
1660277121,23799,19968,3831,1176,422,https://www.intensivregister.de/api/public/reporting/laendertabelle
1660280722,23748,19941,3807,1163,419,https://www.intensivregister.de/api/public/reporting/laendertabelle
1660284322,23741,19952,3789,1168,425,https://www.intensivregister.de/api/public/reporting/laendertabelle
1660291522,23717,19943,3774,1160,420,https://www.intensivregister.de/api/public/reporting/laendertabelle
1660298718,23723,19952,3771,1160,420,https://www.intensivregister.de/api/public/reporting/laendertabelle
1660305921,23717,19938,3779,1161,420,https://www.intensivregister.de/api/public/reporting/laendertabelle
1660313121,23717,19935,3782,1162,421,https://www.intensivregister.de/api/public/reporting/laendertabelle
1660323928,23716,19932,3784,1162,421,https://www.intensivregister.de/api/public/reporting/laendertabelle
1660334718,23716,19931,3785,1161,421,https://www.intensivregister.de/api/public/reporting/laendertabelle
1660338315,23700,19921,3779,1161,421,https://www.intensivregister.de/api/public/reporting/laendertabelle
1660345518,23698,19922,3776,1161,421,https://www.intensivregister.de/api/public/reporting/laendertabelle
1660349129,23698,19916,3782,1160,421,https://www.intensivregister.de/api/public/reporting/laendertabelle
1660352722,23697,19916,3781,1160,421,https://www.intensivregister.de/api/public/reporting/laendertabelle
1660356321,23695,19902,3793,1162,421,https://www.intensivregister.de/api/public/reporting/laendertabelle
1660363518,23642,19823,3819,1146,425,https://www.intensivregister.de/api/public/reporting/laendertabelle
1660367120,23583,19737,3846,1131,426,https://www.intensivregister.de/api/public/reporting/laendertabelle
1660370721,23530,19689,3841,1139,425,https://www.intensivregister.de/api/public/reporting/laendertabelle
1660374328,23490,19616,3874,1137,426,https://www.intensivregister.de/api/public/reporting/laendertabelle
1660377921,23457,19548,3909,1141,424,https://www.intensivregister.de/api/public/reporting/laendertabelle
1660381528,23448,19537,3911,1142,424,https://www.intensivregister.de/api/public/reporting/laendertabelle
1660385128,23442,19535,3907,1143,423,https://www.intensivregister.de/api/public/reporting/laendertabelle
1660392320,23441,19531,3910,1144,423,https://www.intensivregister.de/api/public/reporting/laendertabelle
1660395921,23441,19533,3908,1144,423,https://www.intensivregister.de/api/public/reporting/laendertabelle
1660403118,23439,19527,3912,1144,423,https://www.intensivregister.de/api/public/reporting/laendertabelle
1660406722,23439,19527,3912,1145,424,https://www.intensivregister.de/api/public/reporting/laendertabelle
1660413920,23440,19521,3919,1143,423,https://www.intensivregister.de/api/public/reporting/laendertabelle
1660417527,23439,19520,3919,1143,423,https://www.intensivregister.de/api/public/reporting/laendertabelle
1660424721,23440,19523,3917,1142,423,https://www.intensivregister.de/api/public/reporting/laendertabelle
1660431921,23446,19523,3923,1142,423,https://www.intensivregister.de/api/public/reporting/laendertabelle
1660435521,23446,19520,3926,1143,423,https://www.intensivregister.de/api/public/reporting/laendertabelle
1660439122,23446,19520,3926,1142,423,https://www.intensivregister.de/api/public/reporting/laendertabelle
1660446317,23438,19510,3928,1145,421,https://www.intensivregister.de/api/public/reporting/laendertabelle
1660453521,23386,19387,3999,1155,420,https://www.intensivregister.de/api/public/reporting/laendertabelle
1660457121,23383,19295,4088,1155,425,https://www.intensivregister.de/api/public/reporting/laendertabelle
1660460718,23366,19284,4082,1158,427,https://www.intensivregister.de/api/public/reporting/laendertabelle
1660464320,23370,19257,4113,1157,428,https://www.intensivregister.de/api/public/reporting/laendertabelle
1660471518,23372,19264,4108,1159,428,https://www.intensivregister.de/api/public/reporting/laendertabelle
1660478721,23346,19240,4106,1159,426,https://www.intensivregister.de/api/public/reporting/laendertabelle
1660482318,23346,19238,4108,1159,425,https://www.intensivregister.de/api/public/reporting/laendertabelle
1660489518,23346,19237,4109,1158,424,https://www.intensivregister.de/api/public/reporting/laendertabelle
1660493118,23348,19232,4116,1158,424,https://www.intensivregister.de/api/public/reporting/laendertabelle
1660500320,23348,19231,4117,1157,424,https://www.intensivregister.de/api/public/reporting/laendertabelle
1660503927,23348,19232,4116,1157,424,https://www.intensivregister.de/api/public/reporting/laendertabelle
1660507528,23348,19235,4113,1157,424,https://www.intensivregister.de/api/public/reporting/laendertabelle
1660514728,23347,19225,4122,1159,424,https://www.intensivregister.de/api/public/reporting/laendertabelle
1660521921,23348,19223,4125,1159,424,https://www.intensivregister.de/api/public/reporting/laendertabelle
1660529120,23348,19231,4117,1159,424,https://www.intensivregister.de/api/public/reporting/laendertabelle
1660532727,23367,19261,4106,1150,426,https://www.intensivregister.de/api/public/reporting/laendertabelle
1660536318,23439,19340,4099,1150,427,https://www.intensivregister.de/api/public/reporting/laendertabelle
1660539929,23567,19397,4170,1160,426,https://www.intensivregister.de/api/public/reporting/laendertabelle
1660547128,23643,19496,4147,1152,428,https://www.intensivregister.de/api/public/reporting/laendertabelle
1660550721,23654,19501,4153,1150,431,https://www.intensivregister.de/api/public/reporting/laendertabelle
1660554318,23650,19498,4152,1149,431,https://www.intensivregister.de/api/public/reporting/laendertabelle
1660557928,23649,19497,4152,1150,431,https://www.intensivregister.de/api/public/reporting/laendertabelle
1660561529,23655,19495,4160,1151,431,https://www.intensivregister.de/api/public/reporting/laendertabelle
1660568721,23655,19496,4159,1156,431,https://www.intensivregister.de/api/public/reporting/laendertabelle
1660572321,23655,19496,4159,1155,431,https://www.intensivregister.de/api/public/reporting/laendertabelle
1660579521,23655,19497,4158,1155,431,https://www.intensivregister.de/api/public/reporting/laendertabelle
1660593929,23655,19499,4156,1156,431,https://www.intensivregister.de/api/public/reporting/laendertabelle
1660597521,23652,19495,4157,1155,429,https://www.intensivregister.de/api/public/reporting/laendertabelle
1660601127,23657,19497,4160,1157,429,https://www.intensivregister.de/api/public/reporting/laendertabelle
1660604728,23655,19499,4156,1158,429,https://www.intensivregister.de/api/public/reporting/laendertabelle
1660608320,23655,19502,4153,1158,428,https://www.intensivregister.de/api/public/reporting/laendertabelle
1660611921,23655,19502,4153,1157,428,https://www.intensivregister.de/api/public/reporting/laendertabelle
1660615521,23660,19502,4158,1157,430,https://www.intensivregister.de/api/public/reporting/laendertabelle
1660619118,23690,19546,4144,1155,429,https://www.intensivregister.de/api/public/reporting/laendertabelle
1660622718,23712,19606,4106,1142,422,https://www.intensivregister.de/api/public/reporting/laendertabelle
1660629921,23739,19720,4019,1146,426,https://www.intensivregister.de/api/public/reporting/laendertabelle
1660633520,23745,19797,3948,1135,415,https://www.intensivregister.de/api/public/reporting/laendertabelle
1660637128,23806,19911,3895,1132,411,https://www.intensivregister.de/api/public/reporting/laendertabelle
1660640718,23808,19916,3892,1129,412,https://www.intensivregister.de/api/public/reporting/laendertabelle
1660647928,23812,19944,3868,1133,413,https://www.intensivregister.de/api/public/reporting/laendertabelle
1660651522,23812,19934,3878,1132,413,https://www.intensivregister.de/api/public/reporting/laendertabelle
1660655129,23812,19934,3878,1131,413,https://www.intensivregister.de/api/public/reporting/laendertabelle
1660658728,23814,19935,3879,1134,414,https://www.intensivregister.de/api/public/reporting/laendertabelle
1660680317,23814,19936,3878,1134,413,https://www.intensivregister.de/api/public/reporting/laendertabelle
1660687528,23811,19932,3879,1130,412,https://www.intensivregister.de/api/public/reporting/laendertabelle
1660694722,23803,19929,3874,1132,412,https://www.intensivregister.de/api/public/reporting/laendertabelle
1660698318,23803,19926,3877,1131,411,https://www.intensivregister.de/api/public/reporting/laendertabelle
1660705521,23812,19963,3849,1121,408,https://www.intensivregister.de/api/public/reporting/laendertabelle
1660709128,23804,19971,3833,1108,401,https://www.intensivregister.de/api/public/reporting/laendertabelle
1660712720,23883,20067,3816,1096,400,https://www.intensivregister.de/api/public/reporting/laendertabelle
1660716328,23885,20055,3830,1089,397,https://www.intensivregister.de/api/public/reporting/laendertabelle
1660723529,23885,20041,3844,1075,390,https://www.intensivregister.de/api/public/reporting/laendertabelle
1660730728,23891,20050,3841,1074,388,https://www.intensivregister.de/api/public/reporting/laendertabelle
1660734321,23891,20049,3842,1074,388,https://www.intensivregister.de/api/public/reporting/laendertabelle
1660741516,23890,20048,3842,1074,387,https://www.intensivregister.de/api/public/reporting/laendertabelle
1660748724,23886,20050,3836,1074,387,https://www.intensivregister.de/api/public/reporting/laendertabelle
1660759515,23907,20070,3837,1074,387,https://www.intensivregister.de/api/public/reporting/laendertabelle
1660766714,23907,20069,3838,1074,387,https://www.intensivregister.de/api/public/reporting/laendertabelle
1660773923,23911,20075,3836,1072,388,https://www.intensivregister.de/api/public/reporting/laendertabelle
1660781123,23911,20076,3835,1072,388,https://www.intensivregister.de/api/public/reporting/laendertabelle
1660784714,23914,20073,3841,1073,388,https://www.intensivregister.de/api/public/reporting/laendertabelle
1660788324,23914,20071,3843,1069,387,https://www.intensivregister.de/api/public/reporting/laendertabelle
1660795525,23924,20109,3815,1084,397,https://www.intensivregister.de/api/public/reporting/laendertabelle
1660802715,23909,20168,3741,1093,393,https://www.intensivregister.de/api/public/reporting/laendertabelle
1660806314,23923,20195,3728,1100,393,https://www.intensivregister.de/api/public/reporting/laendertabelle
1660809914,23903,20195,3708,1104,394,https://www.intensivregister.de/api/public/reporting/laendertabelle
1660813516,23888,20182,3706,1102,392,https://www.intensivregister.de/api/public/reporting/laendertabelle
1660817114,23878,20187,3691,1104,394,https://www.intensivregister.de/api/public/reporting/laendertabelle
1660824325,23875,20189,3686,1105,394,https://www.intensivregister.de/api/public/reporting/laendertabelle
1660838725,23875,20190,3685,1104,394,https://www.intensivregister.de/api/public/reporting/laendertabelle
1660842325,23875,20187,3688,1103,393,https://www.intensivregister.de/api/public/reporting/laendertabelle
1660845924,23875,20182,3693,1102,393,https://www.intensivregister.de/api/public/reporting/laendertabelle
1660853115,23874,20181,3693,1103,395,https://www.intensivregister.de/api/public/reporting/laendertabelle
1660860314,23879,20183,3696,1102,395,https://www.intensivregister.de/api/public/reporting/laendertabelle
1660863915,23879,20184,3695,1103,395,https://www.intensivregister.de/api/public/reporting/laendertabelle
1660867514,23878,20186,3692,1102,395,https://www.intensivregister.de/api/public/reporting/laendertabelle
1660871124,23880,20195,3685,1103,395,https://www.intensivregister.de/api/public/reporting/laendertabelle
1660874715,23877,20196,3681,1101,394,https://www.intensivregister.de/api/public/reporting/laendertabelle
1660881925,23818,20144,3674,1087,384,https://www.intensivregister.de/api/public/reporting/laendertabelle
1660889115,23758,20096,3662,1052,380,https://www.intensivregister.de/api/public/reporting/laendertabelle
1660896314,23748,20114,3634,1042,374,https://www.intensivregister.de/api/public/reporting/laendertabelle
1660899915,23739,20106,3633,1038,375,https://www.intensivregister.de/api/public/reporting/laendertabelle
1660907115,23724,20095,3629,1042,376,https://www.intensivregister.de/api/public/reporting/laendertabelle
1660910714,23724,20098,3626,1044,376,https://www.intensivregister.de/api/public/reporting/laendertabelle
1660914314,23726,20100,3626,1044,376,https://www.intensivregister.de/api/public/reporting/laendertabelle
1660921515,23726,20099,3627,1043,376,https://www.intensivregister.de/api/public/reporting/laendertabelle
1660939524,23726,20101,3625,1043,376,https://www.intensivregister.de/api/public/reporting/laendertabelle
1660946715,23725,20094,3631,1041,373,https://www.intensivregister.de/api/public/reporting/laendertabelle
1660953914,23723,20087,3636,1042,373,https://www.intensivregister.de/api/public/reporting/laendertabelle
1660961114,23710,20082,3628,1037,373,https://www.intensivregister.de/api/public/reporting/laendertabelle
1660964714,23706,20043,3663,1035,372,https://www.intensivregister.de/api/public/reporting/laendertabelle
1660971914,23631,19890,3741,1013,370,https://www.intensivregister.de/api/public/reporting/laendertabelle
1661000724,23536,19636,3900,986,361,https://www.intensivregister.de/api/public/reporting/laendertabelle
1661004314,23544,19641,3903,986,361,https://www.intensivregister.de/api/public/reporting/laendertabelle
1661011515,23544,19637,3907,985,361,https://www.intensivregister.de/api/public/reporting/laendertabelle
1661025925,23545,19632,3913,986,361,https://www.intensivregister.de/api/public/reporting/laendertabelle
1661029515,23542,19631,3911,988,362,https://www.intensivregister.de/api/public/reporting/laendertabelle
1661036715,23539,19611,3928,977,362,https://www.intensivregister.de/api/public/reporting/laendertabelle
1661040314,23539,19614,3925,977,362,https://www.intensivregister.de/api/public/reporting/laendertabelle
1661043915,23539,19613,3926,977,362,https://www.intensivregister.de/api/public/reporting/laendertabelle
1661094324,23440,19436,4004,988,362,https://www.intensivregister.de/api/public/reporting/laendertabelle
1661097913,23440,19433,4007,988,362,https://www.intensivregister.de/api/public/reporting/laendertabelle
1661105113,23441,19432,4009,988,362,https://www.intensivregister.de/api/public/reporting/laendertabelle
1661108715,23441,19435,4006,988,362,https://www.intensivregister.de/api/public/reporting/laendertabelle
1661112314,23441,19438,4003,988,362,https://www.intensivregister.de/api/public/reporting/laendertabelle
1661119523,23445,19441,4004,989,363,https://www.intensivregister.de/api/public/reporting/laendertabelle
1661123123,23445,19438,4007,989,363,https://www.intensivregister.de/api/public/reporting/laendertabelle
1661126724,23444,19443,4001,990,363,https://www.intensivregister.de/api/public/reporting/laendertabelle
1661133924,23445,19444,4001,990,363,https://www.intensivregister.de/api/public/reporting/laendertabelle
1661137515,23493,19472,4021,990,369,https://www.intensivregister.de/api/public/reporting/laendertabelle
1661141116,23557,19526,4031,972,359,https://www.intensivregister.de/api/public/reporting/laendertabelle
1661148324,23625,19508,4117,988,359,https://www.intensivregister.de/api/public/reporting/laendertabelle
1661155524,23633,19491,4142,990,360,https://www.intensivregister.de/api/public/reporting/laendertabelle
1661159114,23629,19484,4145,989,359,https://www.intensivregister.de/api/public/reporting/laendertabelle
1661162714,23625,19486,4139,989,360,https://www.intensivregister.de/api/public/reporting/laendertabelle
1661166314,23627,19485,4142,988,360,https://www.intensivregister.de/api/public/reporting/laendertabelle
1661169914,23628,19486,4142,988,360,https://www.intensivregister.de/api/public/reporting/laendertabelle
1661173524,23628,19483,4145,988,360,https://www.intensivregister.de/api/public/reporting/laendertabelle
1661177114,23629,19488,4141,989,360,https://www.intensivregister.de/api/public/reporting/laendertabelle
1661180713,23629,19487,4142,990,361,https://www.intensivregister.de/api/public/reporting/laendertabelle
1661191523,23629,19488,4141,991,362,https://www.intensivregister.de/api/public/reporting/laendertabelle
1661198714,23628,19486,4142,991,362,https://www.intensivregister.de/api/public/reporting/laendertabelle
1661202314,23631,19499,4132,987,362,https://www.intensivregister.de/api/public/reporting/laendertabelle
1661209514,23633,19505,4128,990,362,https://www.intensivregister.de/api/public/reporting/laendertabelle
1661216724,23638,19521,4117,991,363,https://www.intensivregister.de/api/public/reporting/laendertabelle
1661220324,23646,19516,4130,990,362,https://www.intensivregister.de/api/public/reporting/laendertabelle
1661227524,23695,19708,3987,981,359,https://www.intensivregister.de/api/public/reporting/laendertabelle
1661231124,23741,19858,3883,964,360,https://www.intensivregister.de/api/public/reporting/laendertabelle
1661234723,23774,19953,3821,962,354,https://www.intensivregister.de/api/public/reporting/laendertabelle
1661238324,23834,20032,3802,963,352,https://www.intensivregister.de/api/public/reporting/laendertabelle
1661241914,23836,20044,3792,960,351,https://www.intensivregister.de/api/public/reporting/laendertabelle
1661245515,23835,20039,3796,962,351,https://www.intensivregister.de/api/public/reporting/laendertabelle
1661249114,23838,20053,3785,962,351,https://www.intensivregister.de/api/public/reporting/laendertabelle
1661256324,23838,20054,3784,961,351,https://www.intensivregister.de/api/public/reporting/laendertabelle
1661259914,23837,20054,3783,961,351,https://www.intensivregister.de/api/public/reporting/laendertabelle
1661267114,23837,20059,3778,958,348,https://www.intensivregister.de/api/public/reporting/laendertabelle
1661285114,23837,20057,3780,958,348,https://www.intensivregister.de/api/public/reporting/laendertabelle
1661288724,23843,20059,3784,956,348,https://www.intensivregister.de/api/public/reporting/laendertabelle
1661292324,23843,20063,3780,957,348,https://www.intensivregister.de/api/public/reporting/laendertabelle
1661299524,23844,20066,3778,957,349,https://www.intensivregister.de/api/public/reporting/laendertabelle
1661303114,23846,20070,3776,957,349,https://www.intensivregister.de/api/public/reporting/laendertabelle
1661313914,23858,20033,3825,951,346,https://www.intensivregister.de/api/public/reporting/laendertabelle
1661321114,23855,20013,3842,918,337,https://www.intensivregister.de/api/public/reporting/laendertabelle
1661346314,23903,20028,3875,899,335,https://www.intensivregister.de/api/public/reporting/laendertabelle
1661349924,23903,20032,3871,899,335,https://www.intensivregister.de/api/public/reporting/laendertabelle
1661353514,23903,20033,3870,899,335,https://www.intensivregister.de/api/public/reporting/laendertabelle
1661364324,23883,20015,3868,900,335,https://www.intensivregister.de/api/public/reporting/laendertabelle
1661367913,23883,20014,3869,901,336,https://www.intensivregister.de/api/public/reporting/laendertabelle
1661375124,23882,20004,3878,899,337,https://www.intensivregister.de/api/public/reporting/laendertabelle
1661382324,23878,19997,3881,899,336,https://www.intensivregister.de/api/public/reporting/laendertabelle
1661385914,23880,20005,3875,900,336,https://www.intensivregister.de/api/public/reporting/laendertabelle
1661393114,23880,20001,3879,900,336,https://www.intensivregister.de/api/public/reporting/laendertabelle
1661393114,23884,20015,3869,901,337,https://www.intensivregister.de/api/public/reporting/laendertabelle
1661396714,23882,19962,3920,890,331,https://www.intensivregister.de/api/public/reporting/laendertabelle
1661400325,23880,19962,3918,893,333,https://www.intensivregister.de/api/public/reporting/laendertabelle
1661407523,23860,19952,3908,894,334,https://www.intensivregister.de/api/public/reporting/laendertabelle
1661411113,23866,19982,3884,894,334,https://www.intensivregister.de/api/public/reporting/laendertabelle
1661414714,23848,19960,3888,894,333,https://www.intensivregister.de/api/public/reporting/laendertabelle
1661421925,23848,19961,3887,894,332,https://www.intensivregister.de/api/public/reporting/laendertabelle
1661425515,23848,19955,3893,893,331,https://www.intensivregister.de/api/public/reporting/laendertabelle
1661429113,23848,19953,3895,892,330,https://www.intensivregister.de/api/public/reporting/laendertabelle
1661432714,23848,19954,3894,891,331,https://www.intensivregister.de/api/public/reporting/laendertabelle
1661443514,23848,19955,3893,891,331,https://www.intensivregister.de/api/public/reporting/laendertabelle
1661447114,23848,19956,3892,892,331,https://www.intensivregister.de/api/public/reporting/laendertabelle
1661461513,23849,19955,3894,893,331,https://www.intensivregister.de/api/public/reporting/laendertabelle
1661465114,23849,19954,3895,894,331,https://www.intensivregister.de/api/public/reporting/laendertabelle
1661468715,23848,19953,3895,895,331,https://www.intensivregister.de/api/public/reporting/laendertabelle
1661475914,23848,19952,3896,894,329,https://www.intensivregister.de/api/public/reporting/laendertabelle
1661479525,23843,19946,3897,893,327,https://www.intensivregister.de/api/public/reporting/laendertabelle
1661483114,23831,19968,3863,893,328,https://www.intensivregister.de/api/public/reporting/laendertabelle
1661490315,23797,19968,3829,887,323,https://www.intensivregister.de/api/public/reporting/laendertabelle
1661493924,23771,19987,3784,888,323,https://www.intensivregister.de/api/public/reporting/laendertabelle
1661497514,23760,19979,3781,884,328,https://www.intensivregister.de/api/public/reporting/laendertabelle
1661504715,23743,19978,3765,878,328,https://www.intensivregister.de/api/public/reporting/laendertabelle
1661511914,23740,19982,3758,877,327,https://www.intensivregister.de/api/public/reporting/laendertabelle
1661515514,23702,19938,3764,873,325,https://www.intensivregister.de/api/public/reporting/laendertabelle
1661519114,23702,19938,3764,875,327,https://www.intensivregister.de/api/public/reporting/laendertabelle
1661522713,23701,19942,3759,876,327,https://www.intensivregister.de/api/public/reporting/laendertabelle
1661529915,23705,19945,3760,875,328,https://www.intensivregister.de/api/public/reporting/laendertabelle
1661533513,23705,19945,3760,876,328,https://www.intensivregister.de/api/public/reporting/laendertabelle
1661547924,23702,19942,3760,878,328,https://www.intensivregister.de/api/public/reporting/laendertabelle
1661555114,23697,19940,3757,879,329,https://www.intensivregister.de/api/public/reporting/laendertabelle
1661558714,23697,19944,3753,879,329,https://www.intensivregister.de/api/public/reporting/laendertabelle
1661562314,23701,19942,3759,878,329,https://www.intensivregister.de/api/public/reporting/laendertabelle
1661565914,23699,19934,3765,879,329,https://www.intensivregister.de/api/public/reporting/laendertabelle
1661573124,23650,19860,3790,869,324,https://www.intensivregister.de/api/public/reporting/laendertabelle
1661580315,23594,19677,3917,857,324,https://www.intensivregister.de/api/public/reporting/laendertabelle
1661583914,23569,19653,3916,863,329,https://www.intensivregister.de/api/public/reporting/laendertabelle
1661587515,23534,19609,3925,859,329,https://www.intensivregister.de/api/public/reporting/laendertabelle
1661591124,23532,19612,3920,852,327,https://www.intensivregister.de/api/public/reporting/laendertabelle
1661594714,23530,19606,3924,851,328,https://www.intensivregister.de/api/public/reporting/laendertabelle
1661598314,23520,19599,3921,852,328,https://www.intensivregister.de/api/public/reporting/laendertabelle
1661601924,23512,19595,3917,850,328,https://www.intensivregister.de/api/public/reporting/laendertabelle
1661605523,23511,19592,3919,850,328,https://www.intensivregister.de/api/public/reporting/laendertabelle
1661612713,23511,19586,3925,850,328,https://www.intensivregister.de/api/public/reporting/laendertabelle
1661619914,23506,19582,3924,851,328,https://www.intensivregister.de/api/public/reporting/laendertabelle
1661627114,23506,19584,3922,850,328,https://www.intensivregister.de/api/public/reporting/laendertabelle
1661630713,23506,19586,3920,850,328,https://www.intensivregister.de/api/public/reporting/laendertabelle
1661634313,23507,19585,3922,850,327,https://www.intensivregister.de/api/public/reporting/laendertabelle
1661641513,23510,19585,3925,850,327,https://www.intensivregister.de/api/public/reporting/laendertabelle
1661645115,23510,19582,3928,850,327,https://www.intensivregister.de/api/public/reporting/laendertabelle
1661652314,23512,19590,3922,850,327,https://www.intensivregister.de/api/public/reporting/laendertabelle
1661659513,23504,19512,3992,847,324,https://www.intensivregister.de/api/public/reporting/laendertabelle
1661666714,23449,19354,4095,847,324,https://www.intensivregister.de/api/public/reporting/laendertabelle
1661670314,23426,19285,4141,835,320,https://www.intensivregister.de/api/public/reporting/laendertabelle
1661673915,23428,19279,4149,848,322,https://www.intensivregister.de/api/public/reporting/laendertabelle
1661677515,23423,19264,4159,846,321,https://www.intensivregister.de/api/public/reporting/laendertabelle
1661681113,23419,19257,4162,848,321,https://www.intensivregister.de/api/public/reporting/laendertabelle
1661688314,23417,19253,4164,848,322,https://www.intensivregister.de/api/public/reporting/laendertabelle
1661691914,23417,19248,4169,848,322,https://www.intensivregister.de/api/public/reporting/laendertabelle
1661699115,23417,19248,4169,849,322,https://www.intensivregister.de/api/public/reporting/laendertabelle
1661709914,23417,19247,4170,849,322,https://www.intensivregister.de/api/public/reporting/laendertabelle
1661713513,23418,19251,4167,849,322,https://www.intensivregister.de/api/public/reporting/laendertabelle
1661720724,23432,19245,4187,845,320,https://www.intensivregister.de/api/public/reporting/laendertabelle
1661724313,23436,19246,4190,845,320,https://www.intensivregister.de/api/public/reporting/laendertabelle
1661727914,23436,19248,4188,845,320,https://www.intensivregister.de/api/public/reporting/laendertabelle
1661735114,23433,19250,4183,842,319,https://www.intensivregister.de/api/public/reporting/laendertabelle
1661738714,23446,19257,4189,840,318,https://www.intensivregister.de/api/public/reporting/laendertabelle
1661745914,23550,19301,4249,842,317,https://www.intensivregister.de/api/public/reporting/laendertabelle
1661749524,23622,19324,4298,854,311,https://www.intensivregister.de/api/public/reporting/laendertabelle
1661753114,23685,19378,4307,851,313,https://www.intensivregister.de/api/public/reporting/laendertabelle
1661756724,23701,19390,4311,851,313,https://www.intensivregister.de/api/public/reporting/laendertabelle
1661760314,23705,19378,4327,849,314,https://www.intensivregister.de/api/public/reporting/laendertabelle
1661767514,23760,19404,4356,850,315,https://www.intensivregister.de/api/public/reporting/laendertabelle
1661771115,23763,19410,4353,854,317,https://www.intensivregister.de/api/public/reporting/laendertabelle
1661778324,23760,19413,4347,854,317,https://www.intensivregister.de/api/public/reporting/laendertabelle
1661781925,23760,19414,4346,854,317,https://www.intensivregister.de/api/public/reporting/laendertabelle
1661789115,23762,19411,4351,854,317,https://www.intensivregister.de/api/public/reporting/laendertabelle
1661807114,23764,19429,4335,853,317,https://www.intensivregister.de/api/public/reporting/laendertabelle
1661810714,23767,19428,4339,853,317,https://www.intensivregister.de/api/public/reporting/laendertabelle
1661817925,23762,19426,4336,851,318,https://www.intensivregister.de/api/public/reporting/laendertabelle
1661821524,23756,19429,4327,849,318,https://www.intensivregister.de/api/public/reporting/laendertabelle
1661825124,23757,19434,4323,850,318,https://www.intensivregister.de/api/public/reporting/laendertabelle
1661828715,23764,19462,4302,849,317,https://www.intensivregister.de/api/public/reporting/laendertabelle
1661832315,23784,19581,4203,842,311,https://www.intensivregister.de/api/public/reporting/laendertabelle
1661839517,23848,19717,4131,824,302,https://www.intensivregister.de/api/public/reporting/laendertabelle
1661846716,23846,19764,4082,826,306,https://www.intensivregister.de/api/public/reporting/laendertabelle
1661853915,23842,19749,4093,824,306,https://www.intensivregister.de/api/public/reporting/laendertabelle
1661861114,23840,19761,4079,827,306,https://www.intensivregister.de/api/public/reporting/laendertabelle
1661864714,23840,19759,4081,825,306,https://www.intensivregister.de/api/public/reporting/laendertabelle
1661868315,23840,19761,4079,825,306,https://www.intensivregister.de/api/public/reporting/laendertabelle
1661871914,23840,19763,4077,826,306,https://www.intensivregister.de/api/public/reporting/laendertabelle
1661886315,23840,19762,4078,826,306,https://www.intensivregister.de/api/public/reporting/laendertabelle
1661889913,23840,19765,4075,826,306,https://www.intensivregister.de/api/public/reporting/laendertabelle
1661893514,23837,19764,4073,826,305,https://www.intensivregister.de/api/public/reporting/laendertabelle
1661897114,23838,19761,4077,826,305,https://www.intensivregister.de/api/public/reporting/laendertabelle
1661904324,23841,19766,4075,828,306,https://www.intensivregister.de/api/public/reporting/laendertabelle
1661907914,23841,19764,4077,828,306,https://www.intensivregister.de/api/public/reporting/laendertabelle
1661911514,23842,19765,4077,825,307,https://www.intensivregister.de/api/public/reporting/laendertabelle
1661918714,23856,19813,4043,830,307,https://www.intensivregister.de/api/public/reporting/laendertabelle
1661925923,23889,19928,3961,806,302,https://www.intensivregister.de/api/public/reporting/laendertabelle
1661929523,23888,19951,3937,806,299,https://www.intensivregister.de/api/public/reporting/laendertabelle
1661933124,23883,19948,3935,800,296,https://www.intensivregister.de/api/public/reporting/laendertabelle
1662001513,23863,19933,3930,778,288,https://www.intensivregister.de/api/public/reporting/laendertabelle
1662005124,23880,19903,3977,776,292,https://www.intensivregister.de/api/public/reporting/laendertabelle
1662008714,23847,19891,3956,765,281,https://www.intensivregister.de/api/public/reporting/laendertabelle
1662015915,23800,19890,3910,764,276,https://www.intensivregister.de/api/public/reporting/laendertabelle
1662019514,23804,19881,3923,765,277,https://www.intensivregister.de/api/public/reporting/laendertabelle
1662023123,23803,19883,3920,765,278,https://www.intensivregister.de/api/public/reporting/laendertabelle
1662026713,23826,19900,3926,764,277,https://www.intensivregister.de/api/public/reporting/laendertabelle
1662030313,23800,19881,3919,764,277,https://www.intensivregister.de/api/public/reporting/laendertabelle
1662033923,23799,19877,3922,765,277,https://www.intensivregister.de/api/public/reporting/laendertabelle
1662041114,23799,19875,3924,765,276,https://www.intensivregister.de/api/public/reporting/laendertabelle
1662044715,23799,19876,3923,765,276,https://www.intensivregister.de/api/public/reporting/laendertabelle
1662059113,23799,19874,3925,765,276,https://www.intensivregister.de/api/public/reporting/laendertabelle
1662066323,23799,19872,3927,766,276,https://www.intensivregister.de/api/public/reporting/laendertabelle
1662069914,23799,19874,3925,767,276,https://www.intensivregister.de/api/public/reporting/laendertabelle
1662073513,23799,19873,3926,767,276,https://www.intensivregister.de/api/public/reporting/laendertabelle
1662077123,23797,19867,3930,767,276,https://www.intensivregister.de/api/public/reporting/laendertabelle
1662084323,23797,19867,3930,766,276,https://www.intensivregister.de/api/public/reporting/laendertabelle
1662087913,23793,19899,3894,771,272,https://www.intensivregister.de/api/public/reporting/laendertabelle
1662091513,23764,19886,3878,772,271,https://www.intensivregister.de/api/public/reporting/laendertabelle
1662095114,23787,19909,3878,770,272,https://www.intensivregister.de/api/public/reporting/laendertabelle
1662098723,23765,19877,3888,772,273,https://www.intensivregister.de/api/public/reporting/laendertabelle
1662105923,23744,19829,3915,767,273,https://www.intensivregister.de/api/public/reporting/laendertabelle
1662109523,23740,19832,3908,768,273,https://www.intensivregister.de/api/public/reporting/laendertabelle
1662113124,23742,19821,3921,766,273,https://www.intensivregister.de/api/public/reporting/laendertabelle
1662116713,23742,19812,3930,766,273,https://www.intensivregister.de/api/public/reporting/laendertabelle
1662120314,23739,19810,3929,765,273,https://www.intensivregister.de/api/public/reporting/laendertabelle
1662123923,23738,19808,3930,767,273,https://www.intensivregister.de/api/public/reporting/laendertabelle
1662127524,23738,19807,3931,767,273,https://www.intensivregister.de/api/public/reporting/laendertabelle
1662152724,23730,19788,3942,769,273,https://www.intensivregister.de/api/public/reporting/laendertabelle
1662156323,23731,19784,3947,769,273,https://www.intensivregister.de/api/public/reporting/laendertabelle
1662159924,23714,19752,3962,768,273,https://www.intensivregister.de/api/public/reporting/laendertabelle
1662163523,23713,19756,3957,768,273,https://www.intensivregister.de/api/public/reporting/laendertabelle
1662167123,23713,19759,3954,769,273,https://www.intensivregister.de/api/public/reporting/laendertabelle
1662174323,23711,19740,3971,768,276,https://www.intensivregister.de/api/public/reporting/laendertabelle
1662181523,23621,19655,3966,749,277,https://www.intensivregister.de/api/public/reporting/laendertabelle
1662188724,23545,19555,3990,749,273,https://www.intensivregister.de/api/public/reporting/laendertabelle
1662192314,23527,19497,4030,750,272,https://www.intensivregister.de/api/public/reporting/laendertabelle
1662199513,23518,19488,4030,749,271,https://www.intensivregister.de/api/public/reporting/laendertabelle
1662203124,23515,19484,4031,751,273,https://www.intensivregister.de/api/public/reporting/laendertabelle
1662210327,23517,19485,4032,752,273,https://www.intensivregister.de/api/public/reporting/laendertabelle
1662213923,23517,19486,4031,752,273,https://www.intensivregister.de/api/public/reporting/laendertabelle
1662217513,23517,19480,4037,753,273,https://www.intensivregister.de/api/public/reporting/laendertabelle
1662221113,23517,19476,4041,753,273,https://www.intensivregister.de/api/public/reporting/laendertabelle
1662228314,23515,19472,4043,753,273,https://www.intensivregister.de/api/public/reporting/laendertabelle
1662231914,23514,19471,4043,753,273,https://www.intensivregister.de/api/public/reporting/laendertabelle
1662235524,23514,19472,4042,753,273,https://www.intensivregister.de/api/public/reporting/laendertabelle
1662242713,23518,19471,4047,755,274,https://www.intensivregister.de/api/public/reporting/laendertabelle
1662249913,23515,19472,4043,755,274,https://www.intensivregister.de/api/public/reporting/laendertabelle
1662253514,23514,19468,4046,755,274,https://www.intensivregister.de/api/public/reporting/laendertabelle
1662257113,23514,19466,4048,755,274,https://www.intensivregister.de/api/public/reporting/laendertabelle
1662260715,23513,19452,4061,756,275,https://www.intensivregister.de/api/public/reporting/laendertabelle
1662267914,23472,19244,4228,742,277,https://www.intensivregister.de/api/public/reporting/laendertabelle
1662271514,23468,19241,4227,746,283,https://www.intensivregister.de/api/public/reporting/laendertabelle
1662275114,23460,19182,4278,743,280,https://www.intensivregister.de/api/public/reporting/laendertabelle
1662278713,23451,19197,4254,746,283,https://www.intensivregister.de/api/public/reporting/laendertabelle
1662282324,23451,19191,4260,745,283,https://www.intensivregister.de/api/public/reporting/laendertabelle
1662285913,23448,19182,4266,743,283,https://www.intensivregister.de/api/public/reporting/laendertabelle
1662289523,23445,19183,4262,743,283,https://www.intensivregister.de/api/public/reporting/laendertabelle
1662296714,23445,19186,4259,743,283,https://www.intensivregister.de/api/public/reporting/laendertabelle
1662300313,23445,19186,4259,744,283,https://www.intensivregister.de/api/public/reporting/laendertabelle
1662303913,23445,19185,4260,744,283,https://www.intensivregister.de/api/public/reporting/laendertabelle
1662307514,23446,19191,4255,743,283,https://www.intensivregister.de/api/public/reporting/laendertabelle
1662318323,23446,19190,4256,743,283,https://www.intensivregister.de/api/public/reporting/laendertabelle
1662321923,23446,19191,4255,743,283,https://www.intensivregister.de/api/public/reporting/laendertabelle
1662325513,23447,19200,4247,742,282,https://www.intensivregister.de/api/public/reporting/laendertabelle
1662332723,23447,19201,4246,742,282,https://www.intensivregister.de/api/public/reporting/laendertabelle
1662336313,23456,19201,4255,742,282,https://www.intensivregister.de/api/public/reporting/laendertabelle
1662339923,23454,19202,4252,742,282,https://www.intensivregister.de/api/public/reporting/laendertabelle
1662343513,23459,19196,4263,741,281,https://www.intensivregister.de/api/public/reporting/laendertabelle
1662347124,23472,19228,4244,745,276,https://www.intensivregister.de/api/public/reporting/laendertabelle
1662350713,23538,19286,4252,753,278,https://www.intensivregister.de/api/public/reporting/laendertabelle
1662354314,23596,19348,4248,764,282,https://www.intensivregister.de/api/public/reporting/laendertabelle
1662357914,23634,19370,4264,764,275,https://www.intensivregister.de/api/public/reporting/laendertabelle
1662365113,23678,19405,4273,762,275,https://www.intensivregister.de/api/public/reporting/laendertabelle
1662368724,23695,19429,4266,765,275,https://www.intensivregister.de/api/public/reporting/laendertabelle
1662372324,23695,19431,4264,765,275,https://www.intensivregister.de/api/public/reporting/laendertabelle
1662379513,23701,19428,4273,764,275,https://www.intensivregister.de/api/public/reporting/laendertabelle
1662383113,23701,19429,4272,764,275,https://www.intensivregister.de/api/public/reporting/laendertabelle
1662386714,23701,19427,4274,764,275,https://www.intensivregister.de/api/public/reporting/laendertabelle
1662397514,23701,19428,4273,764,275,https://www.intensivregister.de/api/public/reporting/laendertabelle
1662408323,23701,19427,4274,764,275,https://www.intensivregister.de/api/public/reporting/laendertabelle
1662411913,23700,19419,4281,763,275,https://www.intensivregister.de/api/public/reporting/laendertabelle
1662415513,23702,19424,4278,764,275,https://www.intensivregister.de/api/public/reporting/laendertabelle
1662422723,23702,19425,4277,766,276,https://www.intensivregister.de/api/public/reporting/laendertabelle
1662426313,23703,19424,4279,765,277,https://www.intensivregister.de/api/public/reporting/laendertabelle
1662433513,23761,19497,4264,761,273,https://www.intensivregister.de/api/public/reporting/laendertabelle
1662437114,23787,19589,4198,755,273,https://www.intensivregister.de/api/public/reporting/laendertabelle
1662440714,23816,19700,4116,754,278,https://www.intensivregister.de/api/public/reporting/laendertabelle
1662447913,23856,19806,4050,743,275,https://www.intensivregister.de/api/public/reporting/laendertabelle
1662451523,23862,19806,4056,742,278,https://www.intensivregister.de/api/public/reporting/laendertabelle
1662455114,23896,19825,4071,742,278,https://www.intensivregister.de/api/public/reporting/laendertabelle
1662462314,23896,19822,4074,743,278,https://www.intensivregister.de/api/public/reporting/laendertabelle
1662465913,23894,19821,4073,744,279,https://www.intensivregister.de/api/public/reporting/laendertabelle
1662473114,23894,19822,4072,744,279,https://www.intensivregister.de/api/public/reporting/laendertabelle
1662494723,23894,19819,4075,744,279,https://www.intensivregister.de/api/public/reporting/laendertabelle
1662498314,23899,19822,4077,745,279,https://www.intensivregister.de/api/public/reporting/laendertabelle
1662501914,23900,19822,4078,745,279,https://www.intensivregister.de/api/public/reporting/laendertabelle
1662505513,23900,19817,4083,745,279,https://www.intensivregister.de/api/public/reporting/laendertabelle
1662512714,23897,19813,4084,746,279,https://www.intensivregister.de/api/public/reporting/laendertabelle
1662516323,23895,19813,4082,748,279,https://www.intensivregister.de/api/public/reporting/laendertabelle
1662523524,23863,19862,4001,760,277,https://www.intensivregister.de/api/public/reporting/laendertabelle
1662527115,23871,19895,3976,740,274,https://www.intensivregister.de/api/public/reporting/laendertabelle
1662530716,23885,19921,3964,726,267,https://www.intensivregister.de/api/public/reporting/laendertabelle
1662537923,23883,19958,3925,724,270,https://www.intensivregister.de/api/public/reporting/laendertabelle
1662541524,23877,19957,3920,719,269,https://www.intensivregister.de/api/public/reporting/laendertabelle
1662545124,23880,19951,3929,719,269,https://www.intensivregister.de/api/public/reporting/laendertabelle
1662548713,23879,19948,3931,719,269,https://www.intensivregister.de/api/public/reporting/laendertabelle
1662552313,23878,19943,3935,720,269,https://www.intensivregister.de/api/public/reporting/laendertabelle
1662555913,23881,19947,3934,719,269,https://www.intensivregister.de/api/public/reporting/laendertabelle
1662566714,23882,19952,3930,718,268,https://www.intensivregister.de/api/public/reporting/laendertabelle
1662581114,23882,19954,3928,718,268,https://www.intensivregister.de/api/public/reporting/laendertabelle
1662584713,23884,19949,3935,717,270,https://www.intensivregister.de/api/public/reporting/laendertabelle
1662588313,23884,19950,3934,717,270,https://www.intensivregister.de/api/public/reporting/laendertabelle
1662591923,23884,19952,3932,716,269,https://www.intensivregister.de/api/public/reporting/laendertabelle
1662599124,23885,19953,3932,715,269,https://www.intensivregister.de/api/public/reporting/laendertabelle
1662606324,23879,19973,3906,712,271,https://www.intensivregister.de/api/public/reporting/laendertabelle
1662609914,23878,19997,3881,722,267,https://www.intensivregister.de/api/public/reporting/laendertabelle
1662617114,23906,19990,3916,724,272,https://www.intensivregister.de/api/public/reporting/laendertabelle
1662620724,23892,19955,3937,723,271,https://www.intensivregister.de/api/public/reporting/laendertabelle
1662624324,23886,19955,3931,725,272,https://www.intensivregister.de/api/public/reporting/laendertabelle
1662627914,23885,19931,3954,727,271,https://www.intensivregister.de/api/public/reporting/laendertabelle
1662631514,23861,19909,3952,727,270,https://www.intensivregister.de/api/public/reporting/laendertabelle
1662638714,23861,19913,3948,727,270,https://www.intensivregister.de/api/public/reporting/laendertabelle
1662642315,23863,19912,3951,726,270,https://www.intensivregister.de/api/public/reporting/laendertabelle
1662645916,23863,19915,3948,726,270,https://www.intensivregister.de/api/public/reporting/laendertabelle
1662649515,23863,19916,3947,726,270,https://www.intensivregister.de/api/public/reporting/laendertabelle
1662656715,23863,19915,3948,726,270,https://www.intensivregister.de/api/public/reporting/laendertabelle
1662663924,23864,19916,3948,725,269,https://www.intensivregister.de/api/public/reporting/laendertabelle
1662667524,23866,19918,3948,725,269,https://www.intensivregister.de/api/public/reporting/laendertabelle
1662671114,23861,19922,3939,725,269,https://www.intensivregister.de/api/public/reporting/laendertabelle
1662674715,23864,19926,3938,726,269,https://www.intensivregister.de/api/public/reporting/laendertabelle
1662678315,23864,19925,3939,725,269,https://www.intensivregister.de/api/public/reporting/laendertabelle
1662681914,23864,19927,3937,725,269,https://www.intensivregister.de/api/public/reporting/laendertabelle
1662685514,23864,19932,3932,725,269,https://www.intensivregister.de/api/public/reporting/laendertabelle
1662689124,23862,19939,3923,724,268,https://www.intensivregister.de/api/public/reporting/laendertabelle
1662692724,23855,19920,3935,714,267,https://www.intensivregister.de/api/public/reporting/laendertabelle
1662696315,23800,19856,3944,716,264,https://www.intensivregister.de/api/public/reporting/laendertabelle
1662699915,23804,19835,3969,702,261,https://www.intensivregister.de/api/public/reporting/laendertabelle
1662703514,23762,19857,3905,696,254,https://www.intensivregister.de/api/public/reporting/laendertabelle
1662707116,23777,19883,3894,708,252,https://www.intensivregister.de/api/public/reporting/laendertabelle
1662710714,23778,19874,3904,713,253,https://www.intensivregister.de/api/public/reporting/laendertabelle
1662714315,23775,19866,3909,715,253,https://www.intensivregister.de/api/public/reporting/laendertabelle
1662717915,23774,19877,3897,715,253,https://www.intensivregister.de/api/public/reporting/laendertabelle
1662721514,23774,19865,3909,714,253,https://www.intensivregister.de/api/public/reporting/laendertabelle
1662725115,23774,19865,3909,715,255,https://www.intensivregister.de/api/public/reporting/laendertabelle
1662728716,23767,19857,3910,715,255,https://www.intensivregister.de/api/public/reporting/laendertabelle
1662732314,23767,19858,3909,715,255,https://www.intensivregister.de/api/public/reporting/laendertabelle
1662735925,23776,19864,3912,716,256,https://www.intensivregister.de/api/public/reporting/laendertabelle
1662743114,23776,19859,3917,715,256,https://www.intensivregister.de/api/public/reporting/laendertabelle
1662753924,23776,19862,3914,715,256,https://www.intensivregister.de/api/public/reporting/laendertabelle
1662757514,23773,19849,3924,716,257,https://www.intensivregister.de/api/public/reporting/laendertabelle
1662761114,23772,19845,3927,716,256,https://www.intensivregister.de/api/public/reporting/laendertabelle
1662764714,23771,19847,3924,717,256,https://www.intensivregister.de/api/public/reporting/laendertabelle
1662768314,23768,19842,3926,717,256,https://www.intensivregister.de/api/public/reporting/laendertabelle
1662771924,23768,19835,3933,717,256,https://www.intensivregister.de/api/public/reporting/laendertabelle
1662775524,23767,19834,3933,717,255,https://www.intensivregister.de/api/public/reporting/laendertabelle
1662779124,23761,19816,3945,712,254,https://www.intensivregister.de/api/public/reporting/laendertabelle
1662782714,23730,19738,3992,702,252,https://www.intensivregister.de/api/public/reporting/laendertabelle
1662786314,23659,19693,3966,691,247,https://www.intensivregister.de/api/public/reporting/laendertabelle
1662789924,23602,19582,4020,694,249,https://www.intensivregister.de/api/public/reporting/laendertabelle
1662793525,23584,19540,4044,680,247,https://www.intensivregister.de/api/public/reporting/laendertabelle
1662797114,23559,19509,4050,678,246,https://www.intensivregister.de/api/public/reporting/laendertabelle
1662800715,23559,19489,4070,678,246,https://www.intensivregister.de/api/public/reporting/laendertabelle
1662804315,23548,19475,4073,678,246,https://www.intensivregister.de/api/public/reporting/laendertabelle
1662807914,23548,19478,4070,677,246,https://www.intensivregister.de/api/public/reporting/laendertabelle
1662811525,23544,19478,4066,678,246,https://www.intensivregister.de/api/public/reporting/laendertabelle
1662815114,23544,19477,4067,678,246,https://www.intensivregister.de/api/public/reporting/laendertabelle
1662818724,23544,19479,4065,678,246,https://www.intensivregister.de/api/public/reporting/laendertabelle
1662822324,23544,19480,4064,679,246,https://www.intensivregister.de/api/public/reporting/laendertabelle
1662825914,23544,19478,4066,679,246,https://www.intensivregister.de/api/public/reporting/laendertabelle
1662829514,23544,19480,4064,679,246,https://www.intensivregister.de/api/public/reporting/laendertabelle
1662833124,23544,19481,4063,679,246,https://www.intensivregister.de/api/public/reporting/laendertabelle
1662840324,23542,19481,4061,678,246,https://www.intensivregister.de/api/public/reporting/laendertabelle
1662843915,23542,19477,4065,679,247,https://www.intensivregister.de/api/public/reporting/laendertabelle
1662847515,23541,19476,4065,681,247,https://www.intensivregister.de/api/public/reporting/laendertabelle
1662851115,23542,19471,4071,681,247,https://www.intensivregister.de/api/public/reporting/laendertabelle
1662854714,23543,19468,4075,681,247,https://www.intensivregister.de/api/public/reporting/laendertabelle
1662858314,23543,19465,4078,681,247,https://www.intensivregister.de/api/public/reporting/laendertabelle
1662861914,23541,19461,4080,681,247,https://www.intensivregister.de/api/public/reporting/laendertabelle
1662865524,23528,19441,4087,681,247,https://www.intensivregister.de/api/public/reporting/laendertabelle
1662869124,23521,19394,4127,676,248,https://www.intensivregister.de/api/public/reporting/laendertabelle
1662872715,23516,19347,4169,675,242,https://www.intensivregister.de/api/public/reporting/laendertabelle
1662876314,23491,19316,4175,672,244,https://www.intensivregister.de/api/public/reporting/laendertabelle
1662879915,23479,19274,4205,674,241,https://www.intensivregister.de/api/public/reporting/laendertabelle
1662883515,23475,19258,4217,673,243,https://www.intensivregister.de/api/public/reporting/laendertabelle
1662887124,23475,19246,4229,671,243,https://www.intensivregister.de/api/public/reporting/laendertabelle
1662890714,23475,19242,4233,673,244,https://www.intensivregister.de/api/public/reporting/laendertabelle
1662894314,23479,19243,4236,671,244,https://www.intensivregister.de/api/public/reporting/laendertabelle
1662901514,23480,19245,4235,672,245,https://www.intensivregister.de/api/public/reporting/laendertabelle
1662905115,23480,19243,4237,672,245,https://www.intensivregister.de/api/public/reporting/laendertabelle
1662908714,23480,19244,4236,672,245,https://www.intensivregister.de/api/public/reporting/laendertabelle
1662912314,23480,19243,4237,672,245,https://www.intensivregister.de/api/public/reporting/laendertabelle
1662915924,23480,19242,4238,672,245,https://www.intensivregister.de/api/public/reporting/laendertabelle
1662926715,23479,19244,4235,673,245,https://www.intensivregister.de/api/public/reporting/laendertabelle
1662930315,23481,19240,4241,672,245,https://www.intensivregister.de/api/public/reporting/laendertabelle
1662933924,23481,19243,4238,672,245,https://www.intensivregister.de/api/public/reporting/laendertabelle
1662937514,23480,19243,4237,672,245,https://www.intensivregister.de/api/public/reporting/laendertabelle
1662941125,23480,19238,4242,672,245,https://www.intensivregister.de/api/public/reporting/laendertabelle
1662944715,23481,19245,4236,673,245,https://www.intensivregister.de/api/public/reporting/laendertabelle
1662948315,23493,19268,4225,673,245,https://www.intensivregister.de/api/public/reporting/laendertabelle
1662951914,23507,19286,4221,672,249,https://www.intensivregister.de/api/public/reporting/laendertabelle
1662955515,23570,19309,4261,684,248,https://www.intensivregister.de/api/public/reporting/laendertabelle
1662959114,23666,19399,4267,692,250,https://www.intensivregister.de/api/public/reporting/laendertabelle
1662962715,23724,19445,4279,690,250,https://www.intensivregister.de/api/public/reporting/laendertabelle
1662966314,23745,19474,4271,690,252,https://www.intensivregister.de/api/public/reporting/laendertabelle
1662969915,23784,19475,4309,690,252,https://www.intensivregister.de/api/public/reporting/laendertabelle
1662973524,23792,19489,4303,693,253,https://www.intensivregister.de/api/public/reporting/laendertabelle
1662977124,23793,19497,4296,693,253,https://www.intensivregister.de/api/public/reporting/laendertabelle
1662980714,23795,19500,4295,691,251,https://www.intensivregister.de/api/public/reporting/laendertabelle
1662984314,23795,19503,4292,691,251,https://www.intensivregister.de/api/public/reporting/laendertabelle
1662987915,23795,19504,4291,691,251,https://www.intensivregister.de/api/public/reporting/laendertabelle
1662991514,23795,19505,4290,691,251,https://www.intensivregister.de/api/public/reporting/laendertabelle
1662998715,23795,19506,4289,691,251,https://www.intensivregister.de/api/public/reporting/laendertabelle
1663009515,23795,19509,4286,691,251,https://www.intensivregister.de/api/public/reporting/laendertabelle
1663016714,23797,19510,4287,689,251,https://www.intensivregister.de/api/public/reporting/laendertabelle
1663020324,23796,19505,4291,688,251,https://www.intensivregister.de/api/public/reporting/laendertabelle
1663023924,23798,19507,4291,688,251,https://www.intensivregister.de/api/public/reporting/laendertabelle
1663027514,23798,19512,4286,689,252,https://www.intensivregister.de/api/public/reporting/laendertabelle
1663031124,23798,19518,4280,688,252,https://www.intensivregister.de/api/public/reporting/laendertabelle
1663034714,23794,19522,4272,689,252,https://www.intensivregister.de/api/public/reporting/laendertabelle
1663038315,23812,19617,4195,689,248,https://www.intensivregister.de/api/public/reporting/laendertabelle
1663041914,23783,19637,4146,689,246,https://www.intensivregister.de/api/public/reporting/laendertabelle
1663045524,23822,19730,4092,703,243,https://www.intensivregister.de/api/public/reporting/laendertabelle
1663049115,23875,19793,4082,713,245,https://www.intensivregister.de/api/public/reporting/laendertabelle
1663052714,23898,19848,4050,724,247,https://www.intensivregister.de/api/public/reporting/laendertabelle
1663056324,23898,19838,4060,728,249,https://www.intensivregister.de/api/public/reporting/laendertabelle
1663059914,23902,19842,4060,726,249,https://www.intensivregister.de/api/public/reporting/laendertabelle
1663063514,23901,19844,4057,727,248,https://www.intensivregister.de/api/public/reporting/laendertabelle
1663067115,23902,19846,4056,726,246,https://www.intensivregister.de/api/public/reporting/laendertabelle
1663070715,23907,19853,4054,725,246,https://www.intensivregister.de/api/public/reporting/laendertabelle
1663074314,23910,19852,4058,725,246,https://www.intensivregister.de/api/public/reporting/laendertabelle
1663077925,23911,19854,4057,724,245,https://www.intensivregister.de/api/public/reporting/laendertabelle
1663085114,23911,19852,4059,724,245,https://www.intensivregister.de/api/public/reporting/laendertabelle
1663088714,23911,19858,4053,724,245,https://www.intensivregister.de/api/public/reporting/laendertabelle
1663099515,23915,19862,4053,724,245,https://www.intensivregister.de/api/public/reporting/laendertabelle
1663103114,23915,19863,4052,724,245,https://www.intensivregister.de/api/public/reporting/laendertabelle
1663106714,23916,19870,4046,725,245,https://www.intensivregister.de/api/public/reporting/laendertabelle
1663110324,23917,19867,4050,725,244,https://www.intensivregister.de/api/public/reporting/laendertabelle
1663113915,23914,19868,4046,726,244,https://www.intensivregister.de/api/public/reporting/laendertabelle
1663121114,23910,19879,4031,727,246,https://www.intensivregister.de/api/public/reporting/laendertabelle
1663124724,23927,19892,4035,734,247,https://www.intensivregister.de/api/public/reporting/laendertabelle
1663128315,23972,19928,4044,729,251,https://www.intensivregister.de/api/public/reporting/laendertabelle
1663131914,23986,19967,4019,744,257,https://www.intensivregister.de/api/public/reporting/laendertabelle
1663135514,23981,20053,3928,747,259,https://www.intensivregister.de/api/public/reporting/laendertabelle
1663139114,24003,20059,3944,747,258,https://www.intensivregister.de/api/public/reporting/laendertabelle
1663142714,24002,20063,3939,739,256,https://www.intensivregister.de/api/public/reporting/laendertabelle
1663146315,24008,20070,3938,739,257,https://www.intensivregister.de/api/public/reporting/laendertabelle
1663149915,24007,20068,3939,735,255,https://www.intensivregister.de/api/public/reporting/laendertabelle
1663153514,24009,20067,3942,734,255,https://www.intensivregister.de/api/public/reporting/laendertabelle
1663157115,24009,20066,3943,734,255,https://www.intensivregister.de/api/public/reporting/laendertabelle
1663167914,24008,20064,3944,734,255,https://www.intensivregister.de/api/public/reporting/laendertabelle
1663171525,24008,20063,3945,734,255,https://www.intensivregister.de/api/public/reporting/laendertabelle
1663182314,24008,20066,3942,734,255,https://www.intensivregister.de/api/public/reporting/laendertabelle
1663185915,24008,20062,3946,735,255,https://www.intensivregister.de/api/public/reporting/laendertabelle
1663189515,24010,20052,3958,735,255,https://www.intensivregister.de/api/public/reporting/laendertabelle
1663193114,24010,20051,3959,735,255,https://www.intensivregister.de/api/public/reporting/laendertabelle
1663196715,24012,20047,3965,735,255,https://www.intensivregister.de/api/public/reporting/laendertabelle
1663200315,24011,20044,3967,736,254,https://www.intensivregister.de/api/public/reporting/laendertabelle
1663203914,24011,20038,3973,736,254,https://www.intensivregister.de/api/public/reporting/laendertabelle
1663207514,24012,20067,3945,738,255,https://www.intensivregister.de/api/public/reporting/laendertabelle
1663211115,24015,20055,3960,730,253,https://www.intensivregister.de/api/public/reporting/laendertabelle
1663214715,24007,20043,3964,713,252,https://www.intensivregister.de/api/public/reporting/laendertabelle
1663218316,23999,20077,3922,722,258,https://www.intensivregister.de/api/public/reporting/laendertabelle
1663221915,23966,20092,3874,726,262,https://www.intensivregister.de/api/public/reporting/laendertabelle
1663225524,23960,20124,3836,725,262,https://www.intensivregister.de/api/public/reporting/laendertabelle
1663229124,23934,20101,3833,719,262,https://www.intensivregister.de/api/public/reporting/laendertabelle
1663232715,23935,20098,3837,719,262,https://www.intensivregister.de/api/public/reporting/laendertabelle
1663236316,23954,20112,3842,723,263,https://www.intensivregister.de/api/public/reporting/laendertabelle
1663239915,23952,20110,3842,723,263,https://www.intensivregister.de/api/public/reporting/laendertabelle
1663243525,23952,20110,3842,724,263,https://www.intensivregister.de/api/public/reporting/laendertabelle
1663247116,23947,20105,3842,724,263,https://www.intensivregister.de/api/public/reporting/laendertabelle
1663250716,23948,20102,3846,724,263,https://www.intensivregister.de/api/public/reporting/laendertabelle
1663254315,23948,20103,3845,724,263,https://www.intensivregister.de/api/public/reporting/laendertabelle
1663261514,23949,20104,3845,725,263,https://www.intensivregister.de/api/public/reporting/laendertabelle
1663272315,23950,20107,3843,725,263,https://www.intensivregister.de/api/public/reporting/laendertabelle
1663275915,23948,20104,3844,728,263,https://www.intensivregister.de/api/public/reporting/laendertabelle
1663279515,23948,20103,3845,727,263,https://www.intensivregister.de/api/public/reporting/laendertabelle
1663283114,23948,20101,3847,727,263,https://www.intensivregister.de/api/public/reporting/laendertabelle
1663286724,23948,20097,3851,727,263,https://www.intensivregister.de/api/public/reporting/laendertabelle
1663290314,23946,20092,3854,726,263,https://www.intensivregister.de/api/public/reporting/laendertabelle
1663293914,23940,20105,3835,724,263,https://www.intensivregister.de/api/public/reporting/laendertabelle
1663297514,23928,20085,3843,725,265,https://www.intensivregister.de/api/public/reporting/laendertabelle
1663301114,23918,20130,3788,720,255,https://www.intensivregister.de/api/public/reporting/laendertabelle
1663304715,23890,20059,3831,698,253,https://www.intensivregister.de/api/public/reporting/laendertabelle
1663308315,23898,20013,3885,707,251,https://www.intensivregister.de/api/public/reporting/laendertabelle
1663311915,23867,20003,3864,696,242,https://www.intensivregister.de/api/public/reporting/laendertabelle
1663315525,23872,20016,3856,690,239,https://www.intensivregister.de/api/public/reporting/laendertabelle
1663319125,23873,20023,3850,690,238,https://www.intensivregister.de/api/public/reporting/laendertabelle
1663322714,23874,20014,3860,689,238,https://www.intensivregister.de/api/public/reporting/laendertabelle
1663326314,23874,20011,3863,691,238,https://www.intensivregister.de/api/public/reporting/laendertabelle
1663329914,23874,20009,3865,691,238,https://www.intensivregister.de/api/public/reporting/laendertabelle
1663333515,23871,20010,3861,691,238,https://www.intensivregister.de/api/public/reporting/laendertabelle
1663340715,23871,20008,3863,691,238,https://www.intensivregister.de/api/public/reporting/laendertabelle
1663344326,23871,20009,3862,690,238,https://www.intensivregister.de/api/public/reporting/laendertabelle
1663358724,23871,20007,3864,690,238,https://www.intensivregister.de/api/public/reporting/laendertabelle
1663362316,23867,20003,3864,689,238,https://www.intensivregister.de/api/public/reporting/laendertabelle
1663365914,23866,20005,3861,689,238,https://www.intensivregister.de/api/public/reporting/laendertabelle
1663369515,23864,20004,3860,689,238,https://www.intensivregister.de/api/public/reporting/laendertabelle
1663373125,23862,20002,3860,689,237,https://www.intensivregister.de/api/public/reporting/laendertabelle
1663376714,23862,20001,3861,688,236,https://www.intensivregister.de/api/public/reporting/laendertabelle
1663380314,23861,20013,3848,688,236,https://www.intensivregister.de/api/public/reporting/laendertabelle
1663383915,23867,20001,3866,692,237,https://www.intensivregister.de/api/public/reporting/laendertabelle
1663387514,23823,19923,3900,688,238,https://www.intensivregister.de/api/public/reporting/laendertabelle
1663391117,23771,19817,3954,676,236,https://www.intensivregister.de/api/public/reporting/laendertabelle
1663394716,23714,19731,3983,659,234,https://www.intensivregister.de/api/public/reporting/laendertabelle
1663398325,23672,19689,3983,659,237,https://www.intensivregister.de/api/public/reporting/laendertabelle
1663401915,23656,19662,3994,659,236,https://www.intensivregister.de/api/public/reporting/laendertabelle
1663405514,23653,19653,4000,661,235,https://www.intensivregister.de/api/public/reporting/laendertabelle
1663409114,23645,19649,3996,661,235,https://www.intensivregister.de/api/public/reporting/laendertabelle
1663412716,23644,19641,4003,662,235,https://www.intensivregister.de/api/public/reporting/laendertabelle
1663416314,23644,19639,4005,662,235,https://www.intensivregister.de/api/public/reporting/laendertabelle
1663419915,23644,19638,4006,662,235,https://www.intensivregister.de/api/public/reporting/laendertabelle
1663423515,23644,19637,4007,662,235,https://www.intensivregister.de/api/public/reporting/laendertabelle
1663427125,23644,19632,4012,662,235,https://www.intensivregister.de/api/public/reporting/laendertabelle
1663430714,23644,19631,4013,661,235,https://www.intensivregister.de/api/public/reporting/laendertabelle
1663441515,23644,19631,4013,660,235,https://www.intensivregister.de/api/public/reporting/laendertabelle
1663445115,23644,19630,4014,660,235,https://www.intensivregister.de/api/public/reporting/laendertabelle
1663448725,23642,19635,4007,660,235,https://www.intensivregister.de/api/public/reporting/laendertabelle
1663452325,23642,19633,4009,660,234,https://www.intensivregister.de/api/public/reporting/laendertabelle
1663455925,23643,19625,4018,660,234,https://www.intensivregister.de/api/public/reporting/laendertabelle
1663459515,23645,19628,4017,661,234,https://www.intensivregister.de/api/public/reporting/laendertabelle
1663463124,23648,19633,4015,660,234,https://www.intensivregister.de/api/public/reporting/laendertabelle
1663466714,23648,19640,4008,662,234,https://www.intensivregister.de/api/public/reporting/laendertabelle
1663470316,23647,19625,4022,660,234,https://www.intensivregister.de/api/public/reporting/laendertabelle
1663473915,23624,19538,4086,651,231,https://www.intensivregister.de/api/public/reporting/laendertabelle
1663477514,23611,19428,4183,649,233,https://www.intensivregister.de/api/public/reporting/laendertabelle
1663481114,23594,19345,4249,651,230,https://www.intensivregister.de/api/public/reporting/laendertabelle
1663484724,23593,19317,4276,648,227,https://www.intensivregister.de/api/public/reporting/laendertabelle
1663488315,23601,19307,4294,647,231,https://www.intensivregister.de/api/public/reporting/laendertabelle
1663491925,23602,19303,4299,647,231,https://www.intensivregister.de/api/public/reporting/laendertabelle
1663495524,23601,19300,4301,647,231,https://www.intensivregister.de/api/public/reporting/laendertabelle
1663499114,23575,19276,4299,645,229,https://www.intensivregister.de/api/public/reporting/laendertabelle
1663502714,23576,19275,4301,645,228,https://www.intensivregister.de/api/public/reporting/laendertabelle
1663509914,23576,19274,4302,644,228,https://www.intensivregister.de/api/public/reporting/laendertabelle
1663513514,23576,19277,4299,644,228,https://www.intensivregister.de/api/public/reporting/laendertabelle
1663520724,23575,19281,4294,644,228,https://www.intensivregister.de/api/public/reporting/laendertabelle
1663527914,23575,19284,4291,644,228,https://www.intensivregister.de/api/public/reporting/laendertabelle
1663531514,23575,19278,4297,642,228,https://www.intensivregister.de/api/public/reporting/laendertabelle
1663535114,23575,19277,4298,643,228,https://www.intensivregister.de/api/public/reporting/laendertabelle
1663538715,23575,19278,4297,642,228,https://www.intensivregister.de/api/public/reporting/laendertabelle
1663542314,23572,19279,4293,644,228,https://www.intensivregister.de/api/public/reporting/laendertabelle
1663545914,23571,19278,4293,644,228,https://www.intensivregister.de/api/public/reporting/laendertabelle
1663549515,23576,19285,4291,645,229,https://www.intensivregister.de/api/public/reporting/laendertabelle
1663553114,23586,19306,4280,643,228,https://www.intensivregister.de/api/public/reporting/laendertabelle
1663556725,23593,19316,4277,646,227,https://www.intensivregister.de/api/public/reporting/laendertabelle
1663560326,23643,19352,4291,656,226,https://www.intensivregister.de/api/public/reporting/laendertabelle
1663563916,23705,19397,4308,660,232,https://www.intensivregister.de/api/public/reporting/laendertabelle
1663567516,23696,19422,4274,660,227,https://www.intensivregister.de/api/public/reporting/laendertabelle
1663571114,23790,19518,4272,664,228,https://www.intensivregister.de/api/public/reporting/laendertabelle
1663574714,23824,19516,4308,667,230,https://www.intensivregister.de/api/public/reporting/laendertabelle
1663578315,23830,19527,4303,665,230,https://www.intensivregister.de/api/public/reporting/laendertabelle
1663581914,23830,19540,4290,666,229,https://www.intensivregister.de/api/public/reporting/laendertabelle
1663589114,23830,19540,4290,668,229,https://www.intensivregister.de/api/public/reporting/laendertabelle
1663592716,23832,19543,4289,668,229,https://www.intensivregister.de/api/public/reporting/laendertabelle
1663596325,23832,19543,4289,669,229,https://www.intensivregister.de/api/public/reporting/laendertabelle
1663599915,23832,19541,4291,669,229,https://www.intensivregister.de/api/public/reporting/laendertabelle
1663603514,23832,19543,4289,669,229,https://www.intensivregister.de/api/public/reporting/laendertabelle
1663607125,23832,19544,4288,669,229,https://www.intensivregister.de/api/public/reporting/laendertabelle
