timestamp,gender,A00-A04,A05-A14,A15-A34,A35-A59,A60-A79,A80+,ALL
1583539200,A,0,0,0,0,1,0,1
1583539200,F,0,0,0,0,1,0,1
1583539200,M,0,0,0,0,0,0,0
1583798400,A,0,0,2,6,1,0,9
1583798400,F,0,0,0,2,1,0,3
1583798400,M,0,0,2,4,0,0,6
1583884800,A,0,0,0,1,0,0,1
1583884800,F,0,0,0,1,0,0,1
1583884800,M,0,0,0,0,0,0,0
1583971200,A,0,1,1,7,2,0,11
1583971200,F,0,1,1,2,1,0,5
1583971200,M,0,0,0,5,1,0,6
1584057600,A,0,0,4,3,3,0,10
1584057600,F,0,0,1,0,0,0,1
1584057600,M,0,0,3,3,3,0,9
1584144000,A,0,0,8,10,0,0,18
1584144000,F,0,0,6,0,0,0,6
1584144000,M,0,0,2,10,0,0,12
1584230400,A,0,0,0,1,0,0,1
1584230400,F,0,0,0,1,0,0,1
1584230400,M,0,0,0,0,0,0,0
1584316800,A,0,0,7,8,3,0,18
1584316800,F,0,0,2,6,2,0,10
1584316800,M,0,0,5,2,1,0,8
1584403200,A,0,2,9,16,4,0,31
1584403200,F,0,0,3,5,2,0,10
1584403200,M,0,2,6,11,2,0,21
1584489600,A,1,1,13,18,4,0,37
1584489600,F,1,0,5,6,2,0,14
1584489600,M,0,1,8,12,2,0,23
1584576000,A,0,0,16,32,4,2,54
1584576000,F,0,0,3,18,2,0,23
1584576000,M,0,0,13,14,2,2,31
1584662400,A,1,4,24,34,11,2,76
1584662400,F,0,2,10,14,6,1,33
1584662400,M,1,2,14,20,5,1,43
1584748800,A,1,0,9,18,6,4,38
1584748800,F,1,0,2,7,4,1,15
1584748800,M,0,0,7,11,2,3,23
1584835200,A,1,1,6,10,6,3,27
1584835200,F,0,0,3,6,2,0,11
1584835200,M,1,1,3,4,4,3,16
1584921600,A,1,1,13,27,9,1,52
1584921600,F,1,0,7,8,6,0,22
1584921600,M,0,1,6,19,3,1,30
1585008000,A,0,2,15,38,11,6,72
1585008000,F,0,1,9,23,2,2,37
1585008000,M,0,1,6,15,9,4,35
1585094400,A,1,1,22,33,13,9,79
1585094400,F,1,0,9,17,7,8,42
1585094400,M,0,1,13,16,6,1,37
1585180800,A,1,1,22,31,15,4,74
1585180800,F,0,1,13,17,9,3,43
1585180800,M,1,0,9,14,6,1,31
1585267200,A,0,0,11,32,18,12,73
1585267200,F,0,0,8,20,7,9,44
1585267200,M,0,0,3,12,11,3,29
1585353600,A,0,1,14,31,15,7,68
1585353600,F,0,0,5,16,9,4,34
1585353600,M,0,1,9,15,6,3,34
1585440000,A,0,0,5,9,5,1,20
1585440000,F,0,0,2,6,4,0,12
1585440000,M,0,0,3,3,1,1,8
1585526400,A,1,1,6,16,7,4,35
1585526400,F,0,1,4,9,6,3,23
1585526400,M,1,0,2,7,1,1,12
1585612800,A,1,0,7,43,23,5,79
1585612800,F,0,0,5,22,9,3,39
1585612800,M,1,0,2,21,14,2,40
1585699200,A,0,0,7,29,16,6,58
1585699200,F,0,0,4,18,6,3,31
1585699200,M,0,0,3,11,10,3,27
1585785600,A,1,3,10,44,20,7,85
1585785600,F,1,1,5,25,10,4,46
1585785600,M,0,2,5,19,10,3,39
1585872000,A,1,1,15,22,19,12,70
1585872000,F,0,1,10,10,10,8,39
1585872000,M,1,0,5,12,9,4,31
1585958400,A,0,3,5,20,18,4,50
1585958400,F,0,0,4,14,7,0,25
1585958400,M,0,3,1,6,11,4,25
1586044800,A,0,0,6,15,7,12,40
1586044800,F,0,0,3,14,1,5,23
1586044800,M,0,0,3,1,6,7,17
1586131200,A,0,0,5,10,10,1,26
1586131200,F,0,0,3,7,2,0,12
1586131200,M,0,0,2,3,8,1,14
1586217600,A,0,1,19,29,20,3,72
1586217600,F,0,1,10,16,8,1,36
1586217600,M,0,0,9,13,12,2,36
1586304000,A,0,1,13,36,9,5,64
1586304000,F,0,0,8,21,4,1,34
1586304000,M,0,1,5,15,5,4,30
1586390400,A,0,0,18,34,12,6,70
1586390400,F,0,0,10,17,7,4,38
1586390400,M,0,0,8,17,5,2,32
1586476800,A,1,0,4,9,7,5,26
1586476800,F,1,0,3,8,1,4,17
1586476800,M,0,0,1,1,6,1,9
1586563200,A,0,0,8,7,8,4,27
1586563200,F,0,0,4,5,2,4,15
1586563200,M,0,0,4,2,6,0,12
1586649600,A,0,0,5,13,6,8,32
1586649600,F,0,0,1,10,3,5,19
1586649600,M,0,0,4,3,3,3,13
1586736000,A,0,0,6,8,3,3,20
1586736000,F,0,0,5,6,2,1,14
1586736000,M,0,0,1,2,1,2,6
1586822400,A,0,0,10,10,13,11,44
1586822400,F,0,0,5,6,6,6,23
1586822400,M,0,0,5,4,7,5,21
1586908800,A,0,1,8,18,9,6,42
1586908800,F,0,1,5,9,3,4,22
1586908800,M,0,0,3,9,6,2,20
1586995200,A,0,2,24,29,13,12,80
1586995200,F,0,2,16,16,6,9,49
1586995200,M,0,0,8,13,7,3,31
1587081600,A,0,1,6,12,9,8,36
1587081600,F,0,1,5,5,4,8,23
1587081600,M,0,0,1,7,5,0,13
1587168000,A,0,3,9,16,8,11,47
1587168000,F,0,1,4,11,6,4,26
1587168000,M,0,2,5,5,2,7,21
1587254400,A,0,0,2,6,1,7,16
1587254400,F,0,0,2,4,0,6,12
1587254400,M,0,0,0,2,1,1,4
1587340800,A,0,1,5,7,16,9,38
1587340800,F,0,1,1,4,8,5,19
1587340800,M,0,0,4,3,8,4,19
1587427200,A,1,1,19,21,17,16,75
1587427200,F,1,0,10,15,13,12,51
1587427200,M,0,1,9,6,4,4,24
1587513600,A,0,0,6,26,17,7,56
1587513600,F,0,0,4,14,4,5,27
1587513600,M,0,0,2,12,13,2,29
1587600000,A,1,0,18,27,13,7,66
1587600000,F,1,0,8,18,4,4,35
1587600000,M,0,0,10,9,9,3,31
1587686400,A,0,1,11,18,8,8,46
1587686400,F,0,0,7,12,7,5,31
1587686400,M,0,1,4,6,1,3,15
1587772800,A,1,0,6,9,6,3,25
1587772800,F,1,0,3,5,1,3,13
1587772800,M,0,0,3,4,5,0,12
1587859200,A,0,0,2,10,4,5,21
1587859200,F,0,0,2,9,1,5,17
1587859200,M,0,0,0,1,3,0,4
1587945600,A,0,0,6,7,9,6,28
1587945600,F,0,0,2,5,3,4,14
1587945600,M,0,0,4,2,6,2,14
1588032000,A,0,1,8,25,16,27,77
1588032000,F,0,1,5,15,7,22,50
1588032000,M,0,0,3,10,9,5,27
1588118400,A,1,0,6,15,15,6,43
1588118400,F,0,0,3,6,10,5,24
1588118400,M,1,0,3,9,5,1,19
1588204800,A,0,0,10,23,14,13,60
1588204800,F,0,0,7,14,6,5,32
1588204800,M,0,0,3,9,8,8,28
1588291200,A,0,0,5,4,2,3,14
1588291200,F,0,0,1,3,0,2,6
1588291200,M,0,0,4,1,2,1,8
1588377600,A,0,0,4,7,5,5,21
1588377600,F,0,0,3,5,3,3,14
1588377600,M,0,0,1,2,2,2,7
1588464000,A,0,0,0,0,1,0,1
1588464000,F,0,0,0,0,0,0,0
1588464000,M,0,0,0,0,1,0,1
1588550400,A,0,1,4,8,6,11,30
1588550400,F,0,0,2,6,4,8,20
1588550400,M,0,1,2,2,2,3,10
1588636800,A,0,0,6,11,9,15,41
1588636800,F,0,0,3,8,6,12,29
1588636800,M,0,0,3,3,3,3,12
1588723200,A,0,0,12,11,10,12,45
1588723200,F,0,0,9,6,5,9,29
1588723200,M,0,0,3,5,5,3,16
1588809600,A,0,1,10,16,10,11,48
1588809600,F,0,0,7,8,5,5,25
1588809600,M,0,1,3,8,5,6,23
1588896000,A,0,0,6,11,6,3,26
1588896000,F,0,0,6,5,2,2,15
1588896000,M,0,0,0,6,4,1,11
1588982400,A,0,2,4,10,9,6,31
1588982400,F,0,2,0,4,4,5,15
1588982400,M,0,0,4,6,5,1,16
1589068800,A,0,0,2,2,3,1,8
1589068800,F,0,0,2,2,2,0,6
1589068800,M,0,0,0,0,1,1,2
1589155200,A,0,0,4,17,3,8,32
1589155200,F,0,0,2,8,1,7,18
1589155200,M,0,0,2,9,2,1,14
1589241600,A,0,1,6,12,4,5,28
1589241600,F,0,1,3,5,2,3,14
1589241600,M,0,0,3,7,2,2,14
1589328000,A,0,1,2,8,2,3,16
1589328000,F,0,1,0,7,1,2,11
1589328000,M,0,0,2,1,1,1,5
1589414400,A,0,0,4,13,5,3,25
1589414400,F,0,0,3,9,2,3,17
1589414400,M,0,0,1,4,3,0,8
1589500800,A,0,0,1,9,6,5,21
1589500800,F,0,0,1,5,3,2,11
1589500800,M,0,0,0,4,3,3,10
1589587200,A,0,3,3,7,6,5,24
1589587200,F,0,1,1,6,2,2,12
1589587200,M,0,2,2,1,4,3,12
1589673600,A,0,2,0,4,3,0,9
1589673600,F,0,1,0,4,2,0,7
1589673600,M,0,1,0,0,1,0,2
1589760000,A,0,0,0,5,4,1,10
1589760000,F,0,0,0,3,3,1,7
1589760000,M,0,0,0,2,1,0,3
1589846400,A,1,1,4,18,6,4,34
1589846400,F,0,0,4,12,4,2,22
1589846400,M,1,1,0,6,2,2,12
1589932800,A,0,0,3,13,2,3,21
1589932800,F,0,0,2,11,1,3,17
1589932800,M,0,0,1,2,1,0,4
1590019200,A,0,0,3,10,7,0,20
1590019200,F,0,0,1,8,5,0,14
1590019200,M,0,0,2,2,2,0,6
1590105600,A,0,0,3,8,3,4,18
1590105600,F,0,0,2,4,2,1,9
1590105600,M,0,0,1,4,1,3,9
1590192000,A,0,0,2,5,4,3,14
1590192000,F,0,0,2,4,1,2,9
1590192000,M,0,0,0,1,3,1,5
1590278400,A,0,0,0,9,2,0,11
1590278400,F,0,0,0,8,2,0,10
1590278400,M,0,0,0,1,0,0,1
1590364800,A,0,2,3,6,5,2,18
1590364800,F,0,1,1,3,2,0,7
1590364800,M,0,1,2,3,3,2,11
1590451200,A,0,1,7,10,11,7,36
1590451200,F,0,0,5,8,8,5,26
1590451200,M,0,1,2,2,3,2,10
1590537600,A,0,1,4,11,5,3,24
1590537600,F,0,1,3,5,2,3,14
1590537600,M,0,0,1,6,3,0,10
1590624000,A,0,1,3,10,8,14,36
1590624000,F,0,0,2,7,5,12,26
1590624000,M,0,1,1,3,3,2,10
1590710400,A,1,1,2,4,6,2,16
1590710400,F,0,0,2,2,5,2,11
1590710400,M,1,1,0,2,1,0,5
1590796800,A,0,1,1,3,2,6,13
1590796800,F,0,0,1,3,1,6,11
1590796800,M,0,1,0,0,1,0,2
1590883200,A,0,0,1,0,3,3,7
1590883200,F,0,0,0,0,2,1,3
1590883200,M,0,0,1,0,1,2,4
1590969600,A,0,0,0,2,0,0,2
1590969600,F,0,0,0,1,0,0,1
1590969600,M,0,0,0,1,0,0,1
1591056000,A,0,0,0,2,0,2,4
1591056000,F,0,0,0,1,0,2,3
1591056000,M,0,0,0,1,0,0,1
1591142400,A,0,0,5,12,2,1,20
1591142400,F,0,0,3,9,1,0,13
1591142400,M,0,0,2,3,1,1,7
1591228800,A,0,2,2,7,4,1,16
1591228800,F,0,2,2,3,2,0,9
1591228800,M,0,0,0,4,2,1,7
1591315200,A,1,4,3,7,2,3,20
1591315200,F,1,1,2,4,0,2,10
1591315200,M,0,3,1,3,2,1,10
1591401600,A,0,0,0,2,3,1,6
1591401600,F,0,0,0,2,2,1,5
1591401600,M,0,0,0,0,1,0,1
1591488000,A,0,0,1,3,2,0,6
1591488000,F,0,0,0,2,0,0,2
1591488000,M,0,0,1,1,2,0,4
1591574400,A,0,0,1,3,1,1,6
1591574400,F,0,0,0,3,0,1,4
1591574400,M,0,0,1,0,1,0,2
1591660800,A,0,1,3,6,2,2,14
1591660800,F,0,0,3,4,0,1,8
1591660800,M,0,1,0,2,2,1,6
1591747200,A,0,0,1,6,6,9,22
1591747200,F,0,0,1,4,2,7,14
1591747200,M,0,0,0,2,4,2,8
1591833600,A,1,1,2,6,4,5,19
1591833600,F,0,0,1,5,2,5,13
1591833600,M,1,1,1,1,2,0,6
1591920000,A,1,0,0,5,2,0,8
1591920000,F,1,0,0,4,1,0,6
1591920000,M,0,0,0,1,1,0,2
1592006400,A,0,0,2,3,2,4,11
1592006400,F,0,0,0,2,0,4,6
1592006400,M,0,0,2,1,2,0,5
1592092800,A,0,0,0,1,0,4,5
1592092800,F,0,0,0,1,0,3,4
1592092800,M,0,0,0,0,0,1,1
1592179200,A,0,0,1,1,0,0,2
1592179200,F,0,0,0,1,0,0,1
1592179200,M,0,0,1,0,0,0,1
1592265600,A,0,2,2,6,3,2,15
1592265600,F,0,0,1,3,0,2,6
1592265600,M,0,2,1,3,3,0,9
1592352000,A,0,0,0,1,3,2,6
1592352000,F,0,0,0,1,2,1,4
1592352000,M,0,0,0,0,1,1,2
1592438400,A,0,0,2,2,1,0,5
1592438400,F,0,0,0,2,0,0,2
1592438400,M,0,0,2,0,1,0,3
1592524800,A,0,0,0,4,2,0,6
1592524800,F,0,0,0,2,1,0,3
1592524800,M,0,0,0,2,1,0,3
1592611200,A,3,0,0,1,2,2,8
1592611200,F,2,0,0,1,2,1,6
1592611200,M,1,0,0,0,0,1,2
1592784000,A,0,0,2,1,0,2,5
1592784000,F,0,0,0,1,0,1,2
1592784000,M,0,0,2,0,0,1,3
1592870400,A,0,0,0,1,0,1,2
1592870400,F,0,0,0,1,0,1,2
1592870400,M,0,0,0,0,0,0,0
1592956800,A,1,0,1,0,0,1,3
1592956800,F,0,0,1,0,0,1,2
1592956800,M,1,0,0,0,0,0,1
1593043200,A,0,0,0,2,1,1,4
1593043200,F,0,0,0,0,0,1,1
1593043200,M,0,0,0,2,1,0,3
1593129600,A,0,0,0,1,2,2,5
1593129600,F,0,0,0,0,1,2,3
1593129600,M,0,0,0,1,1,0,2
1593388800,A,0,0,1,1,0,0,2
1593388800,F,0,0,1,1,0,0,2
1593388800,M,0,0,0,0,0,0,0
1593475200,A,0,2,0,1,2,0,5
1593475200,F,0,1,0,1,0,0,2
1593475200,M,0,1,0,0,2,0,3
1593561600,A,0,0,1,0,0,0,1
1593561600,F,0,0,1,0,0,0,1
1593561600,M,0,0,0,0,0,0,0
1593648000,A,0,0,3,5,1,1,10
1593648000,F,0,0,1,1,1,1,4
1593648000,M,0,0,2,4,0,0,6
1593820800,A,0,0,0,1,0,1,2
1593820800,F,0,0,0,1,0,0,1
1593820800,M,0,0,0,0,0,1,1
1593907200,A,0,0,0,0,2,0,2
1593907200,F,0,0,0,0,1,0,1
1593907200,M,0,0,0,0,1,0,1
1593993600,A,1,0,3,0,0,1,5
1593993600,F,1,0,1,0,0,1,3
1593993600,M,0,0,2,0,0,0,2
1594080000,A,0,1,2,0,3,1,7
1594080000,F,0,0,0,0,2,1,3
1594080000,M,0,1,2,0,1,0,4
1594166400,A,0,0,1,0,2,0,3
1594166400,F,0,0,1,0,0,0,1
1594166400,M,0,0,0,0,2,0,2
1594252800,A,0,0,0,0,2,0,2
1594252800,F,0,0,0,0,2,0,2
1594252800,M,0,0,0,0,0,0,0
1594339200,A,0,0,0,1,0,0,1
1594339200,F,0,0,0,0,0,0,0
1594339200,M,0,0,0,1,0,0,1
1594425600,A,0,0,2,0,0,1,3
1594425600,F,0,0,0,0,0,1,1
1594425600,M,0,0,2,0,0,0,2
1594512000,A,0,0,0,1,0,0,1
1594512000,F,0,0,0,0,0,0,0
1594512000,M,0,0,0,1,0,0,1
1594598400,A,0,0,0,1,2,0,3
1594598400,F,0,0,0,0,0,0,0
1594598400,M,0,0,0,1,2,0,3
1594684800,A,0,0,3,4,0,0,7
1594684800,F,0,0,1,1,0,0,2
1594684800,M,0,0,2,3,0,0,5
1594771200,A,1,0,3,3,1,1,9
1594771200,F,1,0,1,1,0,0,3
1594771200,M,0,0,2,2,1,1,6
1594857600,A,0,0,2,3,0,0,5
1594857600,F,0,0,1,2,0,0,3
1594857600,M,0,0,1,1,0,0,2
1594944000,A,0,0,2,1,0,0,3
1594944000,F,0,0,2,0,0,0,2
1594944000,M,0,0,0,1,0,0,1
1595030400,A,0,0,0,1,0,0,1
1595030400,F,0,0,0,0,0,0,0
1595030400,M,0,0,0,1,0,0,1
1595116800,A,0,0,1,0,0,0,1
1595116800,F,0,0,1,0,0,0,1
1595116800,M,0,0,0,0,0,0,0
1595203200,A,0,0,0,0,1,1,2
1595203200,F,0,0,0,0,0,1,1
1595203200,M,0,0,0,0,1,0,1
1595289600,A,0,0,0,1,0,0,1
1595289600,F,0,0,0,1,0,0,1
1595289600,M,0,0,0,0,0,0,0
1595376000,A,0,0,1,0,0,0,1
1595376000,F,0,0,0,0,0,0,0
1595376000,M,0,0,1,0,0,0,1
1595462400,A,1,4,2,2,1,2,12
1595462400,F,0,2,1,1,0,1,5
1595462400,M,1,2,1,1,1,1,7
1595548800,A,0,0,0,2,0,0,2
1595548800,F,0,0,0,2,0,0,2
1595548800,M,0,0,0,0,0,0,0
1595635200,A,0,3,2,1,0,0,6
1595635200,F,0,2,1,0,0,0,3
1595635200,M,0,1,1,1,0,0,3
1595721600,A,0,0,1,0,0,0,1
1595721600,F,0,0,0,0,0,0,0
1595721600,M,0,0,1,0,0,0,1
1595808000,A,0,1,0,3,0,0,4
1595808000,F,0,1,0,1,0,0,2
1595808000,M,0,0,0,2,0,0,2
1595894400,A,0,0,4,1,0,1,6
1595894400,F,0,0,1,0,0,1,2
1595894400,M,0,0,3,1,0,0,4
1595980800,A,0,0,0,2,1,0,3
1595980800,F,0,0,0,1,0,0,1
1595980800,M,0,0,0,1,1,0,2
1596067200,A,0,0,1,2,2,1,6
1596067200,F,0,0,1,1,0,1,3
1596067200,M,0,0,0,1,2,0,3
1596153600,A,0,1,0,1,3,1,6
1596153600,F,0,1,0,1,1,1,4
1596153600,M,0,0,0,0,2,0,2
1596240000,A,0,0,1,0,0,2,3
1596240000,F,0,0,1,0,0,2,3
1596240000,M,0,0,0,0,0,0,0
1596326400,A,0,0,0,1,0,0,1
1596326400,F,0,0,0,1,0,0,1
1596326400,M,0,0,0,0,0,0,0
1596412800,A,0,1,7,2,0,0,10
1596412800,F,0,1,1,2,0,0,4
1596412800,M,0,0,6,0,0,0,6
1596499200,A,0,0,2,0,1,1,4
1596499200,F,0,0,2,0,0,1,3
1596499200,M,0,0,0,0,1,0,1
1596585600,A,1,0,4,2,3,1,11
1596585600,F,0,0,1,0,1,1,3
1596585600,M,1,0,3,2,2,0,8
1596672000,A,1,1,5,5,0,2,14
1596672000,F,1,0,2,2,0,1,6
1596672000,M,0,1,3,3,0,1,8
1596758400,A,2,0,4,4,0,0,10
1596758400,F,2,0,3,3,0,0,8
1596758400,M,0,0,1,1,0,0,2
1596844800,A,0,0,2,0,0,0,2
1596844800,F,0,0,1,0,0,0,1
1596844800,M,0,0,1,0,0,0,1
1596931200,A,0,0,1,0,0,0,1
1596931200,F,0,0,1,0,0,0,1
1596931200,M,0,0,0,0,0,0,0
1597017600,A,1,0,2,5,1,4,13
1597017600,F,0,0,1,2,0,1,4
1597017600,M,1,0,1,3,1,3,9
1597104000,A,0,1,6,7,0,0,14
1597104000,F,0,0,1,1,0,0,2
1597104000,M,0,1,5,6,0,0,12
1597190400,A,0,0,11,6,2,0,19
1597190400,F,0,0,6,4,1,0,11
1597190400,M,0,0,5,2,1,0,8
1597276800,A,0,0,8,1,1,1,11
1597276800,F,0,0,5,1,0,0,6
1597276800,M,0,0,3,0,1,1,5
1597363200,A,0,3,4,4,0,0,11
1597363200,F,0,0,2,2,0,0,4
1597363200,M,0,3,2,2,0,0,7
1597449600,A,0,0,1,0,0,0,1
1597449600,F,0,0,0,0,0,0,0
1597449600,M,0,0,1,0,0,0,1
1597536000,A,0,0,1,1,0,0,2
1597536000,F,0,0,0,0,0,0,0
1597536000,M,0,0,1,1,0,0,2
1597622400,A,0,1,1,2,0,1,5
1597622400,F,0,1,1,2,0,1,5
1597622400,M,0,0,0,0,0,0,0
1597708800,A,1,1,2,8,1,0,13
1597708800,F,0,0,0,4,0,0,4
1597708800,M,1,1,2,4,1,0,9
1597795200,A,0,0,4,1,1,0,6
1597795200,F,0,0,0,1,1,0,2
1597795200,M,0,0,4,0,0,0,4
1597881600,A,0,2,6,3,1,1,13
1597881600,F,0,1,2,0,1,1,5
1597881600,M,0,1,4,3,0,0,8
1597968000,A,1,2,4,2,0,0,9
1597968000,F,1,1,3,1,0,0,6
1597968000,M,0,1,1,1,0,0,3
1598054400,A,0,0,1,4,1,1,7
1598054400,F,0,0,0,3,1,0,4
1598054400,M,0,0,1,1,0,1,3
1598140800,A,0,2,0,1,1,0,4
1598140800,F,0,2,0,0,0,0,2
1598140800,M,0,0,0,1,1,0,2
1598227200,A,0,3,4,2,0,1,10
1598227200,F,0,1,2,1,0,0,4
1598227200,M,0,2,2,1,0,1,6
1598313600,A,1,2,2,3,1,0,9
1598313600,F,0,1,1,2,0,0,4
1598313600,M,1,1,1,1,1,0,5
1598400000,A,0,0,2,4,1,0,7
1598400000,F,0,0,2,1,0,0,3
1598400000,M,0,0,0,3,1,0,4
1598486400,A,0,3,8,3,0,0,14
1598486400,F,0,1,3,1,0,0,5
1598486400,M,0,2,5,2,0,0,9
1598572800,A,1,4,13,4,1,0,23
1598572800,F,0,3,8,3,0,0,14
1598572800,M,1,1,5,1,1,0,9
1598659200,A,0,1,4,3,1,0,9
1598659200,F,0,1,2,1,0,0,4
1598659200,M,0,0,2,2,1,0,5
1598832000,A,0,1,1,3,0,0,5
1598832000,F,0,0,0,2,0,0,2
1598832000,M,0,1,1,1,0,0,3
1598918400,A,0,1,6,2,0,1,10
1598918400,F,0,1,2,2,0,0,5
1598918400,M,0,0,4,0,0,1,5
1599004800,A,0,2,5,4,0,0,11
1599004800,F,0,2,3,2,0,0,7
1599004800,M,0,0,2,2,0,0,4
1599091200,A,0,2,5,2,3,0,12
1599091200,F,0,1,2,1,1,0,5
1599091200,M,0,1,3,1,2,0,7
1599177600,A,0,1,10,5,2,0,18
1599177600,F,0,0,6,4,0,0,10
1599177600,M,0,1,4,1,2,0,8
1599264000,A,0,1,1,2,0,0,4
1599264000,F,0,1,0,1,0,0,2
1599264000,M,0,0,1,1,0,0,2
1599350400,A,0,0,2,2,1,2,7
1599350400,F,0,0,0,1,0,2,3
1599350400,M,0,0,2,1,1,0,4
1599436800,A,0,0,3,1,0,0,4
1599436800,F,0,0,1,0,0,0,1
1599436800,M,0,0,2,1,0,0,3
1599523200,A,0,0,5,4,1,0,10
1599523200,F,0,0,2,1,0,0,3
1599523200,M,0,0,3,3,1,0,7
1599609600,A,0,3,7,1,6,2,19
1599609600,F,0,3,5,0,4,2,14
1599609600,M,0,0,2,1,2,0,5
1599696000,A,0,1,7,7,4,0,19
1599696000,F,0,0,2,4,3,0,9
1599696000,M,0,1,5,3,1,0,10
1599782400,A,0,0,5,6,11,2,24
1599782400,F,0,0,2,4,9,1,16
1599782400,M,0,0,3,2,2,1,8
1599868800,A,2,0,5,8,6,2,23
1599868800,F,1,0,4,6,4,1,16
1599868800,M,1,0,1,2,2,1,7
1599955200,A,0,0,1,1,7,4,13
1599955200,F,0,0,0,1,5,4,10
1599955200,M,0,0,1,0,2,0,3
1600041600,A,0,1,5,5,6,0,17
1600041600,F,0,1,1,1,5,0,8
1600041600,M,0,0,4,4,1,0,9
1600128000,A,0,0,3,11,7,5,26
1600128000,F,0,0,2,5,5,3,15
1600128000,M,0,0,1,6,2,2,11
1600214400,A,0,2,3,10,4,6,25
1600214400,F,0,1,2,8,2,4,17
1600214400,M,0,1,1,2,2,2,8
1600300800,A,0,0,11,11,3,0,25
1600300800,F,0,0,6,5,1,0,12
1600300800,M,0,0,5,6,2,0,13
1600387200,A,0,1,8,12,6,5,32
1600387200,F,0,0,4,4,5,3,16
1600387200,M,0,1,4,8,1,2,16
1600473600,A,0,0,0,4,3,0,7
1600473600,F,0,0,0,3,2,0,5
1600473600,M,0,0,0,1,1,0,2
1600560000,A,0,0,1,2,2,1,6
1600560000,F,0,0,0,1,2,1,4
1600560000,M,0,0,1,1,0,0,2
1600646400,A,0,4,11,5,4,2,26
1600646400,F,0,2,7,1,2,1,13
1600646400,M,0,2,4,4,2,1,13
1600732800,A,0,0,4,8,4,1,17
1600732800,F,0,0,2,5,2,1,10
1600732800,M,0,0,2,3,2,0,7
1600819200,A,0,1,2,10,6,2,21
1600819200,F,0,1,1,8,5,2,17
1600819200,M,0,0,1,2,1,0,4
1600905600,A,0,3,6,9,3,0,21
1600905600,F,0,2,3,4,3,0,12
1600905600,M,0,1,3,5,0,0,9
1600992000,A,0,1,6,5,6,0,18
1600992000,F,0,0,2,4,2,0,8
1600992000,M,0,1,4,1,4,0,10
1601078400,A,0,0,2,2,1,2,7
1601078400,F,0,0,0,1,1,1,3
1601078400,M,0,0,2,1,0,1,4
1601164800,A,0,0,0,0,2,1,3
1601164800,F,0,0,0,0,0,1,1
1601164800,M,0,0,0,0,2,0,2
1601251200,A,0,2,3,3,0,0,8
1601251200,F,0,2,2,0,0,0,4
1601251200,M,0,0,1,3,0,0,4
1601337600,A,0,3,6,4,0,2,15
1601337600,F,0,1,4,1,0,1,7
1601337600,M,0,2,2,3,0,1,8
1601424000,A,1,2,6,8,8,6,31
1601424000,F,1,0,2,4,6,3,16
1601424000,M,0,2,4,4,2,3,15
1601510400,A,1,1,9,12,3,3,29
1601510400,F,1,1,6,4,3,1,16
1601510400,M,0,0,3,8,0,2,13
1601596800,A,0,1,6,11,10,2,30
1601596800,F,0,1,2,5,7,1,16
1601596800,M,0,0,4,6,3,1,14
1601683200,A,0,3,6,16,9,8,42
1601683200,F,0,2,3,12,3,5,25
1601683200,M,0,1,3,4,6,3,17
1601769600,A,0,0,3,3,1,0,7
1601769600,F,0,0,1,0,1,0,2
1601769600,M,0,0,2,3,0,0,5
1601856000,A,0,0,3,2,4,1,10
1601856000,F,0,0,2,1,1,1,5
1601856000,M,0,0,1,1,3,0,5
1601942400,A,0,0,5,5,6,2,18
1601942400,F,0,0,1,3,3,1,8
1601942400,M,0,0,4,2,3,1,10
1602028800,A,1,4,11,16,10,2,44
1602028800,F,1,2,7,10,6,1,27
1602028800,M,0,2,4,6,4,1,17
1602115200,A,0,4,11,15,18,0,48
1602115200,F,0,1,5,7,6,0,19
1602115200,M,0,3,6,8,12,0,29
1602201600,A,1,3,11,16,24,5,60
1602201600,F,1,1,6,5,14,4,31
1602201600,M,0,2,5,11,10,1,29
1602288000,A,0,2,10,18,13,10,53
1602288000,F,0,2,7,11,11,6,37
1602288000,M,0,0,3,7,2,4,16
1602374400,A,0,0,1,5,2,0,8
1602374400,F,0,0,1,4,2,0,7
1602374400,M,0,0,0,1,0,0,1
1602460800,A,1,0,18,23,14,3,59
1602460800,F,0,0,8,8,8,2,26
1602460800,M,1,0,10,15,6,1,33
1602547200,A,0,0,16,20,17,6,59
1602547200,F,0,0,4,13,6,4,27
1602547200,M,0,0,12,7,11,2,32
1602633600,A,0,2,22,28,21,5,78
1602633600,F,0,0,14,18,11,3,46
1602633600,M,0,2,8,10,10,2,32
1602720000,A,0,1,16,32,21,4,74
1602720000,F,0,1,9,18,11,1,40
1602720000,M,0,0,7,14,10,3,34
1602806400,A,1,8,34,51,22,8,124
1602806400,F,1,5,17,26,9,5,63
1602806400,M,0,3,17,25,13,3,61
1602892800,A,1,2,17,25,20,5,70
1602892800,F,1,1,9,15,9,2,37
1602892800,M,0,1,8,10,11,3,33
1602979200,A,0,0,17,3,8,4,32
1602979200,F,0,0,6,1,2,2,11
1602979200,M,0,0,11,2,6,2,21
1603065600,A,1,5,17,19,15,7,64
1603065600,F,0,4,10,8,8,4,34
1603065600,M,1,1,7,11,7,3,30
1603152000,A,1,4,29,41,24,18,117
1603152000,F,0,3,9,22,11,11,56
1603152000,M,1,1,20,19,13,7,61
1603238400,A,1,8,45,63,39,7,163
1603238400,F,1,4,20,30,26,6,87
1603238400,M,0,4,25,33,13,1,76
1603324800,A,1,7,51,60,32,13,164
1603324800,F,0,3,30,28,22,8,91
1603324800,M,1,4,21,32,10,5,73
1603411200,A,5,7,42,79,47,18,198
1603411200,F,3,3,25,37,28,12,108
1603411200,M,2,4,17,42,19,6,90
1603497600,A,9,20,49,52,29,46,205
1603497600,F,6,11,24,31,15,33,120
1603497600,M,3,9,25,21,14,13,85
1603584000,A,0,2,16,25,16,9,68
1603584000,F,0,1,9,18,13,7,48
1603584000,M,0,1,7,7,3,2,20
1603670400,A,3,4,31,39,13,5,95
1603670400,F,2,4,10,19,7,3,45
1603670400,M,1,0,21,20,6,2,50
1603756800,A,4,7,56,81,57,51,256
1603756800,F,2,4,21,43,31,36,137
1603756800,M,2,3,35,38,26,15,119
1603843200,A,2,5,61,98,41,20,227
1603843200,F,0,1,32,69,21,11,134
1603843200,M,2,4,29,29,20,9,93
1603929600,A,3,9,36,108,58,15,229
1603929600,F,1,5,14,58,33,11,122
1603929600,M,2,4,22,50,25,4,107
1604016000,A,7,15,79,137,56,41,335
1604016000,F,4,5,47,69,38,23,186
1604016000,M,3,10,32,68,18,18,149
1604102400,A,3,4,37,76,38,10,168
1604102400,F,3,1,20,33,15,7,79
1604102400,M,0,3,17,43,23,3,89
1604188800,A,2,1,12,25,12,7,59
1604188800,F,0,0,6,10,4,4,24
1604188800,M,2,1,6,15,8,3,35
1604275200,A,4,10,56,73,37,25,205
1604275200,F,2,7,34,38,19,18,118
1604275200,M,2,3,22,35,18,7,87
1604361600,A,10,16,67,113,51,26,283
1604361600,F,5,8,37,49,26,14,139
1604361600,M,5,8,30,64,25,12,144
1604448000,A,5,17,73,145,67,23,330
1604448000,F,2,7,43,80,33,16,181
1604448000,M,3,10,30,65,34,7,149
1604534400,A,5,21,73,127,52,27,305
1604534400,F,4,12,37,72,25,15,165
1604534400,M,1,9,36,55,27,12,140
1604620800,A,5,18,72,118,68,22,303
1604620800,F,3,8,34,70,39,16,170
1604620800,M,2,10,38,48,29,6,133
1604707200,A,3,16,63,83,39,30,234
1604707200,F,0,9,30,41,19,21,120
1604707200,M,3,7,33,42,20,9,114
1604793600,A,1,3,23,42,12,17,98
1604793600,F,1,2,13,26,6,9,57
1604793600,M,0,1,10,16,6,8,41
1604880000,A,1,9,64,80,39,13,206
1604880000,F,1,2,27,48,21,9,108
1604880000,M,0,7,37,32,18,4,98
1604966400,A,6,25,72,121,50,25,299
1604966400,F,4,10,42,75,35,14,180
1604966400,M,2,15,30,46,15,11,119
1605052800,A,6,18,79,125,79,47,354
1605052800,F,3,6,37,74,38,34,192
1605052800,M,3,12,42,51,41,13,162
1605139200,A,8,32,85,152,77,52,406
1605139200,F,3,15,52,99,43,40,252
1605139200,M,5,17,33,53,34,12,154
1605225600,A,10,24,77,159,80,36,386
1605225600,F,7,10,49,97,42,22,227
1605225600,M,3,14,28,62,38,14,159
1605312000,A,5,10,54,96,44,40,249
1605312000,F,2,5,24,50,23,31,135
1605312000,M,3,5,30,46,21,9,114
1605398400,A,0,10,35,38,26,12,121
1605398400,F,0,6,21,21,16,6,70
1605398400,M,0,4,14,17,10,6,51
1605484800,A,3,18,50,79,46,43,239
1605484800,F,0,6,33,49,30,28,146
1605484800,M,3,12,17,30,16,15,93
1605571200,A,7,30,72,186,86,52,433
1605571200,F,2,16,37,104,48,32,239
1605571200,M,5,14,35,82,38,20,194
1605657600,A,8,31,87,156,74,62,418
1605657600,F,4,19,45,91,40,46,245
1605657600,M,4,12,42,65,34,16,173
1605744000,A,7,30,99,184,85,67,472
1605744000,F,3,14,57,123,38,46,281
1605744000,M,4,16,42,61,47,21,191
1605830400,A,12,43,126,221,132,111,645
1605830400,F,5,26,67,128,78,82,386
1605830400,M,7,17,59,93,54,29,259
1605916800,A,8,34,119,178,88,50,477
1605916800,F,4,16,62,84,36,39,241
1605916800,M,4,18,57,94,51,11,235
1606003200,A,4,19,42,82,36,12,195
1606003200,F,2,9,24,51,15,11,112
1606003200,M,2,10,18,31,21,1,83
1606089600,A,2,36,59,140,88,55,380
1606089600,F,1,23,37,87,44,41,233
1606089600,M,1,13,22,53,44,14,147
1606176000,A,5,28,119,251,102,74,579
1606176000,F,2,14,71,147,51,44,329
1606176000,M,3,14,48,104,51,30,250
1606262400,A,14,47,128,206,86,67,548
1606262400,F,6,22,59,129,51,52,319
1606262400,M,8,25,69,77,35,15,229
1606348800,A,5,61,145,200,113,53,577
1606348800,F,3,28,83,106,58,34,312
1606348800,M,2,33,62,94,55,18,264
1606435200,A,8,41,120,196,80,64,509
1606435200,F,4,15,73,103,44,45,284
1606435200,M,4,26,47,93,36,19,225
1606521600,A,5,34,73,159,66,34,371
1606521600,F,2,15,31,90,38,24,200
1606521600,M,3,19,41,69,28,10,170
1606608000,A,6,19,43,108,33,41,250
1606608000,F,3,6,20,50,19,26,124
1606608000,M,3,13,23,58,14,15,126
1606694400,A,4,23,64,140,60,55,346
1606694400,F,4,13,31,85,28,34,195
1606694400,M,0,10,33,55,32,21,151
1606780800,A,2,35,114,208,100,41,500
1606780800,F,1,18,67,118,59,25,288
1606780800,M,1,17,47,90,41,16,212
1606867200,A,11,69,150,284,117,104,735
1606867200,F,5,31,88,172,65,73,434
1606867200,M,6,38,62,112,52,31,301
1606953600,A,17,68,185,370,165,84,889
1606953600,F,6,34,108,221,80,54,503
1606953600,M,11,34,77,149,85,30,386
1607040000,A,5,47,137,298,115,92,694
1607040000,F,2,29,77,168,62,62,400
1607040000,M,3,18,60,130,53,30,294
1607126400,A,7,43,75,163,67,58,413
1607126400,F,3,25,46,94,34,38,240
1607126400,M,4,18,29,68,33,20,172
1607212800,A,12,28,62,140,76,83,401
1607212800,F,6,14,41,86,43,55,245
1607212800,M,6,14,21,54,33,28,156
1607299200,A,5,20,92,194,74,49,434
1607299200,F,3,9,53,111,37,31,244
1607299200,M,2,11,39,83,37,18,190
1607385600,A,9,42,135,309,137,88,720
1607385600,F,4,25,73,170,77,56,405
1607385600,M,5,17,62,139,60,32,315
1607472000,A,11,47,176,373,169,93,869
1607472000,F,4,25,82,209,89,66,475
1607472000,M,7,22,94,164,80,27,394
1607558400,A,13,52,242,455,184,117,1063
1607558400,F,6,24,123,277,104,74,608
1607558400,M,7,28,119,178,80,43,455
1607644800,A,13,72,203,401,188,162,1039
1607644800,F,6,37,114,240,89,104,590
1607644800,M,7,35,89,161,99,57,448
1607731200,A,14,44,187,333,158,117,853
1607731200,F,6,26,107,211,81,76,507
1607731200,M,8,18,80,122,77,41,346
1607817600,A,5,23,76,147,76,30,357
1607817600,F,3,11,36,96,42,19,207
1607817600,M,2,12,40,51,34,11,150
1607904000,A,7,37,141,279,151,125,740
1607904000,F,2,14,78,157,73,87,411
1607904000,M,5,23,63,122,78,38,329
1607990400,A,7,29,186,410,159,94,885
1607990400,F,4,17,105,242,77,60,505
1607990400,M,3,12,81,168,82,34,380
1608076800,A,18,46,232,483,243,151,1173
1608076800,F,9,23,129,286,137,108,692
1608076800,M,9,23,102,197,106,43,480
1608163200,A,17,60,235,496,244,171,1223
1608163200,F,7,30,126,298,130,110,701
1608163200,M,10,30,108,198,114,61,521
1608249600,A,15,55,222,491,260,179,1222
1608249600,F,8,33,131,313,137,126,748
1608249600,M,7,22,91,178,123,53,474
1608336000,A,18,41,145,366,186,116,872
1608336000,F,9,23,84,210,113,65,504
1608336000,M,9,18,61,156,73,51,368
1608422400,A,2,10,66,141,88,93,400
1608422400,F,1,4,38,72,52,65,232
1608422400,M,1,6,28,69,36,28,168
1608508800,A,8,30,154,383,167,127,869
1608508800,F,2,10,88,234,77,77,488
1608508800,M,6,20,66,149,90,50,381
1608595200,A,11,52,278,574,286,192,1393
1608595200,F,5,29,158,330,146,122,790
1608595200,M,6,23,120,244,140,70,603
1608681600,A,18,51,294,667,327,196,1553
1608681600,F,10,21,164,393,178,136,902
1608681600,M,8,30,130,274,149,60,651
1608768000,A,12,34,181,424,199,143,993
1608768000,F,6,12,98,250,105,101,572
1608768000,M,6,22,83,174,94,42,421
1608854400,A,6,30,155,304,194,156,845
1608854400,F,4,9,88,181,102,99,483
1608854400,M,2,21,67,123,92,57,362
1608940800,A,1,8,59,161,106,69,404
1608940800,F,1,4,29,102,51,42,229
1608940800,M,0,4,30,59,55,27,175
1609027200,A,2,0,52,88,62,62,266
1609027200,F,1,0,29,55,30,34,149
1609027200,M,1,0,22,33,32,28,116
1609113600,A,3,11,107,265,139,96,621
1609113600,F,2,6,62,163,68,63,364
1609113600,M,1,5,45,102,71,33,257
1609200000,A,12,22,186,498,255,143,1116
1609200000,F,6,8,103,285,116,98,616
1609200000,M,6,14,83,213,139,45,500
1609286400,A,12,45,264,635,361,251,1568
1609286400,F,7,18,148,361,185,172,891
1609286400,M,5,27,116,274,176,79,677
1609372800,A,13,28,202,383,211,107,944
1609372800,F,4,18,112,210,122,69,535
1609372800,M,9,10,90,173,89,38,409
1609459200,A,6,20,111,229,92,108,566
1609459200,F,1,7,63,150,55,74,350
1609459200,M,5,13,48,79,37,34,216
1609545600,A,4,8,70,149,91,88,410
1609545600,F,3,2,38,89,48,48,228
1609545600,M,1,6,32,60,43,40,182
1609632000,A,2,6,51,97,62,65,283
1609632000,F,2,2,26,64,29,47,170
1609632000,M,0,4,25,33,33,18,113
1609718400,A,4,8,118,228,96,74,528
1609718400,F,1,5,55,151,51,43,306
1609718400,M,3,3,63,77,45,31,222
1609804800,A,11,31,274,493,277,177,1263
1609804800,F,6,12,169,296,140,119,742
1609804800,M,5,19,105,196,137,57,519
1609891200,A,16,40,315,538,295,186,1390
1609891200,F,8,16,162,308,160,115,769
1609891200,M,8,24,153,228,135,71,619
1609977600,A,14,30,321,572,295,230,1462
1609977600,F,7,17,167,309,145,165,810
1609977600,M,6,13,154,262,149,65,649
1610064000,A,14,38,279,524,275,208,1338
1610064000,F,5,21,138,316,147,136,763
1610064000,M,9,16,141,208,128,72,574
1610150400,A,8,21,114,207,123,113,586
1610150400,F,4,13,64,115,61,74,331
1610150400,M,4,8,50,92,62,39,255
1610236800,A,2,10,74,119,77,38,320
1610236800,F,1,5,45,72,42,25,190
1610236800,M,1,5,29,47,35,13,130
1610323200,A,7,19,176,300,178,145,825
1610323200,F,2,11,83,170,95,92,453
1610323200,M,5,8,93,130,83,53,372
1610409600,A,20,38,250,494,228,138,1168
1610409600,F,14,22,135,287,118,89,665
1610409600,M,6,16,115,206,110,49,502
1610496000,A,12,41,268,480,220,181,1202
1610496000,F,9,25,147,270,118,136,705
1610496000,M,3,16,121,210,102,45,497
1610582400,A,14,27,212,372,213,157,995
1610582400,F,4,16,124,203,113,102,562
1610582400,M,10,11,88,169,100,55,433
1610668800,A,12,29,180,343,180,164,908
1610668800,F,7,13,94,197,87,116,514
1610668800,M,5,16,85,146,93,48,393
1610755200,A,15,26,122,271,124,93,651
1610755200,F,9,13,71,163,67,58,381
1610755200,M,6,13,51,108,57,35,270
1610841600,A,3,7,39,103,60,68,280
1610841600,F,2,3,28,60,40,48,181
1610841600,M,1,4,11,43,20,20,99
1610928000,A,12,22,73,171,101,98,477
1610928000,F,3,10,39,108,59,70,289
1610928000,M,9,12,34,63,42,28,188
1611014400,A,12,15,177,357,186,146,893
1611014400,F,6,4,94,197,95,104,500
1611014400,M,6,11,83,160,91,42,393
1611100800,A,11,26,180,381,189,113,900
1611100800,F,8,12,99,232,110,80,541
1611100800,M,3,14,81,148,79,33,358
1611187200,A,19,28,111,309,149,148,764
1611187200,F,12,15,71,170,77,103,448
1611187200,M,7,13,40,139,72,45,316
1611273600,A,5,31,134,264,134,108,676
1611273600,F,3,18,74,149,72,77,393
1611273600,M,2,13,60,115,62,31,283
1611360000,A,15,15,102,178,99,82,491
1611360000,F,7,9,55,104,56,57,288
1611360000,M,8,6,47,74,43,25,203
1611446400,A,2,3,40,98,51,35,229
1611446400,F,1,1,19,55,27,24,127
1611446400,M,1,2,21,43,24,11,102
1611532800,A,2,9,69,117,60,63,320
1611532800,F,1,5,40,66,34,31,177
1611532800,M,1,4,29,51,26,32,143
1611619200,A,13,16,130,314,130,100,703
1611619200,F,3,8,69,181,70,65,396
1611619200,M,10,8,61,132,60,35,306
1611705600,A,11,17,134,300,134,111,707
1611705600,F,3,8,66,164,71,71,383
1611705600,M,8,9,68,136,63,40,324
1611792000,A,12,40,116,281,132,94,675
1611792000,F,8,19,58,164,69,69,387
1611792000,M,4,21,58,117,63,25,288
1611878400,A,5,17,109,212,98,79,520
1611878400,F,1,8,55,117,55,52,288
1611878400,M,4,9,54,95,43,27,232
1611964800,A,4,15,86,182,84,49,420
1611964800,F,3,10,40,99,42,32,226
1611964800,M,1,5,46,83,42,17,194
1612051200,A,5,7,33,55,39,21,160
1612051200,F,3,4,20,27,18,13,85
1612051200,M,2,3,13,28,21,8,75
1612137600,A,3,14,52,102,62,58,291
1612137600,F,2,6,27,59,31,33,158
1612137600,M,1,8,25,43,31,25,133
1612224000,A,11,19,111,289,129,65,624
1612224000,F,3,13,71,159,62,39,347
1612224000,M,8,6,40,130,67,26,277
1612310400,A,9,30,122,296,147,80,684
1612310400,F,6,14,58,167,70,52,367
1612310400,M,3,16,64,129,76,28,316
1612396800,A,12,16,141,215,114,69,567
1612396800,F,6,10,76,123,51,40,306
1612396800,M,6,6,65,92,63,29,261
1612483200,A,12,23,75,189,121,67,487
1612483200,F,4,12,29,112,59,34,250
1612483200,M,8,11,46,77,62,33,237
1612569600,A,4,21,58,121,64,41,309
1612569600,F,2,12,31,63,28,25,161
1612569600,M,2,9,27,58,36,16,148
1612656000,A,4,4,24,37,22,11,102
1612656000,F,2,1,9,18,13,8,51
1612656000,M,2,3,15,19,9,3,51
1612742400,A,5,7,47,100,51,33,243
1612742400,F,1,2,26,50,23,22,124
1612742400,M,4,5,21,50,28,11,119
1612828800,A,1,8,52,108,55,45,269
1612828800,F,1,4,32,60,27,29,153
1612828800,M,0,4,20,48,28,16,116
1612915200,A,1,18,62,139,79,37,336
1612915200,F,0,11,32,75,42,23,183
1612915200,M,1,7,30,64,37,14,153
1613001600,A,7,22,134,219,91,64,537
1613001600,F,3,13,72,110,47,40,285
1613001600,M,4,9,62,109,43,24,251
1613088000,A,8,17,94,180,73,57,429
1613088000,F,6,7,52,94,25,40,224
1613088000,M,2,10,42,86,48,17,205
1613174400,A,5,11,59,105,59,38,277
1613174400,F,3,6,26,57,26,20,138
1613174400,M,2,5,33,48,33,18,139
1613260800,A,4,13,30,53,34,17,151
1613260800,F,1,9,13,28,18,12,81
1613260800,M,3,4,17,25,16,5,70
1613347200,A,4,8,46,88,65,48,259
1613347200,F,2,6,23,46,37,35,149
1613347200,M,2,2,23,42,28,13,110
1613433600,A,10,15,93,211,117,63,509
1613433600,F,3,9,54,123,54,36,279
1613433600,M,7,6,39,88,63,27,230
1613520000,A,12,14,111,209,126,88,560
1613520000,F,8,5,60,123,64,62,322
1613520000,M,4,9,51,86,62,26,238
1613606400,A,11,24,98,202,108,56,499
1613606400,F,4,15,52,94,50,34,249
1613606400,M,7,9,46,108,58,22,250
1613692800,A,5,21,93,170,75,59,423
1613692800,F,2,9,47,87,38,43,226
1613692800,M,3,12,46,83,37,16,197
1613779200,A,9,11,87,130,52,40,329
1613779200,F,4,5,42,64,29,25,169
1613779200,M,5,6,45,66,23,15,160
1613865600,A,1,2,33,72,32,19,159
1613865600,F,1,1,18,41,17,8,86
1613865600,M,0,1,15,31,15,11,73
1613952000,A,5,10,52,85,35,26,213
1613952000,F,1,4,37,40,20,21,123
1613952000,M,4,6,15,45,15,5,90
1614038400,A,15,14,80,215,108,62,494
1614038400,F,10,8,45,125,67,37,292
1614038400,M,5,6,35,89,41,25,201
1614124800,A,16,26,120,230,137,98,627
1614124800,F,10,17,60,149,57,71,364
1614124800,M,6,9,60,81,80,27,263
1614211200,A,11,32,113,188,101,53,498
1614211200,F,6,16,60,102,49,30,263
1614211200,M,5,16,53,86,52,23,235
1614297600,A,9,23,95,167,129,49,472
1614297600,F,7,12,57,102,59,28,265
1614297600,M,2,11,38,65,70,21,207
1614384000,A,11,24,59,142,72,27,335
1614384000,F,8,15,27,77,33,20,180
1614384000,M,3,9,32,65,39,7,155
1614470400,A,7,11,29,51,24,8,130
1614470400,F,2,6,16,26,12,5,67
1614470400,M,5,5,13,25,12,3,63
1614556800,A,7,15,45,73,49,33,222
1614556800,F,3,7,20,41,24,20,115
1614556800,M,4,8,25,32,25,13,107
1614643200,A,20,49,97,207,88,39,500
1614643200,F,6,22,51,114,38,27,258
1614643200,M,14,27,46,93,50,12,242
1614729600,A,28,83,151,254,130,41,687
1614729600,F,16,34,84,138,66,28,366
1614729600,M,12,49,67,116,64,13,321
1614816000,A,34,44,95,219,83,34,509
1614816000,F,18,22,50,128,45,25,288
1614816000,M,15,22,45,90,38,9,219
1614902400,A,31,37,87,170,91,40,456
1614902400,F,16,15,50,90,49,27,247
1614902400,M,15,22,37,80,42,13,209
1614988800,A,26,56,85,165,72,27,431
1614988800,F,14,30,41,90,45,19,239
1614988800,M,12,26,44,75,27,8,192
1615075200,A,14,14,33,55,29,16,161
1615075200,F,6,7,18,29,13,10,83
1615075200,M,8,7,15,26,16,6,78
1615161600,A,5,17,51,101,37,35,246
1615161600,F,1,3,32,49,21,16,122
1615161600,M,4,14,19,52,16,19,124
1615248000,A,28,53,107,215,104,41,548
1615248000,F,16,24,60,120,57,27,304
1615248000,M,12,29,47,95,47,14,244
1615334400,A,33,63,156,316,132,62,762
1615334400,F,15,34,82,165,70,44,410
1615334400,M,18,29,74,148,62,17,348
1615420800,A,49,80,144,267,106,55,701
1615420800,F,27,42,79,161,54,41,404
1615420800,M,20,36,65,105,52,14,292
1615507200,A,19,58,130,226,93,32,558
1615507200,F,10,21,70,120,47,22,290
1615507200,M,9,37,60,106,46,10,268
1615593600,A,26,45,133,219,101,36,560
1615593600,F,15,23,71,112,53,19,293
1615593600,M,9,19,62,107,48,17,262
1615680000,A,14,22,58,102,50,18,264
1615680000,F,8,10,37,55,27,10,147
1615680000,M,6,12,21,47,23,6,115
1615766400,A,5,25,53,147,65,33,328
1615766400,F,2,8,24,65,34,16,149
1615766400,M,3,16,29,82,31,17,178
1615852800,A,37,58,184,312,143,47,781
1615852800,F,21,30,102,162,79,27,421
1615852800,M,15,26,82,150,64,20,357
1615939200,A,24,60,165,359,152,56,816
1615939200,F,12,32,88,182,87,38,439
1615939200,M,12,26,77,177,65,18,375
1616025600,A,29,71,198,341,125,51,815
1616025600,F,13,33,110,174,67,31,428
1616025600,M,14,35,88,166,58,20,381
1616112000,A,41,72,193,298,148,67,819
1616112000,F,14,26,94,157,72,47,410
1616112000,M,25,44,98,138,76,20,401
1616198400,A,22,62,131,230,138,30,613
1616198400,F,7,25,66,118,67,20,303
1616198400,M,12,37,65,112,70,10,306
1616284800,A,12,23,55,131,56,18,295
1616284800,F,8,8,25,60,27,6,134
1616284800,M,4,13,30,71,29,12,159
