timestamp,gender,A00-A04,A05-A14,A15-A34,A35-A59,A60-A79,A80+,ALL
1583535600,A,0,0,0,0,1,0,1
1583535600,F,0,0,0,0,1,0,1
1583535600,M,0,0,0,0,0,0,0
1583794800,A,0,0,2,6,1,0,9
1583794800,F,0,0,0,2,1,0,3
1583794800,M,0,0,2,4,0,0,6
1583881200,A,0,0,0,1,0,0,1
1583881200,F,0,0,0,1,0,0,1
1583881200,M,0,0,0,0,0,0,0
1583967600,A,0,1,1,7,2,0,11
1583967600,F,0,1,1,2,1,0,5
1583967600,M,0,0,0,5,1,0,6
1584054000,A,0,0,4,3,3,0,10
1584054000,F,0,0,1,0,0,0,1
1584054000,M,0,0,3,3,3,0,9
1584140400,A,0,0,7,11,0,0,18
1584140400,F,0,0,5,1,0,0,6
1584140400,M,0,0,2,10,0,0,12
1584226800,A,0,0,0,1,0,0,1
1584226800,F,0,0,0,1,0,0,1
1584226800,M,0,0,0,0,0,0,0
1584313200,A,0,0,7,8,3,0,18
1584313200,F,0,0,2,6,2,0,10
1584313200,M,0,0,5,2,1,0,8
1584399600,A,0,2,9,16,4,0,31
1584399600,F,0,0,3,5,2,0,10
1584399600,M,0,2,6,11,2,0,21
1584486000,A,1,1,13,18,4,0,37
1584486000,F,1,0,5,6,2,0,14
1584486000,M,0,1,8,12,2,0,23
1584572400,A,0,0,16,32,4,2,54
1584572400,F,0,0,3,18,2,0,23
1584572400,M,0,0,13,14,2,2,31
1584658800,A,1,4,23,34,11,4,77
1584658800,F,0,2,10,14,6,1,33
1584658800,M,1,2,13,20,5,3,44
1584745200,A,1,0,9,18,6,3,37
1584745200,F,1,0,2,7,4,1,15
1584745200,M,0,0,7,11,2,2,22
1584831600,A,1,1,6,10,6,3,27
1584831600,F,0,0,3,6,2,0,11
1584831600,M,1,1,3,4,4,3,16
1584918000,A,1,1,13,27,9,1,52
1584918000,F,1,0,7,8,6,0,22
1584918000,M,0,1,6,19,3,1,30
1585004400,A,0,2,15,38,11,6,72
1585004400,F,0,1,9,23,2,2,37
1585004400,M,0,1,6,15,9,4,35
1585090800,A,1,1,22,33,13,9,79
1585090800,F,1,0,9,17,7,8,42
1585090800,M,0,1,13,16,6,1,37
1585177200,A,1,1,22,31,15,4,74
1585177200,F,0,1,13,17,9,3,43
1585177200,M,1,0,9,14,6,1,31
1585263600,A,0,0,11,32,18,12,73
1585263600,F,0,0,8,20,7,9,44
1585263600,M,0,0,3,12,11,3,29
1585350000,A,0,1,14,31,15,7,68
1585350000,F,0,0,5,16,9,4,34
1585350000,M,0,1,9,15,6,3,34
1585436400,A,0,0,5,9,5,1,20
1585436400,F,0,0,2,6,4,0,12
1585436400,M,0,0,3,3,1,1,8
1585519200,A,1,1,6,17,7,4,36
1585519200,F,0,1,4,9,6,3,23
1585519200,M,1,0,2,8,1,1,13
1585605600,A,1,0,7,44,23,5,80
1585605600,F,0,0,5,22,9,3,39
1585605600,M,1,0,2,22,14,2,41
1585692000,A,0,0,7,29,16,5,57
1585692000,F,0,0,4,18,6,2,30
1585692000,M,0,0,3,11,10,3,27
1585778400,A,1,2,11,43,19,7,83
1585778400,F,1,0,5,25,10,4,45
1585778400,M,0,2,6,18,9,3,38
1585864800,A,1,1,15,22,19,12,70
1585864800,F,0,1,10,10,10,8,39
1585864800,M,1,0,5,12,9,4,31
1585951200,A,0,2,5,19,18,4,48
1585951200,F,0,0,4,13,7,0,24
1585951200,M,0,2,1,6,11,4,24
1586037600,A,0,0,6,15,7,12,40
1586037600,F,0,0,3,14,1,5,23
1586037600,M,0,0,3,1,6,7,17
1586124000,A,0,0,5,10,11,1,27
1586124000,F,0,0,3,8,3,0,14
1586124000,M,0,0,2,2,8,1,13
1586210400,A,0,1,17,28,21,3,70
1586210400,F,0,1,9,16,8,1,35
1586210400,M,0,0,8,12,13,2,35
1586296800,A,0,1,13,37,8,7,66
1586296800,F,0,0,8,21,4,3,36
1586296800,M,0,1,5,16,4,4,30
1586383200,A,0,0,18,33,11,6,68
1586383200,F,0,0,10,17,7,4,38
1586383200,M,0,0,8,16,4,2,30
1586469600,A,1,0,4,9,7,5,26
1586469600,F,1,0,3,8,1,4,17
1586469600,M,0,0,1,1,6,1,9
1586556000,A,0,0,8,7,8,4,27
1586556000,F,0,0,4,5,2,4,15
1586556000,M,0,0,4,2,6,0,12
1586642400,A,0,0,5,13,6,8,32
1586642400,F,0,0,1,10,3,5,19
1586642400,M,0,0,4,3,3,3,13
1586728800,A,0,0,6,8,4,3,21
1586728800,F,0,0,5,6,2,1,14
1586728800,M,0,0,1,2,2,2,7
1586815200,A,0,0,10,10,13,12,45
1586815200,F,0,0,5,6,6,7,24
1586815200,M,0,0,5,4,7,5,21
1586901600,A,0,1,8,18,8,6,41
1586901600,F,0,1,5,9,3,4,22
1586901600,M,0,0,3,9,5,2,19
1586988000,A,0,2,24,30,13,12,81
1586988000,F,0,1,16,16,6,9,48
1586988000,M,0,1,8,14,7,3,33
1587074400,A,0,1,6,11,10,7,35
1587074400,F,0,1,5,5,4,7,22
1587074400,M,0,0,1,6,6,0,13
1587160800,A,0,3,9,16,7,12,47
1587160800,F,0,1,4,11,6,5,27
1587160800,M,0,2,5,5,1,7,20
1587247200,A,0,0,2,6,1,7,16
1587247200,F,0,0,2,4,0,6,12
1587247200,M,0,0,0,2,1,1,4
1587333600,A,0,1,6,7,16,8,38
1587333600,F,0,1,1,4,8,4,18
1587333600,M,0,0,5,3,8,4,20
1587420000,A,1,1,19,20,16,16,73
1587420000,F,1,0,10,14,12,12,49
1587420000,M,0,1,9,6,4,4,24
1587506400,A,0,0,6,26,17,7,56
1587506400,F,0,0,4,14,4,5,27
1587506400,M,0,0,2,12,13,2,29
1587592800,A,1,0,18,27,13,6,65
1587592800,F,1,0,8,18,4,3,34
1587592800,M,0,0,10,9,9,3,31
1587679200,A,0,1,11,18,8,8,46
1587679200,F,0,0,7,12,7,5,31
1587679200,M,0,1,4,6,1,3,15
1587765600,A,1,0,6,9,6,3,25
1587765600,F,1,0,3,5,1,3,13
1587765600,M,0,0,3,4,5,0,12
1587852000,A,0,0,2,10,4,5,21
1587852000,F,0,0,2,9,1,5,17
1587852000,M,0,0,0,1,3,0,4
1587938400,A,0,0,6,7,9,6,28
1587938400,F,0,0,2,5,3,4,14
1587938400,M,0,0,4,2,6,2,14
1588024800,A,0,1,8,25,16,27,77
1588024800,F,0,1,5,15,7,22,50
1588024800,M,0,0,3,10,9,5,27
1588111200,A,1,0,6,15,15,6,43
1588111200,F,0,0,3,6,10,5,24
1588111200,M,1,0,3,9,5,1,19
1588197600,A,0,0,10,23,14,13,60
1588197600,F,0,0,7,14,6,5,32
1588197600,M,0,0,3,9,8,8,28
1588284000,A,0,0,5,4,2,3,14
1588284000,F,0,0,1,3,0,2,6
1588284000,M,0,0,4,1,2,1,8
1588370400,A,0,0,4,7,5,5,21
1588370400,F,0,0,3,5,3,3,14
1588370400,M,0,0,1,2,2,2,7
1588456800,A,0,0,0,0,1,0,1
1588456800,F,0,0,0,0,0,0,0
1588456800,M,0,0,0,0,1,0,1
1588543200,A,0,1,4,8,6,11,30
1588543200,F,0,0,2,6,4,8,20
1588543200,M,0,1,2,2,2,3,10
1588629600,A,0,0,6,11,9,15,41
1588629600,F,0,0,3,8,6,12,29
1588629600,M,0,0,3,3,3,3,12
1588716000,A,0,0,12,11,10,12,45
1588716000,F,0,0,9,6,5,9,29
1588716000,M,0,0,3,5,5,3,16
1588802400,A,0,1,10,16,10,11,48
1588802400,F,0,0,7,8,5,5,25
1588802400,M,0,1,3,8,5,6,23
1588888800,A,0,0,6,11,6,3,26
1588888800,F,0,0,6,5,2,2,15
1588888800,M,0,0,0,6,4,1,11
1588975200,A,0,2,4,10,9,6,31
1588975200,F,0,2,0,4,4,5,15
1588975200,M,0,0,4,6,5,1,16
1589061600,A,0,0,2,2,3,1,8
1589061600,F,0,0,2,2,2,0,6
1589061600,M,0,0,0,0,1,1,2
1589148000,A,0,0,4,16,3,8,31
1589148000,F,0,0,2,8,1,7,18
1589148000,M,0,0,2,8,2,1,13
1589234400,A,0,1,6,12,4,5,28
1589234400,F,0,1,3,5,2,3,14
1589234400,M,0,0,3,7,2,2,14
1589320800,A,0,1,2,8,2,3,16
1589320800,F,0,1,0,7,1,2,11
1589320800,M,0,0,2,1,1,1,5
1589407200,A,0,0,4,13,5,4,26
1589407200,F,0,0,3,9,2,3,17
1589407200,M,0,0,1,4,3,1,9
1589493600,A,0,0,1,9,6,5,21
1589493600,F,0,0,1,5,3,2,11
1589493600,M,0,0,0,4,3,3,10
1589580000,A,0,3,3,7,6,5,24
1589580000,F,0,1,1,6,2,2,12
1589580000,M,0,2,2,1,4,3,12
1589666400,A,0,2,0,4,3,0,9
1589666400,F,0,1,0,4,2,0,7
1589666400,M,0,1,0,0,1,0,2
1589752800,A,0,0,0,6,4,1,11
1589752800,F,0,0,0,4,3,1,8
1589752800,M,0,0,0,2,1,0,3
1589839200,A,1,1,4,18,6,4,34
1589839200,F,0,0,4,12,4,2,22
1589839200,M,1,1,0,6,2,2,12
1589925600,A,0,0,3,12,3,3,21
1589925600,F,0,0,2,11,1,3,17
1589925600,M,0,0,1,1,2,0,4
1590012000,A,0,0,3,10,7,0,20
1590012000,F,0,0,1,8,5,0,14
1590012000,M,0,0,2,2,2,0,6
1590098400,A,0,0,3,8,3,4,18
1590098400,F,0,0,2,4,2,1,9
1590098400,M,0,0,1,4,1,3,9
1590184800,A,0,0,2,5,4,3,14
1590184800,F,0,0,2,4,1,2,9
1590184800,M,0,0,0,1,3,1,5
1590271200,A,0,0,0,9,2,0,11
1590271200,F,0,0,0,8,2,0,10
1590271200,M,0,0,0,1,0,0,1
1590357600,A,0,2,3,6,5,2,18
1590357600,F,0,1,1,3,2,0,7
1590357600,M,0,1,2,3,3,2,11
1590444000,A,0,1,7,10,11,7,36
1590444000,F,0,0,5,8,8,5,26
1590444000,M,0,1,2,2,3,2,10
1590530400,A,0,1,4,11,5,3,24
1590530400,F,0,1,3,5,2,3,14
1590530400,M,0,0,1,6,3,0,10
1590616800,A,0,1,2,10,8,15,36
1590616800,F,0,0,1,7,5,13,26
1590616800,M,0,1,1,3,3,2,10
1590703200,A,1,1,1,4,6,2,15
1590703200,F,0,0,1,2,5,2,10
1590703200,M,1,1,0,2,1,0,5
1590789600,A,0,1,1,3,2,6,13
1590789600,F,0,0,1,3,1,6,11
1590789600,M,0,1,0,0,1,0,2
1590876000,A,0,0,1,0,3,3,7
1590876000,F,0,0,0,0,2,1,3
1590876000,M,0,0,1,0,1,2,4
1590962400,A,0,0,0,2,0,0,2
1590962400,F,0,0,0,1,0,0,1
1590962400,M,0,0,0,1,0,0,1
1591048800,A,0,0,0,2,0,2,4
1591048800,F,0,0,0,1,0,2,3
1591048800,M,0,0,0,1,0,0,1
1591135200,A,0,0,5,12,2,1,20
1591135200,F,0,0,3,9,1,0,13
1591135200,M,0,0,2,3,1,1,7
1591221600,A,0,2,2,7,4,1,16
1591221600,F,0,2,2,3,2,0,9
1591221600,M,0,0,0,4,2,1,7
1591308000,A,1,4,3,7,2,3,20
1591308000,F,1,1,2,4,0,2,10
1591308000,M,0,3,1,3,2,1,10
1591394400,A,0,0,0,2,3,1,6
1591394400,F,0,0,0,2,2,1,5
1591394400,M,0,0,0,0,1,0,1
1591480800,A,0,0,1,3,2,0,6
1591480800,F,0,0,0,2,0,0,2
1591480800,M,0,0,1,1,2,0,4
1591567200,A,0,0,1,3,1,1,6
1591567200,F,0,0,0,3,0,1,4
1591567200,M,0,0,1,0,1,0,2
1591653600,A,0,1,3,5,2,1,12
1591653600,F,0,0,3,3,0,1,7
1591653600,M,0,1,0,2,2,0,5
1591740000,A,0,0,1,6,6,9,22
1591740000,F,0,0,1,4,2,7,14
1591740000,M,0,0,0,2,4,2,8
1591826400,A,1,1,2,6,4,5,19
1591826400,F,0,0,1,5,2,5,13
1591826400,M,1,1,1,1,2,0,6
1591912800,A,1,0,0,5,2,0,8
1591912800,F,1,0,0,4,1,0,6
1591912800,M,0,0,0,1,1,0,2
1591999200,A,0,0,2,3,2,4,11
1591999200,F,0,0,0,2,0,4,6
1591999200,M,0,0,2,1,2,0,5
1592085600,A,0,0,0,1,0,4,5
1592085600,F,0,0,0,1,0,3,4
1592085600,M,0,0,0,0,0,1,1
1592172000,A,0,0,1,1,0,0,2
1592172000,F,0,0,0,1,0,0,1
1592172000,M,0,0,1,0,0,0,1
1592258400,A,0,2,2,6,3,2,15
1592258400,F,0,0,1,3,0,2,6
1592258400,M,0,2,1,3,3,0,9
1592344800,A,0,0,0,1,3,2,6
1592344800,F,0,0,0,1,2,1,4
1592344800,M,0,0,0,0,1,1,2
1592431200,A,0,0,2,2,1,0,5
1592431200,F,0,0,0,2,0,0,2
1592431200,M,0,0,2,0,1,0,3
1592517600,A,0,0,0,4,2,0,6
1592517600,F,0,0,0,2,1,0,3
1592517600,M,0,0,0,2,1,0,3
1592604000,A,3,0,0,1,2,2,8
1592604000,F,2,0,0,1,2,1,6
1592604000,M,1,0,0,0,0,1,2
1592776800,A,0,0,2,1,0,2,5
1592776800,F,0,0,0,1,0,1,2
1592776800,M,0,0,2,0,0,1,3
1592863200,A,0,0,0,1,0,1,2
1592863200,F,0,0,0,1,0,1,2
1592863200,M,0,0,0,0,0,0,0
1592949600,A,1,0,1,0,0,1,3
1592949600,F,0,0,1,0,0,1,2
1592949600,M,1,0,0,0,0,0,1
1593036000,A,0,0,0,2,1,1,4
1593036000,F,0,0,0,0,0,1,1
1593036000,M,0,0,0,2,1,0,3
1593122400,A,0,0,0,1,2,2,5
1593122400,F,0,0,0,0,1,2,3
1593122400,M,0,0,0,1,1,0,2
1593381600,A,0,0,1,1,0,0,2
1593381600,F,0,0,1,1,0,0,2
1593381600,M,0,0,0,0,0,0,0
1593468000,A,0,2,0,1,2,0,5
1593468000,F,0,1,0,1,0,0,2
1593468000,M,0,1,0,0,2,0,3
1593554400,A,0,0,1,0,0,0,1
1593554400,F,0,0,1,0,0,0,1
1593554400,M,0,0,0,0,0,0,0
1593640800,A,0,0,3,5,1,1,10
1593640800,F,0,0,1,1,1,1,4
1593640800,M,0,0,2,4,0,0,6
1593813600,A,0,0,0,1,0,1,2
1593813600,F,0,0,0,1,0,0,1
1593813600,M,0,0,0,0,0,1,1
1593900000,A,0,0,0,0,2,0,2
1593900000,F,0,0,0,0,1,0,1
1593900000,M,0,0,0,0,1,0,1
1593986400,A,1,0,3,0,0,1,5
1593986400,F,1,0,1,0,0,1,3
1593986400,M,0,0,2,0,0,0,2
1594072800,A,0,1,2,0,3,1,7
1594072800,F,0,0,0,0,2,1,3
1594072800,M,0,1,2,0,1,0,4
1594159200,A,0,0,1,0,2,0,3
1594159200,F,0,0,1,0,0,0,1
1594159200,M,0,0,0,0,2,0,2
1594245600,A,0,0,0,0,2,0,2
1594245600,F,0,0,0,0,2,0,2
1594245600,M,0,0,0,0,0,0,0
1594332000,A,0,0,0,1,0,0,1
1594332000,F,0,0,0,0,0,0,0
1594332000,M,0,0,0,1,0,0,1
1594418400,A,0,0,2,0,0,1,3
1594418400,F,0,0,0,0,0,1,1
1594418400,M,0,0,2,0,0,0,2
1594504800,A,0,0,0,1,0,0,1
1594504800,F,0,0,0,0,0,0,0
1594504800,M,0,0,0,1,0,0,1
1594591200,A,0,0,0,1,2,0,3
1594591200,F,0,0,0,0,0,0,0
1594591200,M,0,0,0,1,2,0,3
1594677600,A,0,0,3,4,0,0,7
1594677600,F,0,0,1,1,0,0,2
1594677600,M,0,0,2,3,0,0,5
1594764000,A,1,0,3,3,1,1,9
1594764000,F,1,0,1,1,0,0,3
1594764000,M,0,0,2,2,1,1,6
1594850400,A,0,0,2,3,0,0,5
1594850400,F,0,0,1,2,0,0,3
1594850400,M,0,0,1,1,0,0,2
1594936800,A,0,0,2,1,0,0,3
1594936800,F,0,0,2,0,0,0,2
1594936800,M,0,0,0,1,0,0,1
1595023200,A,0,0,0,1,0,0,1
1595023200,F,0,0,0,0,0,0,0
1595023200,M,0,0,0,1,0,0,1
1595109600,A,0,0,1,0,0,0,1
1595109600,F,0,0,1,0,0,0,1
1595109600,M,0,0,0,0,0,0,0
1595196000,A,0,0,0,0,1,1,2
1595196000,F,0,0,0,0,0,1,1
1595196000,M,0,0,0,0,1,0,1
1595282400,A,0,0,0,1,0,0,1
1595282400,F,0,0,0,1,0,0,1
1595282400,M,0,0,0,0,0,0,0
1595368800,A,0,0,1,0,0,0,1
1595368800,F,0,0,0,0,0,0,0
1595368800,M,0,0,1,0,0,0,1
1595455200,A,1,4,2,2,1,2,12
1595455200,F,0,2,1,1,0,1,5
1595455200,M,1,2,1,1,1,1,7
1595541600,A,0,0,0,2,0,0,2
1595541600,F,0,0,0,2,0,0,2
1595541600,M,0,0,0,0,0,0,0
1595628000,A,0,3,2,1,0,0,6
1595628000,F,0,2,1,0,0,0,3
1595628000,M,0,1,1,1,0,0,3
1595714400,A,0,0,1,0,0,0,1
1595714400,F,0,0,0,0,0,0,0
1595714400,M,0,0,1,0,0,0,1
1595800800,A,0,1,0,3,0,0,4
1595800800,F,0,1,0,1,0,0,2
1595800800,M,0,0,0,2,0,0,2
1595887200,A,0,0,4,1,0,1,6
1595887200,F,0,0,1,0,0,1,2
1595887200,M,0,0,3,1,0,0,4
1595973600,A,0,0,0,2,1,0,3
1595973600,F,0,0,0,1,0,0,1
1595973600,M,0,0,0,1,1,0,2
1596060000,A,0,0,1,2,2,1,6
1596060000,F,0,0,1,1,0,1,3
1596060000,M,0,0,0,1,2,0,3
1596146400,A,0,2,0,1,3,1,7
1596146400,F,0,2,0,1,1,1,5
1596146400,M,0,0,0,0,2,0,2
1596232800,A,0,0,1,0,0,2,3
1596232800,F,0,0,1,0,0,2,3
1596232800,M,0,0,0,0,0,0,0
1596319200,A,0,0,0,1,0,0,1
1596319200,F,0,0,0,1,0,0,1
1596319200,M,0,0,0,0,0,0,0
1596405600,A,0,0,7,2,0,0,9
1596405600,F,0,0,1,2,0,0,3
1596405600,M,0,0,6,0,0,0,6
1596492000,A,0,0,3,0,1,1,5
1596492000,F,0,0,2,0,0,1,3
1596492000,M,0,0,1,0,1,0,2
1596578400,A,1,0,3,2,3,1,10
1596578400,F,0,0,1,0,1,1,3
1596578400,M,1,0,2,2,2,0,7
1596664800,A,1,1,5,5,0,2,14
1596664800,F,1,0,2,2,0,1,6
1596664800,M,0,1,3,3,0,1,8
1596751200,A,2,0,4,4,0,0,10
1596751200,F,2,0,3,3,0,0,8
1596751200,M,0,0,1,1,0,0,2
1596837600,A,0,0,2,0,0,0,2
1596837600,F,0,0,1,0,0,0,1
1596837600,M,0,0,1,0,0,0,1
1596924000,A,0,0,1,0,0,0,1
1596924000,F,0,0,1,0,0,0,1
1596924000,M,0,0,0,0,0,0,0
1597010400,A,1,0,2,5,1,4,13
1597010400,F,0,0,1,2,0,1,4
1597010400,M,1,0,1,3,1,3,9
1597096800,A,0,1,6,7,0,0,14
1597096800,F,0,0,1,1,0,0,2
1597096800,M,0,1,5,6,0,0,12
1597183200,A,0,0,11,6,2,0,19
1597183200,F,0,0,6,4,1,0,11
1597183200,M,0,0,5,2,1,0,8
1597269600,A,0,0,8,1,1,1,11
1597269600,F,0,0,5,1,0,0,6
1597269600,M,0,0,3,0,1,1,5
1597356000,A,0,3,4,4,0,0,11
1597356000,F,0,0,2,2,0,0,4
1597356000,M,0,3,2,2,0,0,7
1597442400,A,0,0,1,0,0,0,1
1597442400,F,0,0,0,0,0,0,0
1597442400,M,0,0,1,0,0,0,1
1597528800,A,0,0,1,1,0,0,2
1597528800,F,0,0,0,0,0,0,0
1597528800,M,0,0,1,1,0,0,2
1597615200,A,0,1,1,2,0,1,5
1597615200,F,0,1,1,2,0,1,5
1597615200,M,0,0,0,0,0,0,0
1597701600,A,1,1,2,8,1,0,13
1597701600,F,0,0,0,4,0,0,4
1597701600,M,1,1,2,4,1,0,9
1597788000,A,0,0,4,1,1,0,6
1597788000,F,0,0,0,1,1,0,2
1597788000,M,0,0,4,0,0,0,4
1597874400,A,0,2,6,3,1,1,13
1597874400,F,0,1,2,0,1,1,5
1597874400,M,0,1,4,3,0,0,8
1597960800,A,1,2,4,2,0,0,9
1597960800,F,1,1,3,1,0,0,6
1597960800,M,0,1,1,1,0,0,3
1598047200,A,0,0,1,4,1,1,7
1598047200,F,0,0,0,3,1,0,4
1598047200,M,0,0,1,1,0,1,3
1598133600,A,0,2,0,1,1,0,4
1598133600,F,0,2,0,0,0,0,2
1598133600,M,0,0,0,1,1,0,2
1598220000,A,0,3,4,2,0,1,10
1598220000,F,0,1,2,1,0,0,4
1598220000,M,0,2,2,1,0,1,6
1598306400,A,1,2,2,3,1,0,9
1598306400,F,0,1,1,2,0,0,4
1598306400,M,1,1,1,1,1,0,5
1598392800,A,0,0,2,4,2,0,8
1598392800,F,0,0,2,1,0,0,3
1598392800,M,0,0,0,3,2,0,5
1598479200,A,0,3,8,3,0,0,14
1598479200,F,0,1,3,1,0,0,5
1598479200,M,0,2,5,2,0,0,9
1598565600,A,1,4,12,4,1,0,22
1598565600,F,0,3,7,3,0,0,13
1598565600,M,1,1,5,1,1,0,9
1598652000,A,0,1,4,3,1,0,9
1598652000,F,0,1,2,1,0,0,4
1598652000,M,0,0,2,2,1,0,5
1598824800,A,0,1,1,3,0,0,5
1598824800,F,0,0,0,2,0,0,2
1598824800,M,0,1,1,1,0,0,3
1598911200,A,0,1,6,2,0,1,10
1598911200,F,0,1,2,2,0,0,5
1598911200,M,0,0,4,0,0,1,5
1598997600,A,0,2,5,4,0,0,11
1598997600,F,0,2,3,2,0,0,7
1598997600,M,0,0,2,2,0,0,4
1599084000,A,0,2,5,2,3,0,12
1599084000,F,0,1,2,1,1,0,5
1599084000,M,0,1,3,1,2,0,7
1599170400,A,0,1,10,6,2,0,19
1599170400,F,0,0,6,4,0,0,10
1599170400,M,0,1,4,2,2,0,9
1599256800,A,0,1,1,2,0,0,4
1599256800,F,0,1,0,1,0,0,2
1599256800,M,0,0,1,1,0,0,2
1599343200,A,0,0,2,2,1,2,7
1599343200,F,0,0,0,1,0,2,3
1599343200,M,0,0,2,1,1,0,4
1599429600,A,0,0,3,0,0,0,3
1599429600,F,0,0,1,0,0,0,1
1599429600,M,0,0,2,0,0,0,2
1599516000,A,0,0,5,4,1,0,10
1599516000,F,0,0,2,1,0,0,3
1599516000,M,0,0,3,3,1,0,7
1599602400,A,0,3,7,1,6,2,19
1599602400,F,0,3,5,0,4,2,14
1599602400,M,0,0,2,1,2,0,5
1599688800,A,0,1,7,7,4,0,19
1599688800,F,0,0,2,4,3,0,9
1599688800,M,0,1,5,3,1,0,10
1599775200,A,0,0,5,6,11,2,24
1599775200,F,0,0,2,4,9,1,16
1599775200,M,0,0,3,2,2,1,8
1599861600,A,2,0,5,8,6,2,23
1599861600,F,1,0,4,6,4,1,16
1599861600,M,1,0,1,2,2,1,7
1599948000,A,0,0,1,1,7,4,13
1599948000,F,0,0,0,1,5,4,10
1599948000,M,0,0,1,0,2,0,3
1600034400,A,0,1,5,5,6,0,17
1600034400,F,0,1,1,1,5,0,8
1600034400,M,0,0,4,4,1,0,9
1600120800,A,0,0,3,11,7,5,26
1600120800,F,0,0,2,5,5,3,15
1600120800,M,0,0,1,6,2,2,11
1600207200,A,0,2,3,10,4,6,25
1600207200,F,0,1,2,8,2,4,17
1600207200,M,0,1,1,2,2,2,8
1600293600,A,0,0,11,11,3,1,26
1600293600,F,0,0,6,5,1,0,12
1600293600,M,0,0,5,6,2,1,14
1600380000,A,0,1,8,12,6,4,31
1600380000,F,0,0,4,4,5,3,16
1600380000,M,0,1,4,8,1,1,15
1600466400,A,0,0,0,4,3,0,7
1600466400,F,0,0,0,3,2,0,5
1600466400,M,0,0,0,1,1,0,2
1600552800,A,0,0,1,2,2,1,6
1600552800,F,0,0,0,1,2,1,4
1600552800,M,0,0,1,1,0,0,2
1600639200,A,0,4,11,5,5,2,27
1600639200,F,0,2,5,1,2,1,11
1600639200,M,0,2,6,4,3,1,16
1600725600,A,0,0,4,8,3,1,16
1600725600,F,0,0,2,5,1,1,9
1600725600,M,0,0,2,3,2,0,7
1600812000,A,0,1,2,10,6,2,21
1600812000,F,0,0,1,8,5,2,16
1600812000,M,0,1,1,2,1,0,5
1600898400,A,0,3,6,9,3,0,21
1600898400,F,0,2,3,4,3,0,12
1600898400,M,0,1,3,5,0,0,9
1600984800,A,0,1,6,5,6,0,18
1600984800,F,0,0,2,4,2,0,8
1600984800,M,0,1,4,1,4,0,10
1601071200,A,0,0,2,2,1,2,7
1601071200,F,0,0,0,1,1,1,3
1601071200,M,0,0,2,1,0,1,4
1601157600,A,0,0,0,0,2,1,3
1601157600,F,0,0,0,0,0,1,1
1601157600,M,0,0,0,0,2,0,2
1601244000,A,0,2,3,3,0,0,8
1601244000,F,0,2,2,0,0,0,4
1601244000,M,0,0,1,3,0,0,4
1601330400,A,0,3,6,4,0,2,15
1601330400,F,0,1,4,1,0,1,7
1601330400,M,0,2,2,3,0,1,8
1601416800,A,1,1,6,8,8,6,30
1601416800,F,1,0,2,4,6,3,16
1601416800,M,0,1,4,4,2,3,14
1601503200,A,1,1,9,12,3,3,29
1601503200,F,1,1,6,4,3,1,16
1601503200,M,0,0,3,8,0,2,13
1601589600,A,0,1,6,11,10,2,30
1601589600,F,0,1,2,5,7,1,16
1601589600,M,0,0,4,6,3,1,14
1601676000,A,0,3,5,13,8,6,35
1601676000,F,0,2,3,9,3,4,21
1601676000,M,0,1,2,4,5,2,14
1601762400,A,0,0,3,3,1,0,7
1601762400,F,0,0,1,0,1,0,2
1601762400,M,0,0,2,3,0,0,5
1601848800,A,0,0,3,2,4,1,10
1601848800,F,0,0,2,1,1,1,5
1601848800,M,0,0,1,1,3,0,5
1601935200,A,0,0,5,5,6,2,18
1601935200,F,0,0,1,3,3,1,8
1601935200,M,0,0,4,2,3,1,10
1602021600,A,1,4,11,15,11,2,44
1602021600,F,1,2,7,9,7,1,27
1602021600,M,0,2,4,6,4,1,17
1602108000,A,0,4,12,15,18,0,49
1602108000,F,0,1,5,7,6,0,19
1602108000,M,0,3,7,8,12,0,30
1602194400,A,0,4,11,16,24,5,60
1602194400,F,0,2,6,5,14,4,31
1602194400,M,0,2,5,11,10,1,29
1602280800,A,0,2,10,18,13,10,53
1602280800,F,0,2,7,11,11,6,37
1602280800,M,0,0,3,7,2,4,16
1602367200,A,0,0,1,4,2,0,7
1602367200,F,0,0,1,3,2,0,6
1602367200,M,0,0,0,1,0,0,1
1602453600,A,1,0,16,23,14,3,57
1602453600,F,0,0,8,8,8,2,26
1602453600,M,1,0,8,15,6,1,31
1602540000,A,0,0,16,21,17,6,60
1602540000,F,0,0,4,13,6,4,27
1602540000,M,0,0,12,8,11,2,33
1602626400,A,0,2,22,28,21,5,78
1602626400,F,0,0,14,18,11,3,46
1602626400,M,0,2,8,10,10,2,32
1602712800,A,0,1,16,32,21,4,74
1602712800,F,0,0,9,18,11,1,39
1602712800,M,0,1,7,14,10,3,35
1602799200,A,1,8,34,51,22,8,124
1602799200,F,1,5,17,26,9,5,63
1602799200,M,0,3,17,25,13,3,61
1602885600,A,1,2,16,25,20,5,69
1602885600,F,1,1,8,15,9,2,36
1602885600,M,0,1,8,10,11,3,33
1602972000,A,0,0,17,3,8,4,32
1602972000,F,0,0,6,1,2,2,11
1602972000,M,0,0,11,2,6,2,21
1603058400,A,1,5,17,19,15,7,64
1603058400,F,0,4,10,8,8,4,34
1603058400,M,1,1,7,11,7,3,30
1603144800,A,1,4,29,41,24,19,118
1603144800,F,0,3,9,22,11,11,56
1603144800,M,1,1,20,19,13,8,62
1603231200,A,1,8,44,63,38,9,163
1603231200,F,1,4,20,28,26,8,87
1603231200,M,0,4,24,35,12,1,76
1603317600,A,1,7,51,60,32,13,164
1603317600,F,0,3,30,28,22,8,91
1603317600,M,1,4,21,32,10,5,73
1603404000,A,5,7,43,79,46,18,198
1603404000,F,3,3,25,37,26,12,106
1603404000,M,2,4,18,42,20,6,92
1603490400,A,8,20,50,52,29,46,205
1603490400,F,5,11,25,30,15,33,119
1603490400,M,3,9,25,22,14,13,86
1603576800,A,0,2,16,26,18,9,71
1603576800,F,0,1,9,18,15,7,50
1603576800,M,0,1,7,8,3,2,21
1603666800,A,3,4,31,39,15,5,97
1603666800,F,2,4,10,19,7,3,45
1603666800,M,1,0,21,20,8,2,52
1603753200,A,3,8,56,83,56,51,257
1603753200,F,2,4,21,44,29,37,137
1603753200,M,1,4,35,39,27,14,120
1603839600,A,3,5,60,96,40,20,224
1603839600,F,1,1,31,67,21,11,132
1603839600,M,2,4,29,29,19,9,92
1603926000,A,1,10,37,109,57,15,229
1603926000,F,0,5,13,59,33,11,121
1603926000,M,1,5,24,50,24,4,108
1604012400,A,7,15,79,135,56,41,333
1604012400,F,4,5,48,68,38,23,186
1604012400,M,3,10,31,67,18,18,147
1604098800,A,2,4,38,78,37,10,169
1604098800,F,2,1,20,35,15,7,80
1604098800,M,0,3,18,43,22,3,89
1604185200,A,2,1,12,25,14,8,62
1604185200,F,0,0,6,10,5,4,25
1604185200,M,2,1,6,15,9,4,37
1604271600,A,5,10,55,74,37,24,205
1604271600,F,3,7,33,39,19,17,118
1604271600,M,2,3,22,35,18,7,87
1604358000,A,10,16,68,112,52,26,284
1604358000,F,5,8,38,49,27,14,141
1604358000,M,5,8,30,63,25,12,143
1604444400,A,5,17,73,145,69,24,333
1604444400,F,2,7,43,82,34,16,184
1604444400,M,3,10,30,63,35,8,149
1604530800,A,4,21,70,127,55,27,304
1604530800,F,3,12,37,71,26,15,164
1604530800,M,1,9,33,56,29,12,140
1604617200,A,4,20,69,119,69,22,303
1604617200,F,2,10,32,71,39,16,170
1604617200,M,2,10,37,48,30,6,133
1604703600,A,3,16,62,84,39,30,234
1604703600,F,0,9,29,42,19,21,120
1604703600,M,3,7,33,42,20,9,114
1604790000,A,1,3,23,42,12,17,98
1604790000,F,1,2,13,26,6,9,57
1604790000,M,0,1,10,16,6,8,41
1604876400,A,1,9,64,82,40,13,209
1604876400,F,1,2,27,50,21,9,110
1604876400,M,0,7,37,32,19,4,99
1604962800,A,6,25,72,118,48,29,298
1604962800,F,5,10,42,73,34,17,181
1604962800,M,1,15,30,45,14,12,117
1605049200,A,6,19,78,126,80,47,356
1605049200,F,3,6,38,74,39,34,194
1605049200,M,3,13,40,52,41,13,162
1605135600,A,8,31,85,151,77,53,405
1605135600,F,3,14,53,98,43,41,252
1605135600,M,5,17,32,53,34,12,153
1605222000,A,10,24,75,158,80,35,382
1605222000,F,7,10,48,94,44,21,224
1605222000,M,3,14,27,64,36,14,158
1605308400,A,5,10,53,97,43,40,248
1605308400,F,2,5,24,49,22,31,133
1605308400,M,3,5,29,48,21,9,115
1605394800,A,0,10,35,38,26,12,121
1605394800,F,0,6,21,21,16,6,70
1605394800,M,0,4,14,17,10,6,51
1605481200,A,2,18,50,81,45,43,239
1605481200,F,0,6,33,50,30,28,147
1605481200,M,2,12,17,31,15,15,92
1605567600,A,6,30,71,187,86,51,431
1605567600,F,2,15,35,103,49,33,237
1605567600,M,4,15,36,84,37,18,194
1605654000,A,8,31,87,156,74,63,419
1605654000,F,4,19,45,91,40,47,246
1605654000,M,4,12,42,65,34,16,173
1605740400,A,7,29,99,185,86,68,474
1605740400,F,3,13,57,124,39,48,284
1605740400,M,4,16,42,61,47,20,190
1605826800,A,12,43,126,226,133,111,651
1605826800,F,5,26,67,135,78,82,393
1605826800,M,7,17,59,91,55,29,258
1605913200,A,8,33,119,176,87,49,472
1605913200,F,4,14,62,83,36,38,237
1605913200,M,4,19,57,93,51,11,235
1605999600,A,4,19,42,80,35,12,192
1605999600,F,2,9,24,50,14,11,110
1605999600,M,2,10,18,30,21,1,82
1606086000,A,3,37,58,139,84,57,378
1606086000,F,2,23,36,86,42,43,232
1606086000,M,1,14,22,53,42,14,146
1606172400,A,5,28,118,253,100,76,580
1606172400,F,1,15,71,148,49,46,330
1606172400,M,4,13,47,105,51,30,250
1606258800,A,14,47,128,207,87,66,549
1606258800,F,7,23,59,128,53,51,321
1606258800,M,7,24,69,79,34,15,228
1606345200,A,5,60,146,201,112,52,576
1606345200,F,2,28,83,106,55,34,308
1606345200,M,3,32,63,95,57,18,268
1606431600,A,8,40,118,200,81,64,511
1606431600,F,4,15,71,104,44,45,283
1606431600,M,4,25,47,96,37,19,228
1606518000,A,4,34,75,159,65,34,371
1606518000,F,1,15,34,89,38,24,201
1606518000,M,3,19,41,70,27,10,170
1606604400,A,6,19,42,106,34,41,248
1606604400,F,3,6,20,50,19,26,124
1606604400,M,3,13,22,56,15,15,124
1606690800,A,4,24,66,143,61,55,353
1606690800,F,4,14,33,87,28,34,200
1606690800,M,0,10,33,56,33,21,153
1606777200,A,3,35,114,214,100,42,508
1606777200,F,2,18,67,123,58,25,293
1606777200,M,1,17,47,91,42,17,215
1606863600,A,11,67,151,280,118,100,727
1606863600,F,5,29,88,170,65,69,426
1606863600,M,6,38,63,110,53,31,301
1606950000,A,17,68,186,366,168,81,886
1606950000,F,6,34,108,215,82,53,498
1606950000,M,11,34,78,151,86,28,388
1607036400,A,5,47,136,299,115,92,694
1607036400,F,2,29,75,168,63,61,398
1607036400,M,3,18,61,131,52,31,296
1607122800,A,7,44,76,164,65,57,413
1607122800,F,3,26,47,95,34,39,244
1607122800,M,4,18,29,69,31,18,169
1607209200,A,12,28,65,136,73,80,394
1607209200,F,6,14,41,83,39,52,235
1607209200,M,6,14,24,53,34,28,159
1607295600,A,5,20,92,196,74,50,437
1607295600,F,3,9,53,112,37,33,247
1607295600,M,2,11,39,84,37,17,190
1607382000,A,9,42,133,306,137,87,714
1607382000,F,4,26,71,167,78,54,400
1607382000,M,5,16,62,139,59,33,314
1607468400,A,11,47,175,372,168,92,865
1607468400,F,4,25,81,210,91,66,477
1607468400,M,7,22,94,162,77,26,388
1607554800,A,13,52,237,459,188,116,1065
1607554800,F,6,25,119,281,107,73,611
1607554800,M,7,27,118,178,81,43,454
1607641200,A,13,70,202,398,187,163,1033
1607641200,F,6,35,114,238,87,108,588
1607641200,M,7,35,88,160,100,55,445
1607727600,A,15,44,188,330,155,113,845
1607727600,F,6,26,107,210,80,71,500
1607727600,M,9,18,81,120,75,42,345
1607814000,A,5,27,77,147,76,33,365
1607814000,F,3,14,36,95,42,20,210
1607814000,M,2,13,41,52,34,13,155
1607900400,A,6,35,141,282,151,123,738
1607900400,F,2,14,79,158,73,85,411
1607900400,M,4,21,62,124,78,38,327
1607986800,A,7,29,185,408,160,97,886
1607986800,F,4,17,102,243,78,62,506
1607986800,M,3,12,83,165,82,35,380
1608073200,A,18,47,232,486,243,147,1173
1608073200,F,9,24,128,286,137,102,686
1608073200,M,9,23,103,200,106,45,486
1608159600,A,16,63,236,494,247,172,1228
1608159600,F,8,30,127,298,130,110,703
1608159600,M,8,33,108,196,117,62,524
1608246000,A,16,57,224,494,263,183,1237
1608246000,F,8,35,132,313,138,130,756
1608246000,M,8,22,92,181,125,53,481
1608332400,A,17,40,143,361,186,113,860
1608332400,F,8,22,82,204,113,63,492
1608332400,M,9,18,61,157,73,50,368
1608418800,A,2,10,65,138,87,93,395
1608418800,F,1,4,38,72,51,64,230
1608418800,M,1,6,27,66,36,29,165
1608505200,A,8,29,155,377,170,131,870
1608505200,F,3,9,90,230,79,78,489
1608505200,M,5,20,65,147,91,53,381
1608591600,A,11,49,277,567,287,191,1382
1608591600,F,5,27,157,328,146,121,784
1608591600,M,6,22,120,239,141,70,598
1608678000,A,17,52,300,662,331,195,1557
1608678000,F,10,22,167,391,177,137,904
1608678000,M,7,30,133,271,154,58,653
1608764400,A,10,31,174,412,198,148,973
1608764400,F,5,12,94,245,106,104,566
1608764400,M,5,19,80,167,92,44,407
1608850800,A,5,28,148,303,187,156,827
1608850800,F,3,8,82,182,94,100,469
1608850800,M,2,20,66,121,93,56,358
1608937200,A,2,8,59,160,103,62,394
1608937200,F,1,4,29,102,50,37,223
1608937200,M,1,4,30,58,53,25,171
1609023600,A,1,0,52,90,62,62,267
1609023600,F,1,0,29,57,30,34,151
1609023600,M,0,0,22,33,32,28,115
1609110000,A,3,11,107,266,138,96,621
1609110000,F,2,6,62,164,68,64,366
1609110000,M,1,5,45,102,70,32,255
1609196400,A,12,23,190,504,252,149,1130
1609196400,F,6,9,105,286,114,102,622
1609196400,M,6,14,85,218,138,47,508
1609282800,A,12,44,266,639,359,249,1569
1609282800,F,7,18,149,362,187,172,895
1609282800,M,5,26,117,277,172,77,674
1609369200,A,13,27,198,376,208,108,930
1609369200,F,4,17,112,207,118,69,527
1609369200,M,9,10,86,169,90,39,403
1609455600,A,6,20,111,224,90,107,558
1609455600,F,1,7,63,147,54,74,346
1609455600,M,5,13,48,77,36,33,212
1609542000,A,4,8,70,150,91,87,410
1609542000,F,3,2,38,90,48,48,229
1609542000,M,1,6,32,60,43,39,181
1609628400,A,2,6,51,97,63,64,283
1609628400,F,2,2,26,64,30,48,172
1609628400,M,0,4,25,33,33,16,111
1609714800,A,4,8,120,226,100,75,533
1609714800,F,1,5,54,148,51,44,303
1609714800,M,3,3,66,78,49,31,230
1609801200,A,12,31,273,496,287,181,1280
1609801200,F,6,12,166,295,144,121,744
1609801200,M,6,19,107,200,143,60,535
1609887600,A,15,43,315,539,292,184,1388
1609887600,F,7,19,164,311,157,115,773
1609887600,M,8,24,151,228,135,69,615
1609974000,A,13,31,318,568,293,231,1454
1609974000,F,7,17,165,308,146,167,810
1609974000,M,5,14,153,259,147,64,642
1610060400,A,12,37,272,530,279,208,1338
1610060400,F,5,21,133,318,150,137,764
1610060400,M,7,16,139,212,129,71,574
1610146800,A,8,20,121,206,120,110,585
1610146800,F,4,14,66,116,60,74,334
1610146800,M,4,6,55,90,60,36,251
1610233200,A,2,10,75,118,77,42,324
1610233200,F,1,5,46,71,41,28,192
1610233200,M,1,5,29,47,36,14,132
1610319600,A,7,17,175,295,177,146,817
1610319600,F,2,9,85,166,95,92,449
1610319600,M,5,8,90,129,82,54,368
1610406000,A,20,40,251,489,228,137,1165
1610406000,F,14,23,134,284,119,90,664
1610406000,M,6,17,117,205,109,47,501
1610492400,A,12,41,267,489,221,181,1211
1610492400,F,9,25,147,276,118,136,711
1610492400,M,3,16,120,213,103,45,500
1610578800,A,14,27,208,371,213,149,982
1610578800,F,4,16,120,203,111,97,551
1610578800,M,10,11,88,168,102,52,431
1610665200,A,12,28,184,345,177,171,917
1610665200,F,7,13,97,199,87,121,524
1610665200,M,5,15,86,146,90,50,392
1610751600,A,15,23,118,270,124,98,648
1610751600,F,9,10,70,162,68,62,381
1610751600,M,6,13,48,108,56,36,267
1610838000,A,3,7,39,98,60,60,267
1610838000,F,2,3,28,59,39,41,172
1610838000,M,1,4,11,39,21,19,95
1610924400,A,12,22,73,171,100,95,473
1610924400,F,3,10,39,108,58,69,287
1610924400,M,9,12,34,63,42,26,186
1611010800,A,12,16,178,359,186,139,890
1611010800,F,6,5,94,199,94,99,497
1611010800,M,6,11,84,160,92,40,393
1611097200,A,11,26,182,380,190,116,905
1611097200,F,8,12,102,232,111,81,546
1611097200,M,3,14,80,148,79,35,359
1611183600,A,20,28,109,311,150,147,765
1611183600,F,12,15,68,171,79,104,449
1611183600,M,8,13,41,140,71,43,316
1611270000,A,5,30,132,266,132,108,673
1611270000,F,3,17,72,151,71,77,391
1611270000,M,2,13,60,115,61,31,282
1611356400,A,15,15,103,177,98,80,488
1611356400,F,7,9,54,104,56,55,285
1611356400,M,8,6,49,73,42,25,203
1611442800,A,2,3,38,97,51,34,225
1611442800,F,1,1,19,54,27,24,126
1611442800,M,1,2,19,43,24,10,99
1611529200,A,2,9,69,116,59,64,319
1611529200,F,1,5,40,64,32,32,174
1611529200,M,1,4,29,52,27,32,145
1611615600,A,13,16,130,315,130,100,704
1611615600,F,3,8,68,183,70,65,397
1611615600,M,10,8,62,132,60,35,307
1611702000,A,11,17,134,298,134,113,707
1611702000,F,3,8,66,162,71,72,382
1611702000,M,8,9,68,136,63,41,325
1611788400,A,12,40,118,281,135,95,681
1611788400,F,8,19,59,164,70,70,390
1611788400,M,4,21,59,117,65,25,291
1611874800,A,5,17,109,211,98,79,519
1611874800,F,1,8,54,116,56,53,288
1611874800,M,4,9,55,95,42,26,231
1611961200,A,3,13,84,163,76,41,380
1611961200,F,2,9,40,85,37,29,202
1611961200,M,1,4,44,78,39,12,178
1612047600,A,5,7,32,53,38,20,155
1612047600,F,3,4,20,25,18,12,82
1612047600,M,2,3,12,28,20,8,73
1612134000,A,3,14,52,102,62,58,291
1612134000,F,2,6,27,60,31,33,159
1612134000,M,1,8,25,42,31,25,132
1612220400,A,11,19,112,288,129,64,623
1612220400,F,3,13,72,158,62,38,346
1612220400,M,8,6,40,130,67,26,277
1612306800,A,10,30,121,294,147,78,680
1612306800,F,6,14,56,165,70,51,362
1612306800,M,4,16,65,129,77,27,318
1612393200,A,12,16,144,214,114,71,571
1612393200,F,6,10,77,123,52,43,311
1612393200,M,6,6,67,91,62,28,260
1612479600,A,11,23,74,190,120,66,484
1612479600,F,4,12,29,111,58,33,247
1612479600,M,7,11,45,79,62,33,237
1612566000,A,4,21,59,119,66,43,312
1612566000,F,2,12,31,63,28,26,162
1612566000,M,2,9,28,56,38,17,150
1612652400,A,4,4,25,35,22,11,101
1612652400,F,2,1,9,17,13,8,50
1612652400,M,2,3,16,18,9,3,51
1612738800,A,5,7,46,100,50,31,239
1612738800,F,1,2,25,50,22,21,121
1612738800,M,4,5,21,50,28,10,118
1612825200,A,1,8,52,109,56,44,270
1612825200,F,1,4,32,61,27,29,154
1612825200,M,0,4,20,48,29,15,116
1612911600,A,1,18,61,139,77,37,333
1612911600,F,0,11,32,75,41,23,182
1612911600,M,1,7,29,64,36,14,151
1612998000,A,7,22,135,220,92,63,539
1612998000,F,3,13,72,108,47,40,283
1612998000,M,4,9,63,112,44,23,255
1613084400,A,8,18,93,181,73,56,429
1613084400,F,6,8,51,94,26,40,225
1613084400,M,2,10,42,87,47,16,204
1613170800,A,5,11,59,105,59,38,277
1613170800,F,3,6,26,58,26,20,139
1613170800,M,2,5,33,47,33,18,138
1613257200,A,4,12,30,54,33,17,150
1613257200,F,1,8,13,28,17,12,79
1613257200,M,3,4,17,26,16,5,71
1613343600,A,4,8,48,88,65,49,262
1613343600,F,2,6,24,46,37,35,150
1613343600,M,2,2,24,42,28,14,112
1613430000,A,10,16,93,211,119,63,512
1613430000,F,3,10,54,123,56,36,282
1613430000,M,7,6,39,88,63,27,230
1613516400,A,12,14,113,208,126,89,562
1613516400,F,8,5,62,123,64,62,324
1613516400,M,4,9,51,85,62,27,238
1613602800,A,11,23,98,202,110,56,500
1613602800,F,4,14,52,95,52,34,251
1613602800,M,7,9,46,107,58,22,249
1613689200,A,5,22,93,170,76,59,425
1613689200,F,2,9,47,87,38,43,226
1613689200,M,3,13,46,83,38,16,199
1613775600,A,10,11,87,129,52,40,329
1613775600,F,5,5,42,64,29,25,170
1613775600,M,5,6,45,65,23,15,159
1613862000,A,1,2,33,73,32,20,161
1613862000,F,1,1,18,41,17,8,86
1613862000,M,0,1,15,32,15,12,75
1613948400,A,4,10,53,86,35,28,216
1613948400,F,1,4,37,42,20,22,126
1613948400,M,3,6,16,44,15,6,90
1614034800,A,16,14,81,218,108,60,497
1614034800,F,11,8,45,126,67,36,293
1614034800,M,5,6,36,92,41,24,204
1614121200,A,15,25,121,229,137,96,623
1614121200,F,10,17,59,149,58,69,362
1614121200,M,5,8,62,80,79,27,261
1614207600,A,11,32,112,185,100,54,494
1614207600,F,6,16,60,101,49,30,262
1614207600,M,5,16,52,84,51,24,232
1614294000,A,9,24,96,165,129,49,472
1614294000,F,7,13,57,100,59,28,264
1614294000,M,2,11,39,65,70,21,208
1614380400,A,11,23,59,142,74,27,336
1614380400,F,8,16,27,77,34,20,182
1614380400,M,3,7,32,65,40,7,154
1614466800,A,7,11,30,50,21,8,127
1614466800,F,2,6,16,25,11,5,65
1614466800,M,5,5,14,25,10,3,62
1614553200,A,8,16,47,75,50,32,228
1614553200,F,3,8,21,42,25,20,119
1614553200,M,5,8,26,33,25,12,109
1614639600,A,19,48,95,210,87,39,498
1614639600,F,6,21,50,116,38,27,258
1614639600,M,13,27,45,94,49,12,240
1614726000,A,28,83,151,251,131,41,685
1614726000,F,16,34,84,136,66,28,364
1614726000,M,12,49,67,115,65,13,321
1614812400,A,35,44,95,219,84,35,512
1614812400,F,19,21,50,129,47,26,292
1614812400,M,16,23,45,89,37,9,219
1614898800,A,32,38,87,172,91,40,460
1614898800,F,16,15,48,92,49,27,247
1614898800,M,16,23,39,80,42,13,213
1614985200,A,25,54,83,159,70,27,418
1614985200,F,13,30,40,86,44,18,231
1614985200,M,12,24,43,73,26,9,187
1615071600,A,13,15,31,55,27,17,158
1615071600,F,5,8,17,29,12,11,82
1615071600,M,8,7,14,26,15,6,76
1615158000,A,5,17,50,104,39,36,251
1615158000,F,1,3,31,51,22,17,125
1615158000,M,4,14,19,53,17,19,126
1615244400,A,29,52,109,219,106,42,557
1615244400,F,17,24,59,122,57,28,307
1615244400,M,12,28,50,97,49,14,250
1615330800,A,34,63,155,316,128,61,757
1615330800,F,15,34,82,170,68,43,412
1615330800,M,19,29,73,146,60,18,345
1615417200,A,48,82,146,265,106,55,702
1615417200,F,28,44,82,162,54,40,410
1615417200,M,20,38,64,103,52,15,292
1615503600,A,20,60,130,229,94,35,568
1615503600,F,10,22,71,123,48,23,297
1615503600,M,10,38,59,106,46,12,271
1615590000,A,25,44,131,223,102,34,559
1615590000,F,15,22,70,114,52,18,291
1615590000,M,10,22,61,109,50,16,268
1615676400,A,14,22,57,100,51,18,262
1615676400,F,8,10,36,53,28,11,146
1615676400,M,6,12,21,47,23,7,116
1615762800,A,5,25,56,149,70,34,339
1615762800,F,2,9,27,67,37,17,159
1615762800,M,3,16,29,82,33,17,180
1615849200,A,38,61,187,315,144,48,793
1615849200,F,23,33,103,165,80,26,430
1615849200,M,15,28,84,150,64,22,363
1615935600,A,22,61,163,360,154,54,814
1615935600,F,11,32,88,182,86,37,436
1615935600,M,11,29,75,178,68,17,378
1616022000,A,30,71,204,358,129,48,840
1616022000,F,14,36,114,183,70,28,445
1616022000,M,16,35,90,175,59,20,395
1616108400,A,40,72,197,314,155,67,845
1616108400,F,16,27,95,175,73,47,433
1616108400,M,24,45,102,139,82,20,412
1616194800,A,21,68,132,234,142,28,625
1616194800,F,9,28,65,122,68,18,310
1616194800,M,12,40,67,112,74,10,315
1616281200,A,9,22,53,127,56,19,286
1616281200,F,6,7,24,58,28,7,130
1616281200,M,3,15,29,69,28,12,156
1616367600,A,12,48,90,156,65,31,402
1616367600,F,6,19,47,88,24,14,198
1616367600,M,6,29,43,68,41,17,204
1616454000,A,27,72,174,349,190,52,864
1616454000,F,11,39,86,190,100,31,457
1616454000,M,16,33,88,159,90,21,407
1616540400,A,31,90,247,448,167,50,1033
1616540400,F,19,41,116,229,91,32,528
1616540400,M,12,49,131,219,76,18,505
1616626800,A,17,73,207,376,170,42,885
1616626800,F,8,31,108,182,78,25,432
1616626800,M,9,42,99,193,92,17,452
1616713200,A,23,77,225,382,196,43,946
1616713200,F,10,33,98,188,100,26,455
1616713200,M,13,44,127,194,96,17,491
1616799600,A,24,57,155,294,154,32,716
1616799600,F,8,27,73,149,61,22,340
1616799600,M,16,30,82,145,93,10,376
1616886000,A,5,18,68,165,81,24,361
1616886000,F,3,7,34,85,49,16,194
1616886000,M,2,11,34,80,32,8,167
1616968800,A,14,37,122,218,118,39,548
1616968800,F,6,16,49,108,71,26,276
1616968800,M,8,21,73,110,47,13,272
1617055200,A,31,59,198,408,188,40,924
1617055200,F,13,23,108,207,83,26,460
1617055200,M,18,36,90,201,105,14,464
1617141600,A,30,97,264,488,234,73,1186
1617141600,F,17,46,127,252,112,46,600
1617141600,M,13,51,137,236,122,27,586
1617228000,A,22,69,189,397,225,45,947
1617228000,F,7,32,97,193,105,30,464
1617228000,M,15,37,92,204,120,15,483
1617314400,A,13,40,145,288,151,40,677
1617314400,F,5,20,70,151,70,33,349
1617314400,M,8,20,75,137,81,7,328
1617400800,A,18,37,112,190,99,21,477
1617400800,F,6,18,56,78,46,12,216
1617400800,M,12,19,56,112,53,9,261
1617487200,A,9,15,53,102,40,9,228
1617487200,F,2,7,33,55,21,6,124
1617487200,M,7,8,20,47,19,3,104
1617573600,A,7,14,47,109,59,18,254
1617573600,F,4,6,20,56,26,12,124
1617573600,M,3,8,27,53,33,6,130
1617660000,A,17,22,90,223,100,33,485
1617660000,F,8,11,43,115,49,18,244
1617660000,M,9,11,47,108,51,15,241
1617746400,A,26,67,255,469,238,45,1100
1617746400,F,15,38,119,230,122,26,550
1617746400,M,11,29,136,239,116,19,550
1617832800,A,27,71,255,469,261,48,1131
1617832800,F,15,38,127,247,133,31,591
1617832800,M,12,32,128,222,128,17,539
1617919200,A,24,49,242,409,228,54,1006
1617919200,F,10,26,123,206,113,29,507
1617919200,M,14,23,119,203,115,25,499
1618005600,A,30,43,168,279,137,29,686
1618005600,F,10,24,75,140,74,21,344
1618005600,M,20,19,93,139,63,8,342
1618092000,A,4,15,72,134,53,20,298
1618092000,F,3,6,37,87,30,13,176
1618092000,M,1,9,35,47,23,7,122
1618178400,A,9,32,112,174,101,37,465
1618178400,F,4,10,60,88,49,23,234
1618178400,M,5,22,52,86,52,14,231
1618264800,A,28,84,230,420,202,46,1010
1618264800,F,17,42,127,206,93,27,512
1618264800,M,11,42,103,214,109,19,498
1618351200,A,25,69,304,514,263,68,1243
1618351200,F,12,35,145,288,135,37,652
1618351200,M,13,34,159,226,128,31,591
1618437600,A,26,84,266,380,186,64,1006
1618437600,F,14,43,126,204,101,39,527
1618437600,M,12,41,140,176,85,25,479
1618524000,A,35,55,205,344,156,40,835
1618524000,F,21,29,96,168,74,27,415
1618524000,M,14,26,109,176,82,13,420
1618610400,A,14,50,142,200,108,24,538
1618610400,F,6,21,70,108,55,15,275
1618610400,M,8,29,72,92,53,9,263
1618696800,A,6,27,68,120,54,9,284
1618696800,F,5,15,29,55,31,5,140
1618696800,M,1,12,39,65,23,4,144
1618783200,A,17,38,111,176,98,38,478
1618783200,F,6,19,57,97,54,24,257
1618783200,M,11,19,54,79,44,14,221
1618869600,A,27,69,242,401,213,34,986
1618869600,F,14,30,111,199,107,20,481
1618869600,M,13,39,130,202,106,14,504
1618956000,A,14,73,261,418,201,39,1006
1618956000,F,10,40,135,210,91,25,511
1618956000,M,4,33,126,208,110,14,495
1619042400,A,24,71,224,365,150,40,874
1619042400,F,8,33,118,178,78,25,440
1619042400,M,16,38,106,187,72,15,434
1619128800,A,20,69,174,323,148,35,769
1619128800,F,10,38,96,162,77,24,407
1619128800,M,10,31,78,161,71,11,362
1619215200,A,32,71,137,252,120,34,646
1619215200,F,19,33,74,135,64,17,342
1619215200,M,12,38,63,117,56,17,303
1619301600,A,18,21,77,106,54,14,290
1619301600,F,11,4,42,63,30,9,159
1619301600,M,7,17,35,43,24,5,131
1619388000,A,13,44,112,151,84,17,421
1619388000,F,5,15,48,76,44,14,202
1619388000,M,8,29,64,75,40,3,219
1619474400,A,35,82,195,399,180,24,915
1619474400,F,15,44,103,192,88,15,457
1619474400,M,20,38,92,207,92,9,458
1619560800,A,21,60,218,388,163,24,874
1619560800,F,13,30,95,199,78,17,432
1619560800,M,8,30,123,189,85,7,442
1619647200,A,20,66,195,348,166,44,839
1619647200,F,10,29,94,178,87,25,423
1619647200,M,10,37,101,170,79,19,416
1619733600,A,37,69,211,362,143,32,854
1619733600,F,18,31,110,189,71,16,435
1619733600,M,19,38,101,173,72,16,419
1619820000,A,17,57,137,191,97,25,524
1619820000,F,3,24,83,89,51,18,268
1619820000,M,14,33,53,102,46,7,255
1619906400,A,9,29,71,114,54,12,289
1619906400,F,4,17,38,54,22,8,143
1619906400,M,5,12,33,60,32,4,146
1619992800,A,7,28,85,161,86,23,390
1619992800,F,4,14,40,82,38,13,191
1619992800,M,3,13,45,79,48,10,198
1620079200,A,24,57,201,355,143,26,806
1620079200,F,12,26,87,184,78,16,403
1620079200,M,12,31,114,171,65,10,403
1620165600,A,20,69,194,322,144,37,786
1620165600,F,10,29,95,154,81,23,392
1620165600,M,10,40,99,168,63,14,394
1620252000,A,13,56,157,275,131,38,670
1620252000,F,6,27,73,141,64,27,338
1620252000,M,7,29,83,134,67,11,331
1620338400,A,17,63,155,227,118,30,610
1620338400,F,9,36,81,129,60,20,335
1620338400,M,8,27,74,98,58,10,275
1620424800,A,17,50,91,202,82,18,460
1620424800,F,7,22,40,116,36,11,232
1620424800,M,10,28,51,86,46,7,228
1620511200,A,6,18,60,87,35,13,219
1620511200,F,3,10,25,41,17,5,101
1620511200,M,3,8,35,46,18,8,118
1620597600,A,10,48,63,125,68,15,329
1620597600,F,3,24,32,55,28,10,152
1620597600,M,7,24,31,70,40,5,177
1620684000,A,31,58,134,256,122,29,630
1620684000,F,14,29,69,140,63,20,335
1620684000,M,17,29,65,116,59,9,295
1620770400,A,17,64,162,283,123,27,676
1620770400,F,11,29,71,128,67,17,323
1620770400,M,6,35,91,155,56,10,353
1620856800,A,13,24,85,125,63,13,323
1620856800,F,3,14,42,60,31,6,156
1620856800,M,10,10,43,65,32,7,167
1620943200,A,6,45,64,124,52,16,307
1620943200,F,6,22,30,66,24,10,158
1620943200,M,0,23,34,58,28,6,149
1621029600,A,5,21,60,128,64,10,288
1621029600,F,1,10,29,67,36,9,152
1621029600,M,4,11,31,61,28,1,136
1621116000,A,10,19,41,54,24,6,154
1621116000,F,6,12,14,27,9,5,73
1621116000,M,4,7,27,27,15,1,81
1621202400,A,9,20,53,114,51,15,262
1621202400,F,5,10,21,52,29,9,126
1621202400,M,4,10,32,62,22,6,136
1621288800,A,20,57,114,205,100,23,519
1621288800,F,12,35,55,100,51,16,269
1621288800,M,8,22,59,105,49,7,250
1621375200,A,18,44,102,210,94,24,492
1621375200,F,8,23,45,93,47,14,230
1621375200,M,10,21,57,117,47,10,262
1621461600,A,14,25,74,115,57,8,293
1621461600,F,7,16,40,62,24,5,154
1621461600,M,7,9,34,53,33,3,139
1621548000,A,8,32,70,101,59,12,282
1621548000,F,4,15,29,50,30,8,136
1621548000,M,4,17,41,51,29,4,146
1621634400,A,11,12,55,69,42,6,195
1621634400,F,9,6,31,37,15,5,103
1621634400,M,2,6,24,32,27,1,92
1621720800,A,5,12,9,23,10,4,63
1621720800,F,2,9,5,10,5,2,33
1621720800,M,3,3,4,13,5,2,30
1621807200,A,2,4,14,19,12,3,54
1621807200,F,0,1,7,8,4,3,23
1621807200,M,2,3,7,11,8,0,31
1621893600,A,9,13,42,68,38,7,177
1621893600,F,5,6,24,31,21,3,90
1621893600,M,4,7,18,37,17,4,87
1621980000,A,6,15,77,99,61,13,271
1621980000,F,4,4,37,48,26,7,126
1621980000,M,2,11,40,51,35,6,145
1622066400,A,11,15,44,73,42,19,204
1622066400,F,4,7,18,39,20,13,101
1622066400,M,7,8,26,34,22,6,103
1622152800,A,5,24,49,52,28,2,160
1622152800,F,2,8,31,23,12,0,76
1622152800,M,3,16,18,29,16,2,84
1622239200,A,0,12,27,39,26,5,109
1622239200,F,0,8,13,18,13,3,55
1622239200,M,0,4,14,21,13,2,54
1622325600,A,1,3,7,15,6,0,32
1622325600,F,0,2,3,11,2,0,18
1622325600,M,1,1,4,4,4,0,14
1622412000,A,0,4,39,21,23,3,90
1622412000,F,0,2,20,12,13,2,49
1622412000,M,0,2,19,9,10,1,41
1622498400,A,4,16,41,45,38,6,150
1622498400,F,3,10,19,24,21,4,81
1622498400,M,1,6,22,21,17,2,69
1622584800,A,4,8,18,45,16,9,100
1622584800,F,0,3,9,33,11,6,62
1622584800,M,4,5,9,12,5,3,38
1622671200,A,3,11,22,31,14,6,87
1622671200,F,1,4,11,20,9,3,48
1622671200,M,2,7,11,11,5,3,39
1622757600,A,5,12,23,42,14,8,104
1622757600,F,1,8,14,22,9,5,59
1622757600,M,4,4,9,19,5,3,44
1622844000,A,2,11,18,33,11,8,83
1622844000,F,1,4,11,16,8,5,45
1622844000,M,1,7,7,17,3,3,38
1622930400,A,1,0,3,7,2,1,14
1622930400,F,1,0,1,5,1,1,9
1622930400,M,0,0,2,2,1,0,5
1623016800,A,2,7,13,19,8,7,56
1623016800,F,1,3,9,11,3,5,32
1623016800,M,1,4,4,8,5,2,24
1623103200,A,6,4,12,28,12,13,75
1623103200,F,5,2,5,12,6,9,39
1623103200,M,1,2,7,16,6,4,36
1623189600,A,3,8,15,24,15,3,68
1623189600,F,1,3,7,11,10,2,34
1623189600,M,2,5,8,13,5,1,34
1623276000,A,2,5,16,16,7,1,47
1623276000,F,1,2,9,11,3,0,26
1623276000,M,1,3,7,5,4,1,21
1623362400,A,1,9,18,14,9,7,58
1623362400,F,1,2,12,6,5,5,31
1623362400,M,0,7,6,8,4,2,27
1623448800,A,1,4,8,12,5,0,30
1623448800,F,1,2,2,4,4,0,13
1623448800,M,0,2,6,8,1,0,17
1623535200,A,0,0,0,1,2,0,3
1623535200,F,0,0,0,1,1,0,2
1623535200,M,0,0,0,0,1,0,1
1623621600,A,1,2,8,8,1,0,20
1623621600,F,1,0,5,3,0,0,9
1623621600,M,0,2,3,5,1,0,11
1623708000,A,3,2,10,18,8,2,43
1623708000,F,1,2,7,11,3,1,25
1623708000,M,2,0,3,7,5,1,18
1623794400,A,2,4,9,16,5,4,40
1623794400,F,2,3,3,8,4,2,22
1623794400,M,0,1,6,8,1,2,18
1623880800,A,0,3,4,5,4,0,16
1623880800,F,0,2,3,5,3,0,13
1623880800,M,0,1,1,0,1,0,3
1623967200,A,3,5,5,9,3,0,25
1623967200,F,3,3,3,3,1,0,13
1623967200,M,0,2,2,6,2,0,12
1624053600,A,1,4,2,4,3,0,14
1624053600,F,0,2,2,2,2,0,8
1624053600,M,1,2,0,2,1,0,6
1624140000,A,0,0,2,2,0,0,4
1624140000,F,0,0,1,1,0,0,2
1624140000,M,0,0,1,1,0,0,2
1624226400,A,1,4,5,6,4,0,20
1624226400,F,0,1,3,3,4,0,11
1624226400,M,1,3,2,3,0,0,9
1624312800,A,1,3,2,8,4,2,20
1624312800,F,1,2,1,3,2,0,9
1624312800,M,0,1,1,5,2,2,11
1624399200,A,1,1,6,4,2,1,15
1624399200,F,1,1,4,3,0,1,10
1624399200,M,0,0,2,1,2,0,5
1624485600,A,0,2,2,6,3,0,13
1624485600,F,0,1,1,5,0,0,7
1624485600,M,0,1,1,1,3,0,6
1624572000,A,0,3,1,3,0,2,9
1624572000,F,0,0,0,0,0,1,1
1624572000,M,0,3,1,3,0,1,8
1624658400,A,0,1,0,0,2,0,3
1624658400,F,0,1,0,0,0,0,1
1624658400,M,0,0,0,0,2,0,2
1624744800,A,0,0,0,1,0,0,1
1624744800,F,0,0,0,0,0,0,0
1624744800,M,0,0,0,1,0,0,1
1624831200,A,0,0,6,3,1,0,10
1624831200,F,0,0,1,1,0,0,2
1624831200,M,0,0,5,2,1,0,8
1624917600,A,0,5,4,12,1,1,23
1624917600,F,0,1,2,5,0,0,8
1624917600,M,0,4,2,7,1,1,15
1625004000,A,2,1,9,4,2,0,18
1625004000,F,1,0,3,1,2,0,7
1625004000,M,1,1,6,3,0,0,11
1625090400,A,0,1,9,6,0,2,18
1625090400,F,0,1,2,0,0,1,4
1625090400,M,0,0,7,6,0,1,14
1625176800,A,0,4,2,1,2,0,9
1625176800,F,0,2,0,1,2,0,5
1625176800,M,0,2,2,0,0,0,4
1625263200,A,0,1,1,1,0,0,3
1625263200,F,0,0,0,0,0,0,0
1625263200,M,0,1,1,1,0,0,3
1625349600,A,0,1,1,0,0,0,2
1625349600,F,0,1,0,0,0,0,1
1625349600,M,0,0,1,0,0,0,1
1625436000,A,0,0,4,2,0,2,8
1625436000,F,0,0,3,0,0,2,5
1625436000,M,0,0,1,2,0,0,3
1625522400,A,0,3,5,6,0,1,15
1625522400,F,0,0,4,2,0,0,6
1625522400,M,0,3,1,4,0,1,9
1625608800,A,0,1,0,2,1,0,4
1625608800,F,0,1,0,1,0,0,2
1625608800,M,0,0,0,1,1,0,2
1625695200,A,0,6,1,5,2,1,15
1625695200,F,0,4,0,1,1,1,7
1625695200,M,0,2,1,4,1,0,8
1625781600,A,0,0,0,3,0,0,3
1625781600,F,0,0,0,2,0,0,2
1625781600,M,0,0,0,1,0,0,1
1625868000,A,0,2,1,1,0,0,4
1625868000,F,0,0,1,1,0,0,2
1625868000,M,0,2,0,0,0,0,2
1625954400,A,0,1,0,2,1,0,4
1625954400,F,0,0,0,1,1,0,2
1625954400,M,0,1,0,1,0,0,2
1626040800,A,1,2,2,4,1,1,11
1626040800,F,0,1,1,1,1,0,4
1626040800,M,1,1,1,3,0,1,7
1626127200,A,1,9,4,11,0,0,25
1626127200,F,1,4,2,5,0,0,12
1626127200,M,0,5,2,6,0,0,13
1626213600,A,1,3,3,6,1,1,15
1626213600,F,0,2,0,4,1,0,7
1626213600,M,1,1,3,2,0,1,8
1626300000,A,0,2,7,4,1,0,14
1626300000,F,0,1,4,2,1,0,8
1626300000,M,0,1,3,2,0,0,6
1626386400,A,1,2,5,6,2,1,17
1626386400,F,1,2,2,2,0,1,8
1626386400,M,0,0,3,4,2,0,9
1626472800,A,0,3,0,0,2,0,5
1626472800,F,0,2,0,0,1,0,3
1626472800,M,0,1,0,0,1,0,2
1626559200,A,0,0,0,3,0,0,3
1626559200,F,0,0,0,2,0,0,2
1626559200,M,0,0,0,1,0,0,1
1626645600,A,0,6,8,5,4,0,23
1626645600,F,0,4,5,2,4,0,15
1626645600,M,0,2,3,3,0,0,8
1626732000,A,0,12,8,7,3,0,30
1626732000,F,0,5,2,3,2,0,12
1626732000,M,0,7,6,4,1,0,18
1626818400,A,2,2,2,3,3,3,15
1626818400,F,1,0,0,3,0,3,7
1626818400,M,1,2,2,0,3,0,8
1626904800,A,0,6,3,5,4,1,19
1626904800,F,0,3,1,4,0,1,9
1626904800,M,0,3,2,1,4,0,10
1626991200,A,0,6,11,7,3,2,29
1626991200,F,0,4,5,4,1,1,15
1626991200,M,0,2,6,3,2,1,14
1627077600,A,0,1,4,8,1,0,14
1627077600,F,0,0,1,4,1,0,6
1627077600,M,0,1,3,4,0,0,8
1627164000,A,0,0,0,1,0,0,1
1627164000,F,0,0,0,1,0,0,1
1627164000,M,0,0,0,0,0,0,0
1627250400,A,1,1,8,6,2,1,19
1627250400,F,1,0,5,5,2,0,13
1627250400,M,0,1,3,1,0,1,6
1627336800,A,1,2,10,8,0,1,22
1627336800,F,0,2,6,4,0,1,13
1627336800,M,1,0,4,4,0,0,9
1627423200,A,0,6,3,7,1,0,17
1627423200,F,0,3,2,4,1,0,10
1627423200,M,0,3,1,3,0,0,7
1627509600,A,2,6,5,9,1,1,24
1627509600,F,2,3,3,4,0,1,13
1627509600,M,0,3,2,5,1,0,11
1627596000,A,1,5,5,3,3,0,17
1627596000,F,0,4,4,1,2,0,11
1627596000,M,1,1,1,2,1,0,6
1627682400,A,0,7,11,5,0,0,23
1627682400,F,0,3,8,4,0,0,15
1627682400,M,0,4,3,1,0,0,8
1627768800,A,0,1,3,0,0,0,4
1627768800,F,0,0,2,0,0,0,2
1627768800,M,0,1,1,0,0,0,2
1627855200,A,0,7,11,8,2,3,31
1627855200,F,0,1,5,3,2,3,14
1627855200,M,0,6,6,5,0,0,17
1627941600,A,0,4,17,9,0,0,30
1627941600,F,0,1,8,4,0,0,13
1627941600,M,0,3,9,5,0,0,17
1628028000,A,0,0,15,4,2,1,22
1628028000,F,0,0,7,2,1,0,10
1628028000,M,0,0,8,2,1,1,12
1628114400,A,0,2,9,5,2,1,19
1628114400,F,0,1,4,5,2,1,13
1628114400,M,0,1,5,0,0,0,6
1628200800,A,2,7,11,7,2,2,31
1628200800,F,1,3,5,5,1,1,16
1628200800,M,1,4,6,2,1,1,15
1628287200,A,0,0,5,1,2,1,9
1628287200,F,0,0,2,1,2,1,6
1628287200,M,0,0,3,0,0,0,3
1628373600,A,0,1,3,1,3,0,8
1628373600,F,0,0,1,0,1,0,2
1628373600,M,0,1,2,1,2,0,6
1628460000,A,3,5,7,4,4,0,23
1628460000,F,2,2,3,1,2,0,10
1628460000,M,1,3,4,3,2,0,13
1628546400,A,0,4,14,12,5,1,36
1628546400,F,0,2,9,5,4,0,20
1628546400,M,0,2,5,7,1,1,16
1628632800,A,0,1,12,13,5,1,32
1628632800,F,0,1,4,3,1,1,10
1628632800,M,0,0,8,10,4,0,22
1628719200,A,0,4,16,7,3,2,32
1628719200,F,0,3,7,5,2,1,18
1628719200,M,0,1,9,2,1,1,14
1628805600,A,1,4,19,9,2,0,35
1628805600,F,1,1,12,6,1,0,21
1628805600,M,0,3,7,3,1,0,14
1628892000,A,1,1,4,5,1,1,13
1628892000,F,0,1,2,3,1,1,8
1628892000,M,1,0,2,2,0,0,5
1628978400,A,0,0,1,1,3,0,5
1628978400,F,0,0,1,0,1,0,2
1628978400,M,0,0,0,1,2,0,3
1629064800,A,3,11,16,11,1,1,43
1629064800,F,1,5,9,1,1,0,17
1629064800,M,2,6,7,10,0,1,26
1629151200,A,2,10,33,35,8,0,88
1629151200,F,0,3,19,21,3,0,46
1629151200,M,2,7,14,14,5,0,42
1629237600,A,1,10,17,16,4,2,50
1629237600,F,0,7,8,6,2,0,23
1629237600,M,1,3,9,10,2,2,27
1629324000,A,2,4,21,16,10,1,54
1629324000,F,1,1,12,5,5,1,25
1629324000,M,1,3,9,11,5,0,29
1629410400,A,3,4,12,16,4,0,39
1629410400,F,1,0,6,9,2,0,18
1629410400,M,2,4,6,7,2,0,21
1629496800,A,1,6,13,11,2,0,33
1629496800,F,0,1,6,3,0,0,10
1629496800,M,1,5,7,8,2,0,23
1629583200,A,0,4,3,3,0,0,10
1629583200,F,0,1,2,2,0,0,5
1629583200,M,0,3,1,1,0,0,5
1629669600,A,1,5,17,12,6,0,41
1629669600,F,1,3,10,7,2,0,23
1629669600,M,0,2,7,5,4,0,18
1629756000,A,3,16,46,37,5,3,110
1629756000,F,1,7,23,15,3,2,51
1629756000,M,2,9,23,22,2,1,59
1629842400,A,3,14,43,29,6,0,95
1629842400,F,2,8,16,18,3,0,47
1629842400,M,1,6,27,11,3,0,48
1629928800,A,12,12,24,29,9,4,90
1629928800,F,5,9,16,16,6,4,56
1629928800,M,7,3,8,13,3,0,34
1630015200,A,7,19,31,34,9,0,100
1630015200,F,6,9,13,18,6,0,52
1630015200,M,1,10,18,16,3,0,48
1630101600,A,1,6,15,15,9,1,47
1630101600,F,0,2,7,7,5,1,22
1630101600,M,1,4,8,8,4,0,25
1630188000,A,0,0,2,4,0,0,6
1630188000,F,0,0,0,2,0,0,2
1630188000,M,0,0,2,2,0,0,4
1630274400,A,3,11,21,33,8,3,79
1630274400,F,0,7,12,18,4,1,42
1630274400,M,3,4,9,15,4,2,37
1630360800,A,10,17,39,50,8,4,128
1630360800,F,2,9,17,26,4,2,60
1630360800,M,8,8,22,24,4,2,68
1630447200,A,7,16,39,49,22,6,139
1630447200,F,3,7,19,24,14,3,70
1630447200,M,4,9,20,25,8,3,69
1630533600,A,5,21,32,30,13,4,105
1630533600,F,1,8,15,13,8,3,48
1630533600,M,4,13,17,17,5,1,57
1630620000,A,7,18,47,63,11,6,152
1630620000,F,5,6,26,34,5,4,80
1630620000,M,2,12,21,29,6,2,72
1630706400,A,9,11,22,29,8,2,81
1630706400,F,6,4,13,14,3,1,41
1630706400,M,3,7,9,15,5,1,40
1630792800,A,0,5,13,12,8,0,38
1630792800,F,0,3,6,6,5,0,20
1630792800,M,0,2,7,6,3,0,18
1630879200,A,3,13,43,45,10,3,117
1630879200,F,2,5,20,26,7,3,63
1630879200,M,1,8,23,19,3,0,54
1630965600,A,10,32,72,92,22,6,234
1630965600,F,4,10,35,50,12,3,114
1630965600,M,6,22,37,42,10,3,120
1631052000,A,8,29,60,79,22,6,204
1631052000,F,4,14,19,43,10,6,96
1631052000,M,4,15,41,35,12,0,107
1631138400,A,9,25,58,57,15,3,167
1631138400,F,7,10,28,24,9,2,80
1631138400,M,2,14,30,33,6,1,86
1631224800,A,4,22,46,65,24,2,163
1631224800,F,4,8,24,28,18,2,84
1631224800,M,0,14,22,37,6,0,79
1631311200,A,4,16,30,29,15,0,94
1631311200,F,1,8,18,17,10,0,54
1631311200,M,3,8,12,12,5,0,40
1631397600,A,0,7,3,16,4,2,32
1631397600,F,0,4,1,8,2,1,16
1631397600,M,0,3,2,8,2,1,16
1631484000,A,11,21,44,55,14,7,152
1631484000,F,6,9,20,30,9,6,80
1631484000,M,5,12,24,25,5,1,72
1631570400,A,13,50,63,91,34,4,255
1631570400,F,8,26,30,48,17,2,131
1631570400,M,5,24,33,43,17,2,124
1631656800,A,12,34,65,60,18,5,194
1631656800,F,4,17,31,30,10,3,95
1631656800,M,8,17,34,30,8,2,99
1631743200,A,13,51,63,75,27,4,233
1631743200,F,5,24,21,32,14,3,99
1631743200,M,8,27,42,43,13,1,134
1631829600,A,11,54,50,46,7,2,170
1631829600,F,2,19,30,24,5,1,81
1631829600,M,9,35,20,22,2,1,89
1631916000,A,10,47,49,52,15,2,175
1631916000,F,6,24,25,28,7,2,92
1631916000,M,4,23,24,24,8,0,83
1632002400,A,4,13,10,12,0,3,42
1632002400,F,1,7,5,7,0,0,20
1632002400,M,3,6,5,5,0,3,22
1632088800,A,1,7,3,5,3,2,21
1632088800,F,1,3,0,1,2,2,9
1632088800,M,0,4,3,4,1,0,12
1632175200,A,1,25,33,53,11,3,126
1632175200,F,0,11,15,27,7,2,62
1632175200,M,1,14,18,26,4,1,64
1632261600,A,12,81,71,109,30,11,314
1632261600,F,7,37,39,61,21,8,173
1632261600,M,5,44,32,48,9,3,141
1632348000,A,11,70,69,109,32,10,301
1632348000,F,2,33,36,62,15,6,154
1632348000,M,9,37,33,47,17,4,147
1632434400,A,10,47,76,71,17,3,224
1632434400,F,4,24,40,42,6,1,117
1632434400,M,6,23,36,29,11,2,107
1632520800,A,7,44,38,65,14,7,175
1632520800,F,2,18,18,30,7,6,81
1632520800,M,5,26,20,35,7,1,94
1632607200,A,0,8,13,15,2,3,41
1632607200,F,0,3,5,9,2,1,20
1632607200,M,0,5,8,6,0,2,21
1632693600,A,7,35,51,70,21,5,189
1632693600,F,6,12,28,35,12,1,94
1632693600,M,1,23,23,35,9,4,95
1632780000,A,3,60,84,121,32,18,318
1632780000,F,1,28,42,64,16,13,164
1632780000,M,2,32,42,57,16,5,154
1632866400,A,14,88,91,121,35,26,375
1632866400,F,3,45,52,72,21,18,211
1632866400,M,11,43,39,49,14,8,164
1632952800,A,9,73,80,108,22,9,301
1632952800,F,5,37,41,65,9,4,161
1632952800,M,4,36,39,43,13,5,140
1633039200,A,5,51,59,76,28,28,247
1633039200,F,1,25,30,45,21,23,145
1633039200,M,4,26,29,31,7,5,102
1633125600,A,6,40,41,63,18,4,172
1633125600,F,2,20,21,35,11,2,91
1633125600,M,4,20,20,28,7,2,81
1633212000,A,2,17,12,29,7,6,73
1633212000,F,1,8,6,18,2,2,37
1633212000,M,1,8,6,11,5,4,35
1633298400,A,10,56,55,75,22,9,227
1633298400,F,5,28,29,45,14,6,127
1633298400,M,5,28,26,30,8,3,100
1633384800,A,8,94,83,138,45,14,382
1633384800,F,6,48,44,82,21,8,209
1633384800,M,2,46,39,56,24,6,173
1633471200,A,11,114,106,134,31,18,414
1633471200,F,3,50,46,63,15,10,187
1633471200,M,8,64,60,71,16,8,227
1633557600,A,13,129,99,124,40,19,424
1633557600,F,4,67,46,62,12,12,203
1633557600,M,9,62,53,62,28,7,221
1633644000,A,14,76,95,114,34,18,351
1633644000,F,6,41,54,67,17,8,193
1633644000,M,8,35,41,47,17,10,158
1633730400,A,4,73,62,85,26,7,257
1633730400,F,2,43,34,45,18,4,146
1633730400,M,2,30,28,40,8,3,111
1633816800,A,4,13,10,20,12,6,65
1633816800,F,3,9,8,11,4,3,38
1633816800,M,1,4,2,9,8,3,27
1633903200,A,4,66,51,89,27,15,252
1633903200,F,0,40,32,39,14,9,134
1633903200,M,4,26,19,50,13,6,118
1633989600,A,17,120,130,175,70,38,550
1633989600,F,8,70,67,105,38,28,316
1633989600,M,9,50,63,70,32,10,234
1634076000,A,11,138,133,212,64,34,592
1634076000,F,7,74,63,117,35,24,320
1634076000,M,4,64,69,95,29,10,271
1634162400,A,16,137,164,190,57,33,597
1634162400,F,12,74,82,115,27,22,332
1634162400,M,4,63,81,75,30,11,264
1634248800,A,10,106,142,165,57,28,508
1634248800,F,4,50,70,98,34,17,273
1634248800,M,6,56,72,67,23,11,235
1634335200,A,7,88,88,117,50,30,380
1634335200,F,4,48,48,64,25,20,209
1634335200,M,3,40,40,53,25,10,171
1634421600,A,5,42,32,50,19,7,155
1634421600,F,3,27,17,32,11,3,93
1634421600,M,2,15,15,18,8,4,62
1634508000,A,9,109,110,152,57,51,488
1634508000,F,4,56,59,86,30,39,274
1634508000,M,5,53,51,66,27,12,214
1634594400,A,19,198,211,310,83,54,875
1634594400,F,12,104,110,172,45,41,484
1634594400,M,7,94,101,138,38,13,391
1634680800,A,23,178,227,305,79,49,861
1634680800,F,11,79,109,167,43,31,440
1634680800,M,12,99,118,138,36,17,420
1634767200,A,21,205,229,314,103,82,954
1634767200,F,11,101,123,166,57,63,521
1634767200,M,9,104,106,148,46,19,432
1634853600,A,20,176,208,296,102,43,845
1634853600,F,10,81,105,162,59,23,440
1634853600,M,10,94,103,134,43,20,404
1634940000,A,14,130,166,233,73,28,644
1634940000,F,5,69,82,116,44,12,328
1634940000,M,9,60,84,117,29,16,315
1635026400,A,4,56,53,83,32,11,239
1635026400,F,4,26,26,52,16,8,132
1635026400,M,0,28,26,31,16,3,104
1635112800,A,9,161,183,321,80,54,808
1635112800,F,6,73,98,180,42,39,438
1635112800,M,3,88,85,141,38,15,370
1635199200,A,20,161,263,381,121,56,1002
1635199200,F,11,68,127,222,61,34,523
1635199200,M,9,93,136,159,60,22,479
1635285600,A,38,252,348,531,201,80,1450
1635285600,F,14,133,174,288,105,54,768
1635285600,M,23,119,173,243,96,26,680
1635372000,A,26,238,318,497,162,73,1314
1635372000,F,13,124,160,270,79,48,694
1635372000,M,13,114,158,226,83,25,619
1635458400,A,27,157,261,420,140,58,1063
1635458400,F,14,80,121,230,67,40,552
1635458400,M,13,76,140,190,73,18,510
1635544800,A,13,123,167,299,96,49,747
1635544800,F,4,61,93,163,56,26,403
1635544800,M,9,61,74,136,39,23,342
1635631200,A,4,55,66,106,39,25,295
1635631200,F,1,30,35,59,24,13,162
1635631200,M,3,24,31,47,15,12,132
1635721200,A,18,133,202,378,135,64,930
1635721200,F,11,69,112,197,73,45,507
1635721200,M,7,60,90,180,61,19,417
1635807600,A,35,224,352,741,249,87,1688
1635807600,F,13,103,183,416,132,55,902
1635807600,M,22,119,169,325,117,32,784
1635894000,A,36,255,414,808,304,123,1940
1635894000,F,18,118,223,445,161,88,1053
1635894000,M,18,135,191,363,143,35,885
1635980400,A,56,210,399,759,278,129,1831
1635980400,F,34,109,228,413,149,87,1020
1635980400,M,21,101,171,345,129,42,809
1636066800,A,28,168,306,528,245,105,1380
1636066800,F,15,79,144,283,119,71,711
1636066800,M,12,85,161,245,125,34,662
1636153200,A,30,136,239,405,170,71,1051
1636153200,F,14,62,125,214,83,49,547
1636153200,M,16,72,114,191,87,22,502
1636239600,A,13,55,98,176,87,43,472
1636239600,F,8,31,47,95,53,27,261
1636239600,M,5,24,51,81,34,16,211
1636326000,A,34,153,332,503,179,92,1293
1636326000,F,19,75,190,269,88,58,699
1636326000,M,14,77,141,234,91,34,591
1636412400,A,62,255,462,796,304,88,1967
1636412400,F,26,126,249,430,157,57,1045
1636412400,M,35,129,212,366,147,30,919
1636498800,A,75,300,531,920,374,145,2345
1636498800,F,30,153,265,468,185,94,1195
1636498800,M,45,144,265,452,189,51,1146
1636585200,A,65,288,558,947,408,153,2419
1636585200,F,28,146,283,474,219,88,1238
1636585200,M,35,140,275,471,189,65,1175
1636671600,A,49,199,431,720,334,124,1857
1636671600,F,25,87,226,393,181,82,994
1636671600,M,22,112,204,326,153,41,858
1636758000,A,24,142,285,492,204,78,1225
1636758000,F,9,70,158,259,105,56,657
1636758000,M,15,72,127,232,98,22,566
1636844400,A,21,71,163,263,126,38,682
1636844400,F,7,40,78,138,71,24,358
1636844400,M,14,30,83,125,53,14,319
1636930800,A,42,188,411,636,239,107,1623
1636930800,F,19,73,202,325,131,61,811
1636930800,M,23,112,209,309,108,46,807
1637017200,A,63,329,562,983,377,154,2468
1637017200,F,30,154,293,546,194,104,1321
1637017200,M,30,171,269,435,180,49,1134
1637103600,A,70,311,538,950,456,153,2478
1637103600,F,33,158,281,485,247,94,1298
1637103600,M,36,147,256,464,209,59,1171
1637190000,A,73,395,635,1145,468,166,2882
1637190000,F,36,177,315,584,253,99,1464
1637190000,M,36,212,318,560,215,67,1408
1637276400,A,54,371,559,895,344,165,2388
1637276400,F,14,167,291,465,169,116,1222
1637276400,M,36,193,264,423,173,47,1136
1637362800,A,45,238,407,635,234,95,1654
1637362800,F,23,119,202,319,125,69,857
1637362800,M,22,113,204,315,109,26,789
1637449200,A,25,151,260,445,161,63,1105
1637449200,F,13,79,133,238,85,41,589
1637449200,M,12,69,126,207,76,21,511
1637535600,A,75,366,614,1010,414,159,2638
1637535600,F,39,175,322,562,207,113,1418
1637535600,M,36,189,291,448,206,46,1216
1637622000,A,70,526,750,1317,486,179,3328
1637622000,F,30,256,414,687,249,118,1754
1637622000,M,38,260,333,615,236,60,1542
1637708400,A,107,626,862,1462,549,172,3778
1637708400,F,40,281,443,788,269,109,1930
1637708400,M,64,334,415,669,280,63,1825
1637794800,A,110,585,753,1364,490,155,3457
1637794800,F,55,291,406,752,240,97,1841
1637794800,M,54,284,344,612,248,57,1599
1637881200,A,95,554,745,1303,487,144,3328
1637881200,F,42,280,395,656,276,87,1736
1637881200,M,51,270,348,643,211,57,1580
1637967600,A,39,333,426,779,241,92,1910
1637967600,F,15,165,218,404,118,59,979
1637967600,M,23,162,207,373,123,33,921
1638054000,A,38,211,345,623,186,50,1453
1638054000,F,16,107,178,329,98,33,761
1638054000,M,21,99,166,293,88,17,684
1638140400,A,79,599,790,1394,513,159,3534
1638140400,F,36,277,411,680,266,104,1774
1638140400,M,42,320,376,710,247,55,1750
1638226800,A,115,720,866,1622,536,162,4021
1638226800,F,54,351,460,847,277,100,2089
1638226800,M,56,363,399,771,258,62,1909
1638313200,A,123,759,917,1633,508,188,4128
1638313200,F,56,373,456,844,258,126,2113
1638313200,M,64,381,459,786,248,61,1999
1638399600,A,108,700,953,1543,533,157,3994
1638399600,F,51,357,508,786,253,90,2045
1638399600,M,54,331,440,752,279,66,1922
1638486000,A,99,620,817,1308,428,102,3374
1638486000,F,47,321,398,689,218,59,1732
1638486000,M,51,291,416,617,209,43,1627
1638572400,A,66,399,463,864,292,61,2145
1638572400,F,37,180,212,407,156,38,1030
1638572400,M,29,216,251,457,136,23,1112
1638658800,A,40,225,286,533,194,43,1321
1638658800,F,20,124,141,269,94,27,675
1638658800,M,20,101,144,264,99,16,644
1638745200,A,69,560,681,1276,432,132,3150
1638745200,F,36,281,370,670,226,83,1666
1638745200,M,32,273,309,603,205,49,1471
1638831600,A,119,727,902,1693,503,151,4095
1638831600,F,47,348,467,892,251,103,2108
1638831600,M,72,374,434,799,248,48,1975
1638918000,A,146,770,1061,1764,605,157,4503
1638918000,F,76,406,562,927,317,100,2388
1638918000,M,68,361,496,831,288,57,2101
1639004400,A,145,748,824,1442,504,133,3796
1639004400,F,75,371,431,758,255,96,1986
1639004400,M,70,369,391,677,247,37,1791
1639090800,A,110,574,717,1224,434,122,3181
1639090800,F,51,298,365,620,230,83,1647
1639090800,M,58,271,348,604,203,39,1523
1639177200,A,77,412,485,874,291,98,2237
1639177200,F,43,184,269,429,152,63,1140
1639177200,M,34,222,215,443,139,35,1088
1639263600,A,40,201,323,514,190,49,1317
1639263600,F,20,89,171,268,101,34,683
1639263600,M,19,111,149,245,88,15,627
1639350000,A,80,453,576,990,337,135,2571
1639350000,F,39,217,316,526,178,86,1362
1639350000,M,41,233,258,463,158,47,1200
1639436400,A,138,695,801,1442,444,122,3642
1639436400,F,66,332,441,734,230,93,1896
1639436400,M,72,358,358,708,214,29,1739
1639522800,A,110,607,726,1319,428,145,3335
1639522800,F,59,294,372,680,239,91,1735
1639522800,M,49,308,353,635,189,54,1588
1639609200,A,118,548,680,1267,397,111,3121
1639609200,F,60,284,358,665,209,70,1646
1639609200,M,58,262,319,599,187,41,1466
1639695600,A,89,450,582,974,334,124,2553
1639695600,F,43,212,297,502,162,80,1296
1639695600,M,46,238,285,470,172,43,1254
1639782000,A,72,313,407,671,223,68,1754
1639782000,F,38,145,218,361,108,43,913
1639782000,M,34,166,187,310,114,25,836
1639868400,A,22,123,156,259,97,33,690
1639868400,F,10,56,92,138,52,22,370
1639868400,M,12,64,63,121,45,11,316
1639954800,A,70,315,441,747,273,88,1934
1639954800,F,44,162,239,380,131,58,1014
1639954800,M,26,150,201,367,142,30,916
1640041200,A,122,557,662,1196,385,113,3035
1640041200,F,71,279,384,594,192,72,1592
1640041200,M,50,269,276,601,193,41,1430
1640127600,A,119,457,592,1090,365,100,2723
1640127600,F,61,221,296,550,201,60,1389
1640127600,M,58,234,293,532,164,40,1321
1640214000,A,80,335,496,758,243,82,1994
1640214000,F,40,156,272,406,114,59,1047
1640214000,M,40,176,220,347,129,21,933
1640300400,A,40,212,283,499,171,53,1258
1640300400,F,18,87,147,252,88,32,624
1640300400,M,22,118,132,247,82,21,622
1640386800,A,15,75,120,147,42,14,413
1640386800,F,5,42,67,68,25,14,221
1640386800,M,9,32,53,79,17,0,190
1640473200,A,8,59,102,159,57,27,412
1640473200,F,4,28,45,69,30,20,196
1640473200,M,4,31,57,90,26,7,215
1640559600,A,25,158,236,426,132,37,1014
1640559600,F,13,80,128,224,67,24,536
1640559600,M,12,76,106,200,60,13,467
1640646000,A,65,352,503,878,244,89,2131
1640646000,F,27,185,270,442,124,60,1108
1640646000,M,38,163,231,433,120,29,1014
1640732400,A,85,321,498,904,268,92,2168
1640732400,F,44,154,267,476,159,56,1156
1640732400,M,41,164,227,427,108,35,1002
1640818800,A,59,272,391,732,214,57,1725
1640818800,F,29,127,196,372,117,43,884
1640818800,M,29,144,193,359,96,14,835
1640905200,A,29,160,268,415,153,30,1055
1640905200,F,12,85,151,227,90,23,588
1640905200,M,17,74,117,187,63,7,465
1640991600,A,10,33,84,140,42,20,329
1640991600,F,5,15,43,69,19,13,164
1640991600,M,5,18,40,71,23,7,164
1641078000,A,7,38,82,116,39,16,298
1641078000,F,4,21,32,55,23,14,149
1641078000,M,2,17,47,59,14,2,141
1641164400,A,38,169,337,534,155,42,1275
1641164400,F,20,79,187,258,75,25,644
1641164400,M,18,90,149,276,80,17,630
1641250800,A,56,231,587,815,269,64,2022
1641250800,F,26,112,286,430,153,44,1051
1641250800,M,30,113,300,385,115,20,963
1641337200,A,37,179,428,609,220,57,1530
1641337200,F,17,88,226,307,108,37,783
1641337200,M,20,87,197,301,112,20,737
1641423600,A,39,126,368,436,171,55,1195
1641423600,F,22,64,175,218,87,35,601
1641423600,M,17,61,190,218,84,20,590
1641510000,A,41,98,245,306,116,29,835
1641510000,F,21,52,118,152,67,18,428
1641510000,M,20,46,125,154,49,11,405
1641596400,A,15,72,211,225,88,24,635
1641596400,F,8,44,93,118,42,18,323
1641596400,M,7,26,117,106,46,6,308
1641682800,A,10,25,83,129,48,10,305
1641682800,F,7,12,42,66,25,5,157
1641682800,M,3,11,39,63,23,5,144
1641769200,A,16,61,168,196,65,24,530
1641769200,F,7,28,90,94,30,15,264
1641769200,M,8,33,76,100,35,9,261
1641855600,A,31,141,302,418,131,36,1059
1641855600,F,21,61,155,202,70,27,536
1641855600,M,10,77,146,215,60,9,517
1641942000,A,26,98,268,315,90,25,822
1641942000,F,15,58,123,157,56,15,424
1641942000,M,11,39,145,157,33,10,395
1642028400,A,29,95,218,282,92,24,740
1642028400,F,12,45,103,129,41,17,347
1642028400,M,17,48,113,153,51,7,389
1642114800,A,31,92,196,244,68,15,646
1642114800,F,20,43,99,126,36,12,336
1642114800,M,11,49,96,118,32,3,309
1642201200,A,17,63,116,144,37,8,385
1642201200,F,10,20,50,76,16,4,176
1642201200,M,7,39,66,65,21,4,202
1642287600,A,8,31,63,62,22,5,191
1642287600,F,5,14,37,39,9,3,107
1642287600,M,3,17,26,23,13,2,84
1642374000,A,33,94,180,255,56,28,646
1642374000,F,18,41,83,140,28,14,324
1642374000,M,14,52,97,115,28,14,320
1642460400,A,63,251,378,487,120,33,1332
1642460400,F,29,118,193,255,62,18,675
1642460400,M,32,130,181,232,58,15,648
1642546800,A,51,238,386,485,85,25,1270
1642546800,F,29,115,218,245,42,14,663
1642546800,M,22,122,168,238,43,11,604
1642633200,A,67,202,366,460,97,41,1233
1642633200,F,26,86,181,235,49,29,606
1642633200,M,41,110,183,224,47,12,617
1642719600,A,43,214,289,406,107,37,1096
1642719600,F,16,107,145,219,59,26,572
1642719600,M,27,106,140,187,48,11,519
1642806000,A,40,157,197,289,65,26,774
1642806000,F,23,68,97,150,37,16,391
1642806000,M,17,88,94,137,27,10,373
1642892400,A,3,33,58,55,17,9,175
1642892400,F,1,14,30,30,11,6,92
1642892400,M,2,19,27,25,6,3,82
1642978800,A,49,203,287,349,69,15,972
1642978800,F,19,94,159,191,36,9,508
1642978800,M,29,107,125,158,33,6,458
1643065200,A,83,414,497,757,178,37,1966
1643065200,F,50,199,265,384,84,25,1007
1643065200,M,32,206,225,371,94,12,940
1643151600,A,60,400,505,747,167,30,1909
1643151600,F,35,189,268,377,85,20,974
1643151600,M,23,205,236,367,81,10,922
1643238000,A,80,358,524,719,146,27,1854
1643238000,F,39,161,280,366,77,16,939
1643238000,M,39,194,240,350,68,11,902
1643324400,A,65,306,421,573,132,31,1528
1643324400,F,24,144,215,278,73,21,755
1643324400,M,40,158,206,295,59,10,768
1643410800,A,51,303,343,468,113,27,1305
1643410800,F,21,139,189,225,54,19,647
1643410800,M,30,162,154,243,57,8,654
1643497200,A,20,108,134,235,65,11,573
1643497200,F,10,53,64,123,32,8,290
1643497200,M,9,51,68,112,33,3,276
1643583600,A,38,296,332,449,86,17,1218
1643583600,F,20,132,167,242,44,10,615
1643583600,M,18,163,165,205,42,7,600
1643670000,A,121,750,760,1118,242,35,3026
1643670000,F,63,344,406,604,124,19,1560
1643670000,M,58,388,353,513,118,16,1446
1643756400,A,127,762,875,1242,269,62,3337
1643756400,F,73,358,462,647,152,40,1732
1643756400,M,53,398,411,590,117,22,1591
1643842800,A,107,615,827,1157,222,59,2987
1643842800,F,57,304,425,610,110,38,1544
1643842800,M,46,306,400,544,111,20,1427
1643929200,A,100,542,794,1010,213,38,2697
1643929200,F,55,254,426,552,107,21,1415
1643929200,M,44,281,361,455,106,17,1264
1644015600,A,87,452,595,877,183,44,2238
1644015600,F,38,230,317,479,88,31,1183
1644015600,M,46,215,276,393,95,13,1038
1644102000,A,36,208,266,358,86,19,973
1644102000,F,22,107,128,181,43,9,490
1644102000,M,14,100,136,176,42,10,478
1644188400,A,73,386,500,728,151,29,1867
1644188400,F,33,176,244,415,91,16,975
1644188400,M,38,207,252,311,60,13,881
1644274800,A,160,810,1078,1588,301,54,3991
1644274800,F,77,387,562,878,153,33,2090
1644274800,M,81,408,509,708,148,20,1874
1644361200,A,187,892,1222,1610,366,94,4371
1644361200,F,89,435,627,871,194,54,2270
1644361200,M,92,444,589,726,171,40,2062
1644447600,A,158,789,1333,1614,373,95,4362
1644447600,F,82,381,697,864,176,57,2257
1644447600,M,73,389,628,740,195,38,2063
1644534000,A,141,544,993,1290,279,90,3337
1644534000,F,69,283,527,707,144,57,1787
1644534000,M,70,246,460,578,134,32,1520
1644620400,A,91,455,693,1047,247,51,2584
1644620400,F,48,221,363,566,116,37,1351
1644620400,M,42,231,329,479,129,14,1224
1644706800,A,44,186,293,410,87,20,1040
1644706800,F,14,90,141,210,40,13,508
1644706800,M,30,92,150,197,47,6,522
1644793200,A,97,408,574,857,182,39,2157
1644793200,F,49,210,308,450,90,25,1132
1644793200,M,46,190,261,404,92,14,1007
1644879600,A,219,794,1187,1739,386,106,4431
1644879600,F,91,380,641,926,199,71,2308
1644879600,M,125,400,541,812,187,35,2100
1644966000,A,175,769,1252,1806,414,85,4501
1644966000,F,83,357,670,963,226,50,2349
1644966000,M,90,398,581,841,188,34,2132
1645052400,A,157,745,1377,1922,488,118,4807
1645052400,F,72,367,722,1055,262,67,2545
1645052400,M,83,370,650,861,226,51,2241
1645138800,A,149,539,1074,1466,302,79,3609
1645138800,F,70,265,553,789,138,58,1873
1645138800,M,77,270,519,676,164,21,1727
1645225200,A,105,403,809,1257,282,75,2931
1645225200,F,55,195,418,665,165,47,1545
1645225200,M,50,205,388,589,117,27,1376
1645311600,A,56,216,364,525,118,29,1308
1645311600,F,23,101,201,274,62,16,677
1645311600,M,33,114,160,249,56,13,625
1645398000,A,98,439,761,1066,295,42,2701
1645398000,F,50,208,398,578,140,30,1404
1645398000,M,48,229,362,485,154,12,1290
1645484400,A,184,795,1391,2377,519,131,5397
1645484400,F,93,374,725,1258,274,86,2810
1645484400,M,90,421,666,1117,244,45,2583
1645570800,A,195,714,1449,2229,583,130,5300
1645570800,F,98,328,771,1195,295,82,2769
1645570800,M,97,384,674,1033,288,48,2524
1645657200,A,209,671,1530,2137,574,147,5268
1645657200,F,96,350,823,1107,298,102,2776
1645657200,M,113,320,699,1024,276,44,2476
1645743600,A,216,646,1217,1730,492,155,4456
1645743600,F,95,325,639,919,271,99,2348
1645743600,M,121,318,571,807,221,56,2094
1645830000,A,160,507,1036,1401,438,134,3676
1645830000,F,80,235,592,755,230,90,1982
1645830000,M,80,266,435,643,208,44,1676
1645916400,A,51,182,324,504,130,53,1244
1645916400,F,23,79,178,282,63,27,652
1645916400,M,27,99,145,222,67,26,586
1646002800,A,107,467,769,1130,331,78,2882
1646002800,F,53,221,407,606,181,48,1516
1646002800,M,54,245,362,520,150,30,1361
1646089200,A,260,931,1430,2104,523,160,5408
1646089200,F,130,456,787,1138,271,107,2889
1646089200,M,129,473,641,962,250,53,2508
1646175600,A,221,895,1491,2123,545,176,5451
1646175600,F,103,411,802,1147,286,117,2866
1646175600,M,118,479,685,974,259,59,2574
1646262000,A,296,988,1707,2418,648,241,6298
1646262000,F,157,480,946,1311,356,161,3411
1646262000,M,137,506,757,1103,291,80,2874
1646348400,A,195,808,1442,1979,619,209,5252
1646348400,F,98,392,768,1056,315,121,2750
1646348400,M,95,413,673,917,302,87,2487
1646434800,A,189,723,1166,1669,509,137,4393
1646434800,F,79,375,627,899,251,93,2324
1646434800,M,110,344,537,767,257,44,2059
1646521200,A,77,339,491,714,228,74,1923
1646521200,F,40,173,268,393,126,57,1057
1646521200,M,36,165,221,321,102,17,862
1646607600,A,206,877,1299,1888,482,159,4911
1646607600,F,104,428,694,1078,241,92,2637
1646607600,M,101,447,603,806,241,66,2264
1646694000,A,308,1292,1803,2743,748,218,7112
1646694000,F,177,652,988,1514,400,140,3871
1646694000,M,131,633,809,1227,347,78,3225
1646780400,A,343,1508,2149,3272,877,234,8383
1646780400,F,166,750,1146,1783,453,146,4444
1646780400,M,174,751,998,1485,423,88,3919
1646866800,A,342,1492,2046,3054,803,282,8019
1646866800,F,166,727,1087,1629,411,183,4203
1646866800,M,176,757,952,1422,392,98,3797
1646953200,A,284,1198,1963,2728,774,206,7153
1646953200,F,125,577,1069,1441,423,139,3774
1646953200,M,159,614,891,1279,350,66,3359
1647039600,A,182,832,1378,1803,503,146,4844
1647039600,F,93,404,720,968,255,91,2531
1647039600,M,89,427,653,830,247,54,2300
1647126000,A,107,442,703,1010,316,101,2679
1647126000,F,51,197,378,567,174,67,1434
1647126000,M,54,244,322,439,140,34,1233
1647212400,A,225,973,1621,2406,744,218,6187
1647212400,F,111,468,867,1295,400,126,3267
1647212400,M,114,502,743,1101,341,92,2893
1647298800,A,259,1232,2075,3304,949,235,8054
1647298800,F,126,584,1067,1840,513,154,4284
1647298800,M,131,643,996,1455,435,80,3740
1647385200,A,318,1368,2381,3718,1117,420,9322
1647385200,F,151,655,1250,2009,605,258,4928
1647385200,M,166,707,1125,1702,509,158,4367
1647471600,A,303,1325,2262,3463,1065,270,8688
1647471600,F,137,660,1161,1841,578,163,4540
1647471600,M,165,660,1094,1612,481,107,4119
1647558000,A,263,1027,1969,3077,1006,245,7587
1647558000,F,124,514,1008,1658,534,158,3996
1647558000,M,138,510,954,1412,469,83,3566
1647644400,A,167,589,1207,1876,607,143,4589
1647644400,F,80,274,623,991,304,92,2364
1647644400,M,86,308,575,876,302,49,2196
1647730800,A,128,499,974,1477,478,129,3685
1647730800,F,58,219,510,786,234,89,1896
1647730800,M,69,277,457,682,243,40,1768
1647817200,A,218,912,1772,2709,932,303,6846
1647817200,F,99,430,892,1445,496,194,3556
1647817200,M,117,477,875,1256,435,108,3268
1647903600,A,337,1328,2282,3668,1194,337,9146
1647903600,F,153,636,1213,2035,657,197,4891
1647903600,M,181,687,1059,1621,535,137,4220
1647990000,A,300,1259,2156,3583,1222,388,8908
1647990000,F,136,628,1100,1911,634,258,4667
1647990000,M,162,626,1050,1661,582,130,4211
1648076400,A,298,1173,2098,3465,1188,371,8593
1648076400,F,142,587,1095,1858,626,228,4536
1648076400,M,155,575,994,1598,559,135,4016
1648162800,A,236,987,1768,2976,958,296,7221
1648162800,F,111,500,939,1601,500,189,3840
1648162800,M,124,483,826,1369,454,107,3363
1648249200,A,157,590,1163,1844,594,160,4508
1648249200,F,66,267,563,993,300,109,2298
1648249200,M,89,316,583,826,286,48,2148
1648335600,A,88,293,635,970,377,114,2477
1648335600,F,44,145,333,520,208,58,1308
1648335600,M,42,145,295,445,169,52,1148
1648418400,A,174,720,1437,2328,783,241,5683
1648418400,F,78,360,761,1262,423,159,3043
1648418400,M,95,356,666,1048,356,82,2603
1648504800,A,239,969,1740,3038,1020,289,7295
1648504800,F,110,481,920,1626,550,171,3858
1648504800,M,127,483,810,1400,466,116,3402
1648591200,A,258,1031,2130,3398,1081,288,8186
1648591200,F,127,531,1085,1857,599,170,4369
1648591200,M,131,493,1036,1527,479,117,3783
1648677600,A,276,1057,2348,3430,1167,301,8579
1648677600,F,142,511,1219,1848,607,206,4533
1648677600,M,131,537,1109,1568,556,93,3994
1648764000,A,202,861,1796,2712,919,246,6736
1648764000,F,101,435,911,1446,516,154,3563
1648764000,M,100,420,873,1255,400,87,3135
1648850400,A,119,453,909,1359,439,109,3388
1648850400,F,52,218,463,741,219,73,1766
1648850400,M,66,232,439,617,218,35,1607
1648936800,A,36,190,417,670,265,69,1647
1648936800,F,14,89,212,351,126,40,832
1648936800,M,21,100,201,315,138,27,802
1649023200,A,170,651,1544,2340,720,222,5647
1649023200,F,83,342,832,1229,371,131,2988
1649023200,M,84,303,695,1097,346,89,2614
1649109600,A,209,734,1614,2507,803,204,6071
1649109600,F,114,365,859,1343,425,130,3236
1649109600,M,92,364,742,1156,375,74,2803
1649196000,A,189,735,1824,2725,788,270,6531
1649196000,F,93,343,931,1502,419,177,3465
1649196000,M,92,378,882,1217,368,89,3026
1649282400,A,182,609,1638,2515,758,230,5932
1649282400,F,100,297,876,1412,407,141,3233
1649282400,M,80,305,748,1098,346,86,2663
1649368800,A,137,472,1148,1606,479,158,4000
1649368800,F,55,253,619,868,257,108,2160
1649368800,M,80,216,523,729,221,49,1818
1649455200,A,65,249,505,834,260,78,1991
1649455200,F,32,119,266,436,133,48,1034
1649455200,M,33,130,238,396,126,28,951
1649541600,A,22,91,174,296,134,35,752
1649541600,F,12,41,92,148,68,19,380
1649541600,M,10,49,80,140,66,15,360
1649628000,A,134,425,1250,1725,611,225,4370
1649628000,F,73,219,651,925,309,135,2312
1649628000,M,61,204,593,795,297,84,2034
1649714400,A,151,422,1138,1796,564,130,4201
1649714400,F,63,197,614,975,279,83,2211
1649714400,M,86,223,519,811,283,47,1969
1649800800,A,145,432,1195,1796,617,165,4350
1649800800,F,74,210,614,988,317,84,2287
1649800800,M,69,214,571,801,297,78,2030
1649887200,A,90,291,925,1399,466,151,3322
1649887200,F,41,141,489,757,267,91,1786
1649887200,M,49,147,433,636,199,58,1522
1649973600,A,17,57,210,363,153,36,836
1649973600,F,9,25,110,203,87,21,455
1649973600,M,8,30,98,155,65,15,371
1650060000,A,16,80,250,433,154,52,985
1650060000,F,8,35,128,242,72,38,523
1650060000,M,8,43,115,180,77,13,436
1650146400,A,2,14,24,62,41,15,158
1650146400,F,1,7,14,41,24,12,99
1650146400,M,1,7,10,21,17,3,59
1650232800,A,16,33,103,176,74,26,428
1650232800,F,8,16,47,85,36,14,206
1650232800,M,7,16,55,83,36,10,207
1650319200,A,134,370,1119,1713,639,144,4119
1650319200,F,63,175,604,917,346,86,2191
1650319200,M,70,194,508,778,290,56,1896
1650405600,A,71,182,841,1397,507,141,3139
1650405600,F,36,92,445,749,262,80,1664
1650405600,M,35,89,386,638,244,61,1453
1650492000,A,69,171,922,1553,536,153,3404
1650492000,F,35,90,494,869,292,86,1866
1650492000,M,32,79,423,676,242,64,1516
1650578400,A,46,93,543,854,321,66,1923
1650578400,F,23,37,284,463,188,36,1031
1650578400,M,23,54,256,389,133,30,885
1650664800,A,3,31,111,223,89,29,486
1650664800,F,0,16,64,122,47,19,268
1650664800,M,3,15,47,101,42,9,217
1650751200,A,1,13,32,65,25,5,141
1650751200,F,1,6,16,37,15,4,79
1650751200,M,0,7,16,28,10,1,62
1650837600,A,44,147,639,1008,417,132,2387
1650837600,F,21,68,364,537,214,76,1280
1650837600,M,23,78,275,465,202,55,1098
1650924000,A,38,135,473,791,343,98,1878
1650924000,F,19,61,254,452,181,62,1029
1650924000,M,19,74,215,338,159,36,841
1651010400,A,40,137,477,817,320,74,1865
1651010400,F,18,70,235,432,173,43,971
1651010400,M,22,66,240,382,145,30,885
1651096800,A,28,98,437,637,268,84,1552
1651096800,F,11,50,230,368,135,56,850
1651096800,M,17,47,206,265,132,28,695
1651183200,A,16,70,298,405,213,50,1052
1651183200,F,9,31,165,232,108,38,583
1651183200,M,7,39,132,173,105,12,468
1651269600,A,3,21,49,92,65,7,237
1651269600,F,2,10,25,50,41,4,132
1651269600,M,1,11,24,42,24,3,105
1651356000,A,3,5,24,40,22,8,102
1651356000,F,2,2,10,21,10,4,49
1651356000,M,1,3,14,19,11,4,52
1651442400,A,31,112,368,563,274,106,1454
1651442400,F,16,53,187,321,141,61,779
1651442400,M,15,58,178,240,130,45,666
1651528800,A,25,113,299,557,251,58,1303
1651528800,F,14,53,147,324,135,33,706
1651528800,M,11,60,151,232,116,25,595
1651615200,A,37,114,319,497,195,65,1227
1651615200,F,18,62,180,247,101,44,652
1651615200,M,17,49,139,250,94,21,570
1651701600,A,14,71,270,339,178,55,927
1651701600,F,6,40,141,204,106,39,536
1651701600,M,8,31,129,135,72,16,391
1651788000,A,10,57,209,284,127,42,729
1651788000,F,2,29,116,170,52,28,397
1651788000,M,8,28,93,114,75,14,332
1651874400,A,2,7,18,33,21,4,85
1651874400,F,2,2,15,23,11,2,55
1651874400,M,0,5,3,10,10,2,30
1651960800,A,4,5,9,21,5,4,48
1651960800,F,2,2,6,9,2,3,24
1651960800,M,2,3,3,12,3,1,24
1652047200,A,23,97,299,508,222,95,1244
1652047200,F,8,50,164,315,110,54,701
1652047200,M,14,47,135,192,111,40,539
1652133600,A,16,84,209,411,169,52,941
1652133600,F,9,42,112,227,94,29,513
1652133600,M,7,42,95,183,74,23,424
1652220000,A,19,86,213,414,186,46,964
1652220000,F,8,49,122,228,107,28,542
1652220000,M,11,36,89,183,76,18,413
1652306400,A,23,64,213,301,131,44,776
1652306400,F,12,42,109,174,65,29,431
1652306400,M,11,21,104,126,63,15,340
1652392800,A,12,30,156,191,105,29,523
1652392800,F,7,17,85,109,51,15,284
1652392800,M,5,13,69,81,54,14,236
1652479200,A,1,0,8,15,18,2,44
1652479200,F,1,0,6,7,8,1,23
1652479200,M,0,0,2,8,10,1,21
1652565600,A,0,4,20,21,10,2,57
1652565600,F,0,2,8,12,2,1,25
1652565600,M,0,2,12,9,8,1,32
1652652000,A,6,63,205,311,125,41,751
1652652000,F,3,31,108,173,63,20,398
1652652000,M,3,31,95,135,61,21,346
1652738400,A,13,61,180,316,147,44,761
1652738400,F,5,30,87,169,82,23,396
1652738400,M,8,31,92,147,65,21,364
1652824800,A,14,39,140,207,83,42,525
1652824800,F,5,19,76,102,53,29,284
1652824800,M,9,20,63,105,30,13,240
1652911200,A,7,25,107,160,92,19,410
1652911200,F,3,14,55,97,46,14,229
1652911200,M,4,11,52,63,46,5,181
1652997600,A,10,24,112,163,74,23,406
1652997600,F,6,13,48,89,37,9,202
1652997600,M,4,11,64,74,37,13,203
1653084000,A,2,5,13,31,15,8,74
1653084000,F,0,3,7,17,8,7,42
1653084000,M,2,2,6,14,7,1,32
1653170400,A,0,2,12,23,7,3,47
1653170400,F,0,2,6,15,4,1,28
1653170400,M,0,0,6,8,3,2,19
1653256800,A,1,36,148,234,109,21,549
1653256800,F,0,16,96,129,53,10,304
1653256800,M,1,20,52,104,55,11,243
1653343200,A,5,29,120,186,85,23,448
1653343200,F,3,19,74,101,42,14,253
1653343200,M,2,9,46,85,42,9,193
1653429600,A,12,26,93,136,48,24,339
1653429600,F,4,10,49,79,27,13,182
1653429600,M,7,16,43,57,21,11,155
1653516000,A,0,2,12,10,5,3,32
1653516000,F,0,0,8,5,3,2,18
1653516000,M,0,2,4,5,2,1,14
1653602400,A,1,10,69,77,37,12,206
1653602400,F,0,5,41,31,23,6,106
1653602400,M,1,5,28,46,14,6,100
1653688800,A,0,2,8,9,7,4,30
1653688800,F,0,1,4,4,4,1,14
1653688800,M,0,1,4,5,2,3,15
1653775200,A,1,0,3,28,17,2,51
1653775200,F,0,0,2,19,11,2,34
1653775200,M,1,0,1,9,6,0,17
1653861600,A,11,27,124,238,107,32,539
1653861600,F,6,13,67,140,55,21,302
1653861600,M,5,14,57,98,52,11,237
1653948000,A,8,37,123,240,91,37,536
1653948000,F,5,20,70,142,54,17,308
1653948000,M,3,16,52,97,37,20,225
1654034400,A,8,17,137,178,76,28,444
1654034400,F,2,7,74,102,38,18,241
1654034400,M,6,10,62,76,38,10,202
1654120800,A,4,12,76,112,79,20,303
1654120800,F,3,7,43,61,42,12,168
1654120800,M,0,5,33,51,37,8,134
1654207200,A,6,11,71,101,40,11,240
1654207200,F,4,6,34,61,21,7,133
1654207200,M,2,5,37,40,19,4,107
1654293600,A,0,2,9,21,12,3,47
1654293600,F,0,1,5,12,6,1,25
1654293600,M,0,1,4,9,6,2,22
1654380000,A,2,2,26,18,8,3,59
1654380000,F,0,1,10,11,6,2,30
1654380000,M,1,1,16,7,2,1,28
1654466400,A,2,7,10,11,8,3,41
1654466400,F,1,3,8,6,4,2,24
1654466400,M,1,4,2,5,4,1,17
1654552800,A,15,29,154,279,136,38,651
1654552800,F,10,16,91,144,83,24,368
1654552800,M,5,13,61,134,53,14,280
1654639200,A,9,27,179,308,131,29,683
1654639200,F,5,13,99,170,72,15,374
1654639200,M,4,14,80,137,59,14,308
1654725600,A,6,22,173,277,133,31,642
1654725600,F,6,10,88,154,73,18,349
1654725600,M,0,12,85,123,60,13,293
1654812000,A,6,24,140,185,92,28,475
1654812000,F,3,17,77,105,57,17,276
1654812000,M,3,7,63,79,35,11,198
1654898400,A,2,3,17,28,12,3,65
1654898400,F,1,2,6,16,8,2,35
1654898400,M,1,1,11,12,4,1,30
1654984800,A,0,7,13,30,14,5,69
1654984800,F,0,3,9,14,8,3,37
1654984800,M,0,4,4,16,6,2,32
1655071200,A,11,28,248,383,175,46,891
1655071200,F,6,9,140,218,95,21,489
1655071200,M,5,19,106,164,80,25,399
1655157600,A,7,35,229,310,135,32,748
1655157600,F,3,17,117,164,72,16,389
1655157600,M,4,18,111,145,63,16,357
1655244000,A,9,23,197,288,131,31,679
1655244000,F,3,13,105,155,59,16,351
1655244000,M,6,10,90,133,72,15,326
1655330400,A,20,25,187,264,129,32,657
1655330400,F,6,13,93,145,68,24,349
1655330400,M,14,12,92,118,61,8,305
1655416800,A,7,25,212,319,139,42,744
1655416800,F,4,13,111,160,69,24,381
1655416800,M,3,12,98,158,70,18,359
1655503200,A,4,4,20,31,24,6,89
1655503200,F,0,3,13,19,14,5,54
1655503200,M,4,1,7,12,10,1,35
1655589600,A,1,2,25,32,14,4,78
1655589600,F,0,2,10,20,5,3,40
1655589600,M,1,0,15,12,9,1,38
1655676000,A,14,47,226,422,171,65,945
1655676000,F,5,19,124,231,87,36,502
1655676000,M,9,28,101,191,84,29,442
1655762400,A,10,50,233,467,204,42,1006
1655762400,F,5,21,125,278,112,19,560
1655762400,M,5,29,108,188,91,23,444
1655848800,A,13,58,304,455,187,42,1059
1655848800,F,6,32,164,254,95,29,580
1655848800,M,7,25,140,200,91,13,476
1655935200,A,8,46,224,336,161,39,814
1655935200,F,4,21,105,191,80,18,419
1655935200,M,4,25,117,143,81,21,391
1656021600,A,15,42,251,377,143,33,861
1656021600,F,7,20,115,198,77,19,436
1656021600,M,7,22,136,179,65,14,423
1656108000,A,2,2,19,45,24,7,99
1656108000,F,2,0,10,18,11,5,46
1656108000,M,0,2,9,27,13,2,53
1656194400,A,0,5,18,28,14,6,71
1656194400,F,0,3,13,10,8,6,40
1656194400,M,0,2,5,18,6,0,31
1656280800,A,19,91,360,588,249,61,1368
1656280800,F,8,53,183,311,128,32,715
1656280800,M,11,37,177,275,121,29,650
1656367200,A,13,99,344,687,275,52,1470
1656367200,F,5,55,176,384,157,32,809
1656367200,M,8,43,166,303,118,20,658
1656453600,A,17,93,407,626,231,51,1425
1656453600,F,11,54,198,353,125,22,763
1656453600,M,6,38,209,271,105,29,658
1656540000,A,7,47,238,410,194,55,951
1656540000,F,3,19,117,223,108,31,501
1656540000,M,4,28,121,187,86,24,450
1656626400,A,11,50,317,452,223,55,1108
1656626400,F,4,23,174,247,134,24,606
1656626400,M,7,26,142,205,89,31,500
1656712800,A,3,5,19,48,30,2,107
1656712800,F,3,1,8,25,11,2,50
1656712800,M,0,4,11,23,19,0,57
1656799200,A,0,5,21,35,14,10,85
1656799200,F,0,2,11,19,6,6,44
1656799200,M,0,3,10,16,8,4,41
1656885600,A,18,99,349,625,300,72,1463
1656885600,F,7,45,191,329,168,37,777
1656885600,M,11,52,155,294,130,35,677
1656972000,A,21,83,349,708,270,57,1488
1656972000,F,13,38,195,385,138,32,801
1656972000,M,8,45,154,319,132,25,683
1657058400,A,19,74,290,598,300,85,1366
1657058400,F,10,41,151,332,154,41,729
1657058400,M,9,33,139,265,146,44,636
1657144800,A,11,51,314,545,242,50,1213
1657144800,F,3,23,153,337,144,29,689
1657144800,M,8,28,157,207,98,20,518
1657231200,A,13,59,271,435,221,46,1045
1657231200,F,7,29,142,235,125,27,565
1657231200,M,4,29,129,200,95,19,476
1657317600,A,2,8,46,72,42,7,177
1657317600,F,1,4,23,36,25,4,93
1657317600,M,1,4,23,36,17,3,84
1657404000,A,0,5,16,34,23,9,87
1657404000,F,0,2,11,18,11,4,46
1657404000,M,0,3,5,16,12,5,41
1657490400,A,33,82,427,690,377,115,1724
1657490400,F,18,35,217,350,189,77,886
1657490400,M,15,42,207,340,187,38,829
1657576800,A,30,105,418,853,350,87,1843
1657576800,F,13,62,209,469,180,39,972
1657576800,M,16,41,204,384,170,48,863
1657663200,A,31,89,435,699,294,76,1624
1657663200,F,11,43,238,397,163,44,896
1657663200,M,19,44,193,298,131,32,717
1657749600,A,25,67,405,771,340,89,1697
1657749600,F,15,27,198,418,189,49,896
1657749600,M,10,38,207,351,151,38,795
1657836000,A,17,42,323,585,253,74,1294
1657836000,F,10,17,162,325,138,45,697
1657836000,M,6,25,161,259,114,29,594
1657922400,A,1,5,57,106,36,12,217
1657922400,F,0,1,28,62,17,6,114
1657922400,M,1,3,29,44,19,6,102
1658008800,A,2,6,26,64,28,11,137
1658008800,F,1,3,13,44,16,7,84
1658008800,M,1,3,13,20,12,4,53
1658095200,A,29,92,477,892,399,113,2002
1658095200,F,15,49,251,510,220,58,1103
1658095200,M,14,40,222,376,179,54,885
1658181600,A,24,82,511,1012,430,109,2168
1658181600,F,7,36,270,555,223,66,1157
1658181600,M,15,46,239,456,204,43,1003
1658268000,A,27,78,464,851,371,102,1893
1658268000,F,12,42,247,464,200,57,1022
1658268000,M,13,35,215,384,171,45,863
1658354400,A,24,43,397,734,313,95,1606
1658354400,F,10,24,197,403,165,56,855
1658354400,M,14,19,198,329,148,39,747
1658440800,A,14,41,310,535,231,73,1204
1658440800,F,7,18,171,298,127,37,658
1658440800,M,6,22,135,234,104,36,537
1658527200,A,3,12,43,86,60,13,217
1658527200,F,2,7,22,53,36,6,126
1658527200,M,1,5,20,33,24,7,90
1658613600,A,0,1,24,36,26,11,98
1658613600,F,0,0,11,12,14,7,44
1658613600,M,0,1,12,24,12,4,53
1658700000,A,31,70,506,902,439,163,2111
1658700000,F,17,38,274,493,233,92,1147
1658700000,M,14,32,229,407,206,71,959
1658786400,A,29,63,396,825,381,115,1809
1658786400,F,19,24,199,454,196,69,961
1658786400,M,10,39,196,367,185,46,843
1658872800,A,18,46,331,703,342,88,1528
1658872800,F,10,24,172,377,171,59,813
1658872800,M,6,20,157,324,169,29,705
1658959200,A,20,30,266,465,226,77,1084
1658959200,F,9,14,135,264,116,43,581
1658959200,M,11,16,129,200,110,34,500
1659045600,A,20,26,228,475,198,61,1008
1659045600,F,12,10,114,272,97,38,543
1659045600,M,7,15,112,203,101,23,461
1659132000,A,1,5,20,52,25,10,113
1659132000,F,1,3,11,27,15,6,63
1659132000,M,0,2,9,25,10,4,50
1659218400,A,1,3,18,43,12,13,90
1659218400,F,1,3,6,26,1,5,42
1659218400,M,0,0,11,17,11,8,47
1659304800,A,21,40,322,584,285,98,1350
1659304800,F,11,20,181,314,154,61,741
1659304800,M,10,20,139,267,131,37,604
1659391200,A,18,29,266,555,235,68,1171
1659391200,F,14,14,148,305,122,40,643
1659391200,M,4,15,118,248,113,28,526
1659477600,A,27,25,273,516,216,86,1143
1659477600,F,10,16,135,285,120,47,613
1659477600,M,17,9,137,228,96,39,526
1659564000,A,18,25,233,369,209,60,914
1659564000,F,7,12,116,216,109,30,490
1659564000,M,11,13,112,152,100,30,418
1659650400,A,10,23,185,281,120,51,670
1659650400,F,7,15,99,169,67,32,389
1659650400,M,3,7,86,112,53,19,280
1659736800,A,2,4,20,49,29,8,112
1659736800,F,1,2,9,28,14,4,58
1659736800,M,1,2,10,20,15,4,52
1659823200,A,0,2,9,34,22,6,73
1659823200,F,0,0,5,16,8,4,33
1659823200,M,0,2,4,18,12,2,38
1659909600,A,15,33,237,491,243,77,1096
1659909600,F,9,15,135,279,122,47,607
1659909600,M,6,18,101,211,121,30,487
1659996000,A,24,25,206,425,232,71,983
1659996000,F,9,12,106,233,117,38,515
1659996000,M,15,13,98,191,115,33,465
1660082400,A,18,27,219,465,215,53,997
1660082400,F,11,9,110,250,112,25,517
1660082400,M,7,18,108,211,103,28,475
1660168800,A,10,22,153,329,161,54,729
1660168800,F,4,9,90,197,85,25,410
1660168800,M,6,13,62,132,76,29,318
1660255200,A,12,15,164,287,156,45,679
1660255200,F,3,7,80,160,83,25,358
1660255200,M,9,8,82,125,70,20,314
1660341600,A,0,3,17,52,29,6,107
1660341600,F,0,1,8,35,19,2,65
1660341600,M,0,2,9,17,10,4,42
1660428000,A,1,2,14,22,16,7,62
1660428000,F,1,1,11,9,8,4,34
1660428000,M,0,1,2,13,8,3,27
1660514400,A,15,44,243,462,267,81,1112
1660514400,F,5,23,119,271,126,46,590
1660514400,M,10,21,123,189,140,35,518
1660600800,A,20,19,196,384,180,63,862
1660600800,F,12,10,99,183,101,36,441
1660600800,M,8,9,95,200,79,26,417
1660687200,A,14,21,234,438,201,61,969
1660687200,F,9,10,107,232,105,32,495
1660687200,M,5,11,127,202,96,29,470
1660773600,A,17,25,160,335,131,61,729
1660773600,F,7,14,79,186,66,29,381
1660773600,M,9,11,79,149,65,32,345
1660860000,A,6,23,128,243,120,30,550
1660860000,F,2,14,63,125,63,20,287
1660860000,M,3,9,65,118,55,10,260
1660946400,A,1,2,18,48,26,10,105
1660946400,F,1,2,9,21,13,5,51
1660946400,M,0,0,9,27,13,5,54
1661032800,A,0,2,9,20,13,4,48
1661032800,F,0,2,4,13,8,1,28
1661032800,M,0,0,5,7,5,3,20
1661119200,A,24,37,168,377,193,69,868
1661119200,F,10,17,102,191,103,34,457
1661119200,M,14,20,65,184,89,35,407
1661205600,A,18,27,206,444,200,42,937
1661205600,F,8,16,101,249,103,20,497
1661205600,M,10,11,103,195,96,22,437
1661292000,A,15,40,177,342,171,46,791
1661292000,F,4,18,87,200,86,31,426
1661292000,M,11,20,83,137,79,15,345
1661378400,A,11,12,124,234,122,36,539
1661378400,F,3,8,71,123,71,24,300
1661378400,M,8,4,53,111,51,12,239
1661464800,A,12,22,108,213,129,39,523
1661464800,F,4,5,58,118,84,18,287
1661464800,M,8,17,49,94,45,21,234
1661551200,A,1,6,19,34,27,6,93
1661551200,F,1,4,11,22,17,3,58
1661551200,M,0,2,8,12,10,3,35
1661637600,A,4,1,13,34,28,8,88
1661637600,F,3,0,7,19,14,8,51
1661637600,M,1,1,6,15,13,0,36
1661724000,A,12,35,185,349,165,68,814
1661724000,F,3,15,95,202,81,37,433
1661724000,M,9,20,88,147,83,31,378
1661810400,A,9,51,163,365,141,26,755
1661810400,F,2,28,90,194,77,12,403
1661810400,M,7,23,73,171,63,14,351
1661896800,A,19,38,146,295,137,50,685
1661896800,F,8,17,72,159,71,34,361
1661896800,M,10,20,74,135,66,16,321
